final_kills,secondary_uniques,staff_pieces,total_drops,drop_rate,staff_drop_rate,kill_time_mins,total_log_hours,staff_gp,staff_gp_per_hour
1205,14,13,27,44.629629629629626,92.6923076923077,6025,100.41666666666667,13000000000,129.46058091286307
625,12,3,15,41.666666666666664,208.33333333333334,3125,52.083333333333336,3000000000,57.6
792,12,9,21,37.714285714285715,88,3960,66,9000000000,136.36363636363637
588,15,3,18,32.666666666666664,196,2940,49,3000000000,61.224489795918366
264,9,3,12,22,88,1320,22,3000000000,136.36363636363637
1251,13,9,22,56.86363636363637,139,6255,104.25,9000000000,86.33093525179855
438,4,5,9,48.666666666666664,87.6,2190,36.5,5000000000,136.986301369863
413,7,4,11,37.54545454545455,103.25,2065,34.416666666666664,4000000000,116.2227602905569
575,8,3,11,52.27272727272727,191.66666666666666,2875,47.916666666666664,3000000000,62.608695652173914
698,10,9,19,36.73684210526316,77.55555555555556,3490,58.166666666666664,9000000000,154.72779369627509
290,4,3,7,41.42857142857143,96.66666666666667,1450,24.166666666666668,3000000000,124.13793103448275
1165,14,11,25,46.6,105.9090909090909,5825,97.08333333333333,11000000000,113.30472103004291
825,5,7,12,68.75,117.85714285714286,4125,68.75,7000000000,101.81818181818181
1064,12,8,20,53.2,133,5320,88.66666666666667,8000000000,90.22556390977444
1140,20,9,29,39.310344827586206,126.66666666666667,5700,95,9000000000,94.73684210526316
187,3,4,7,26.714285714285715,46.75,935,15.583333333333334,4000000000,256.68449197860963
414,5,4,9,46,103.5,2070,34.5,4000000000,115.94202898550725
687,10,3,13,52.84615384615385,229,3435,57.25,3000000000,52.40174672489083
1023,13,3,16,63.9375,341,5115,85.25,3000000000,35.19061583577712
507,11,3,14,36.214285714285715,169,2535,42.25,3000000000,71.0059171597633
677,13,3,16,42.3125,225.66666666666666,3385,56.416666666666664,3000000000,53.17577548005909
565,11,3,14,40.357142857142854,188.33333333333334,2825,47.083333333333336,3000000000,63.716814159292035
620,14,4,18,34.44444444444444,155,3100,51.666666666666664,4000000000,77.41935483870968
818,7,4,11,74.36363636363636,204.5,4090,68.16666666666667,4000000000,58.67970660146699
598,9,4,13,46,149.5,2990,49.833333333333336,4000000000,80.2675585284281
1059,15,3,18,58.833333333333336,353,5295,88.25,3000000000,33.994334277620396
586,10,4,14,41.857142857142854,146.5,2930,48.833333333333336,4000000000,81.91126279863481
242,6,3,9,26.88888888888889,80.66666666666667,1210,20.166666666666668,3000000000,148.7603305785124
876,12,7,19,46.10526315789474,125.14285714285714,4380,73,7000000000,95.8904109589041
350,7,3,10,35,116.66666666666667,1750,29.166666666666668,3000000000,102.85714285714285
461,5,4,9,51.22222222222222,115.25,2305,38.416666666666664,4000000000,104.12147505422995
519,8,4,12,43.25,129.75,2595,43.25,4000000000,92.48554913294798
246,4,3,7,35.142857142857146,82,1230,20.5,3000000000,146.34146341463415
1005,16,6,22,45.68181818181818,167.5,5025,83.75,6000000000,71.64179104477613
531,10,3,13,40.84615384615385,177,2655,44.25,3000000000,67.79661016949153
680,9,4,13,52.30769230769231,170,3400,56.666666666666664,4000000000,70.58823529411764
558,12,5,17,32.8235294117647,111.6,2790,46.5,5000000000,107.52688172043011
995,12,4,16,62.1875,248.75,4975,82.91666666666667,4000000000,48.24120603015075
269,4,3,7,38.42857142857143,89.66666666666667,1345,22.416666666666668,3000000000,133.82899628252787
895,16,8,24,37.291666666666664,111.875,4475,74.58333333333333,8000000000,107.26256983240225
301,4,3,7,43,100.33333333333333,1505,25.083333333333332,3000000000,119.60132890365449
646,5,3,8,80.75,215.33333333333334,3230,53.833333333333336,3000000000,55.72755417956656
418,5,3,8,52.25,139.33333333333334,2090,34.833333333333336,3000000000,86.1244019138756
211,3,3,6,35.166666666666664,70.33333333333333,1055,17.583333333333332,3000000000,170.61611374407585
990,17,7,24,41.25,141.42857142857142,4950,82.5,7000000000,84.84848484848484
193,3,3,6,32.166666666666664,64.33333333333333,965,16.083333333333332,3000000000,186.52849740932643
983,10,5,15,65.53333333333333,196.6,4915,81.91666666666667,5000000000,61.03763987792472
1018,22,5,27,37.7037037037037,203.6,5090,84.83333333333333,5000000000,58.93909626719058
446,8,3,11,40.54545454545455,148.66666666666666,2230,37.166666666666664,3000000000,80.71748878923768
392,11,3,14,28,130.66666666666666,1960,32.666666666666664,3000000000,91.83673469387756
357,4,3,7,51,119,1785,29.75,3000000000,100.84033613445379
1045,8,4,12,87.08333333333333,261.25,5225,87.08333333333333,4000000000,45.93301435406699
866,16,5,21,41.23809523809524,173.2,4330,72.16666666666667,5000000000,69.284064665127
460,6,3,9,51.111111111111114,153.33333333333334,2300,38.333333333333336,3000000000,78.26086956521739
762,16,3,19,40.10526315789474,254,3810,63.5,3000000000,47.24409448818898
903,6,3,9,100.33333333333333,301,4515,75.25,3000000000,39.8671096345515
386,4,3,7,55.142857142857146,128.66666666666666,1930,32.166666666666664,3000000000,93.26424870466322
704,7,4,11,64,176,3520,58.666666666666664,4000000000,68.18181818181819
728,7,4,11,66.18181818181819,182,3640,60.666666666666664,4000000000,65.93406593406594
506,9,3,12,42.166666666666664,168.66666666666666,2530,42.166666666666664,3000000000,71.14624505928855
863,16,3,19,45.421052631578945,287.6666666666667,4315,71.91666666666667,3000000000,41.71494785631517
498,15,3,18,27.666666666666668,166,2490,41.5,3000000000,72.28915662650603
600,3,4,7,85.71428571428571,150,3000,50,4000000000,80
386,6,4,10,38.6,96.5,1930,32.166666666666664,4000000000,124.35233160621762
797,14,3,17,46.88235294117647,265.6666666666667,3985,66.41666666666667,3000000000,45.1693851944793
777,13,3,16,48.5625,259,3885,64.75,3000000000,46.33204633204633
629,7,6,13,48.38461538461539,104.83333333333333,3145,52.416666666666664,6000000000,114.46740858505565
581,10,5,15,38.733333333333334,116.2,2905,48.416666666666664,5000000000,103.27022375215148
667,5,3,8,83.375,222.33333333333334,3335,55.583333333333336,3000000000,53.973013493253376
1175,19,11,30,39.166666666666664,106.81818181818181,5875,97.91666666666667,11000000000,112.34042553191489
1435,21,12,33,43.484848484848484,119.58333333333333,7175,119.58333333333333,12000000000,100.34843205574913
642,5,6,11,58.36363636363637,107,3210,53.5,6000000000,112.14953271028037
203,5,4,9,22.555555555555557,50.75,1015,16.916666666666668,4000000000,236.45320197044333
547,5,4,9,60.77777777777778,136.75,2735,45.583333333333336,4000000000,87.75137111517367
431,8,3,11,39.18181818181818,143.66666666666666,2155,35.916666666666664,3000000000,83.52668213457078
516,9,8,17,30.352941176470587,64.5,2580,43,8000000000,186.04651162790697
361,6,3,9,40.111111111111114,120.33333333333333,1805,30.083333333333332,3000000000,99.7229916897507
302,4,3,7,43.142857142857146,100.66666666666667,1510,25.166666666666668,3000000000,119.20529801324503
345,8,5,13,26.53846153846154,69,1725,28.75,5000000000,173.91304347826087
585,9,3,12,48.75,195,2925,48.75,3000000000,61.53846153846153
407,7,5,12,33.916666666666664,81.4,2035,33.916666666666664,5000000000,147.42014742014743
618,3,4,7,88.28571428571429,154.5,3090,51.5,4000000000,77.66990291262137
765,13,3,16,47.8125,255,3825,63.75,3000000000,47.05882352941176
785,9,5,14,56.07142857142857,157,3925,65.41666666666667,5000000000,76.43312101910828
788,9,9,18,43.77777777777778,87.55555555555556,3940,65.66666666666667,9000000000,137.05583756345177
654,13,3,16,40.875,218,3270,54.5,3000000000,55.04587155963302
215,5,3,8,26.875,71.66666666666667,1075,17.916666666666668,3000000000,167.44186046511626
665,11,3,14,47.5,221.66666666666666,3325,55.416666666666664,3000000000,54.13533834586466
1414,13,9,22,64.27272727272727,157.11111111111111,7070,117.83333333333333,9000000000,76.37906647807638
412,3,3,6,68.66666666666667,137.33333333333334,2060,34.333333333333336,3000000000,87.37864077669902
593,10,4,14,42.357142857142854,148.25,2965,49.416666666666664,4000000000,80.94435075885329
541,10,6,16,33.8125,90.16666666666667,2705,45.083333333333336,6000000000,133.08687615526802
756,12,3,15,50.4,252,3780,63,3000000000,47.61904761904762
704,6,3,9,78.22222222222223,234.66666666666666,3520,58.666666666666664,3000000000,51.13636363636364
364,6,3,9,40.44444444444444,121.33333333333333,1820,30.333333333333332,3000000000,98.9010989010989
517,8,3,11,47,172.33333333333334,2585,43.083333333333336,3000000000,69.63249516441006
665,14,3,17,39.11764705882353,221.66666666666666,3325,55.416666666666664,3000000000,54.13533834586466
647,8,3,11,58.81818181818182,215.66666666666666,3235,53.916666666666664,3000000000,55.64142194744977
1217,21,3,24,50.708333333333336,405.6666666666667,6085,101.41666666666667,3000000000,29.580936729663105
526,11,3,14,37.57142857142857,175.33333333333334,2630,43.833333333333336,3000000000,68.44106463878326
561,5,3,8,70.125,187,2805,46.75,3000000000,64.171122994652407
710,12,3,15,47.333333333333336,236.66666666666666,3550,59.166666666666664,3000000000,50.70422535211268
473,9,3,12,39.416666666666664,157.66666666666666,2365,39.416666666666664,3000000000,76.10993657505286
515,8,3,11,46.81818181818182,171.66666666666666,2575,42.916666666666664,3000000000,69.90291262135923
313,5,3,8,39.125,104.33333333333333,1565,26.083333333333332,3000000000,115.01597444089457
476,3,3,6,79.33333333333333,158.66666666666666,2380,39.666666666666664,3000000000,75.63025210084035
598,13,3,16,37.375,199.33333333333334,2990,49.833333333333336,3000000000,60.20066889632107
955,16,3,19,50.26315789473684,318.3333333333333,4775,79.58333333333333,3000000000,37.696335078534034
257,8,3,11,23.363636363636363,85.66666666666667,1285,21.416666666666668,3000000000,140.07782101167317
452,5,6,11,41.09090909090909,75.33333333333333,2260,37.666666666666664,6000000000,159.2920353982301
426,8,3,11,38.72727272727273,142,2130,35.5,3000000000,84.50704225352113
574,16,7,23,24.956521739130434,82,2870,47.833333333333336,7000000000,146.34146341463415
489,7,4,11,44.45454545454545,122.25,2445,40.75,4000000000,98.15950920245399
639,13,3,16,39.9375,213,3195,53.25,3000000000,56.33802816901408
772,14,6,20,38.6,128.66666666666666,3860,64.33333333333333,6000000000,93.26424870466322
960,10,9,19,50.526315789473685,106.66666666666667,4800,80,9000000000,112.5
610,11,3,14,43.57142857142857,203.33333333333334,3050,50.833333333333336,3000000000,59.01639344262294
965,17,5,22,43.86363636363637,193,4825,80.41666666666667,5000000000,62.1761658031088
460,3,3,6,76.66666666666667,153.33333333333334,2300,38.333333333333336,3000000000,78.26086956521739
572,8,3,11,52,190.66666666666666,2860,47.666666666666664,3000000000,62.93706293706294
327,9,3,12,27.25,109,1635,27.25,3000000000,110.09174311926604
625,8,8,16,39.0625,78.125,3125,52.083333333333336,8000000000,153.6
935,11,4,15,62.333333333333336,233.75,4675,77.91666666666667,4000000000,51.33689839572192
1092,21,3,24,45.5,364,5460,91,3000000000,32.967032967032964
494,8,3,11,44.90909090909091,164.66666666666666,2470,41.166666666666664,3000000000,72.87449392712551
229,4,3,7,32.714285714285715,76.33333333333333,1145,19.083333333333332,3000000000,157.2052401746725
1510,29,10,39,38.717948717948715,151,7550,125.83333333333333,10000000000,79.4701986754967
630,11,3,14,45,210,3150,52.5,3000000000,57.14285714285714
588,13,7,20,29.4,84,2940,49,7000000000,142.85714285714286
501,11,3,14,35.785714285714285,167,2505,41.75,3000000000,71.85628742514969
554,7,5,12,46.166666666666664,110.8,2770,46.166666666666664,5000000000,108.30324909747294
457,10,3,13,35.15384615384615,152.33333333333334,2285,38.083333333333336,3000000000,78.77461706783369
1021,28,3,31,32.935483870967744,340.3333333333333,5105,85.08333333333333,3000000000,35.259549461312446
511,8,3,11,46.45454545454545,170.33333333333334,2555,42.583333333333336,3000000000,70.45009784735812
836,14,3,17,49.1764705882353,278.6666666666667,4180,69.66666666666667,3000000000,43.0622009569378
338,7,6,13,26,56.333333333333336,1690,28.166666666666668,6000000000,213.01775147928993
666,12,3,15,44.4,222,3330,55.5,3000000000,54.05405405405405
1354,32,7,39,34.717948717948715,193.42857142857142,6770,112.83333333333333,7000000000,62.0384047267356
793,7,4,11,72.0909090909091,198.25,3965,66.08333333333333,4000000000,60.529634300126105
614,11,3,14,43.857142857142854,204.66666666666666,3070,51.166666666666664,3000000000,58.63192182410423
683,8,3,11,62.09090909090909,227.66666666666666,3415,56.916666666666664,3000000000,52.7086383601757
734,6,3,9,81.55555555555556,244.66666666666666,3670,61.166666666666664,3000000000,49.04632152588556
811,16,4,20,40.55,202.75,4055,67.58333333333333,4000000000,59.1861898890259
362,6,3,9,40.22222222222222,120.66666666666667,1810,30.166666666666668,3000000000,99.4475138121547
504,7,4,11,45.81818181818182,126,2520,42,4000000000,95.23809523809524
552,6,3,9,61.333333333333336,184,2760,46,3000000000,65.21739130434783
507,10,4,14,36.214285714285715,126.75,2535,42.25,4000000000,94.67455621301775
968,10,9,19,50.94736842105263,107.55555555555556,4840,80.66666666666667,9000000000,111.57024793388429
412,5,3,8,51.5,137.33333333333334,2060,34.333333333333336,3000000000,87.37864077669902
235,6,3,9,26.11111111111111,78.33333333333333,1175,19.583333333333332,3000000000,153.19148936170214
581,12,4,16,36.3125,145.25,2905,48.416666666666664,4000000000,82.61617900172118
339,3,4,7,48.42857142857143,84.75,1695,28.25,4000000000,141.5929203539823
645,12,3,15,43,215,3225,53.75,3000000000,55.81395348837209
1432,24,3,27,53.03703703703704,477.3333333333333,7160,119.33333333333333,3000000000,25.139664804469277
719,5,4,9,79.88888888888889,179.75,3595,59.916666666666664,4000000000,66.75938803894297
633,12,3,15,42.2,211,3165,52.75,3000000000,56.87203791469194
547,4,4,8,68.375,136.75,2735,45.583333333333336,4000000000,87.75137111517367
387,7,3,10,38.7,129,1935,32.25,3000000000,93.02325581395348
906,9,7,16,56.625,129.42857142857142,4530,75.5,7000000000,92.71523178807946
658,8,3,11,59.81818181818182,219.33333333333334,3290,54.833333333333336,3000000000,54.7112462006079
581,11,3,14,41.5,193.66666666666666,2905,48.416666666666664,3000000000,61.96213425129088
813,17,3,20,40.65,271,4065,67.75,3000000000,44.28044280442804
834,12,3,15,55.6,278,4170,69.5,3000000000,43.165467625899275
492,8,4,12,41,123,2460,41,4000000000,97.5609756097561
650,12,3,15,43.333333333333336,216.66666666666666,3250,54.166666666666664,3000000000,55.38461538461539
417,7,3,10,41.7,139,2085,34.75,3000000000,86.33093525179855
474,4,3,7,67.71428571428571,158,2370,39.5,3000000000,75.94936708860759
828,13,8,21,39.42857142857143,103.5,4140,69,8000000000,115.94202898550725
815,17,3,20,40.75,271.6666666666667,4075,67.91666666666667,3000000000,44.17177914110429
609,9,3,12,50.75,203,3045,50.75,3000000000,59.11330049261083
365,7,3,10,36.5,121.66666666666667,1825,30.416666666666668,3000000000,98.63013698630137
442,5,7,12,36.833333333333336,63.142857142857146,2210,36.833333333333336,7000000000,190.04524886877826
864,13,3,16,54,288,4320,72,3000000000,41.666666666666664
988,17,3,20,49.4,329.3333333333333,4940,82.33333333333333,3000000000,36.43724696356276
1065,21,3,24,44.375,355,5325,88.75,3000000000,33.80281690140845
488,6,3,9,54.22222222222222,162.66666666666666,2440,40.666666666666664,3000000000,73.7704918032787
350,8,3,11,31.818181818181817,116.66666666666667,1750,29.166666666666668,3000000000,102.85714285714285
384,4,3,7,54.857142857142854,128,1920,32,3000000000,93.75
700,9,5,14,50,140,3500,58.333333333333336,5000000000,85.71428571428572
533,5,4,9,59.22222222222222,133.25,2665,44.416666666666664,4000000000,90.0562851782364
675,11,3,14,48.214285714285715,225,3375,56.25,3000000000,53.333333333333336
524,9,3,12,43.666666666666664,174.66666666666666,2620,43.666666666666664,3000000000,68.70229007633587
676,16,3,19,35.578947368421055,225.33333333333334,3380,56.333333333333336,3000000000,53.25443786982248
344,7,3,10,34.4,114.66666666666667,1720,28.666666666666668,3000000000,104.65116279069767
644,10,3,13,49.53846153846154,214.66666666666666,3220,53.666666666666664,3000000000,55.90062111801243
358,6,3,9,39.77777777777778,119.33333333333333,1790,29.833333333333332,3000000000,100.5586592178771
898,13,6,19,47.26315789473684,149.66666666666666,4490,74.83333333333333,6000000000,80.1781737193764
436,7,3,10,43.6,145.33333333333334,2180,36.333333333333336,3000000000,82.56880733944953
362,6,3,9,40.22222222222222,120.66666666666667,1810,30.166666666666668,3000000000,99.4475138121547
1107,16,11,27,41,100.63636363636364,5535,92.25,11000000000,119.24119241192412
138,3,3,6,23,46,690,11.5,3000000000,260.8695652173913
726,5,6,11,66,121,3630,60.5,6000000000,99.17355371900827
562,13,3,16,35.125,187.33333333333334,2810,46.833333333333336,3000000000,64.05693950177935
683,9,3,12,56.916666666666664,227.66666666666666,3415,56.916666666666664,3000000000,52.7086383601757
617,10,3,13,47.46153846153846,205.66666666666666,3085,51.416666666666664,3000000000,58.346839546191255
652,15,3,18,36.22222222222222,217.33333333333334,3260,54.333333333333336,3000000000,55.214723926380366
518,6,3,9,57.55555555555556,172.66666666666666,2590,43.166666666666664,3000000000,69.4980694980695
988,15,3,18,54.888888888888886,329.3333333333333,4940,82.33333333333333,3000000000,36.43724696356276
499,5,3,8,62.375,166.33333333333334,2495,41.583333333333336,3000000000,72.14428857715431
647,14,3,17,38.05882352941177,215.66666666666666,3235,53.916666666666664,3000000000,55.64142194744977
732,10,5,15,48.8,146.4,3660,61,5000000000,81.9672131147541
1079,15,5,20,53.95,215.8,5395,89.91666666666667,5000000000,55.60704355885079
670,11,3,14,47.857142857142854,223.33333333333334,3350,55.833333333333336,3000000000,53.731343283582085
841,17,3,20,42.05,280.3333333333333,4205,70.08333333333333,3000000000,42.80618311533888
986,13,13,26,37.92307692307692,75.84615384615384,4930,82.16666666666667,13000000000,158.21501014198782
425,5,6,11,38.63636363636363,70.83333333333333,2125,35.416666666666664,6000000000,169.41176470588238
625,6,3,9,69.44444444444444,208.33333333333334,3125,52.083333333333336,3000000000,57.6
848,16,4,20,42.4,212,4240,70.66666666666667,4000000000,56.60377358490565
795,13,3,16,49.6875,265,3975,66.25,3000000000,45.283018867924525
309,4,3,7,44.142857142857146,103,1545,25.75,3000000000,116.50485436893204
552,9,3,12,46,184,2760,46,3000000000,65.21739130434783
864,8,5,13,66.46153846153847,172.8,4320,72,5000000000,69.44444444444444
635,8,6,14,45.357142857142854,105.83333333333333,3175,52.916666666666664,6000000000,113.38582677165354
995,13,3,16,62.1875,331.6666666666667,4975,82.91666666666667,3000000000,36.18090452261306
914,14,7,21,43.523809523809526,130.57142857142858,4570,76.16666666666667,7000000000,91.90371991247264
750,15,3,18,41.666666666666664,250,3750,62.5,3000000000,48
534,12,3,15,35.6,178,2670,44.5,3000000000,67.41573033707864
553,7,6,13,42.53846153846154,92.16666666666667,2765,46.083333333333336,6000000000,130.19891500904157
547,9,3,12,45.583333333333336,182.33333333333334,2735,45.583333333333336,3000000000,65.81352833638024
761,11,5,16,47.5625,152.2,3805,63.416666666666664,5000000000,78.84362680683311
499,6,3,9,55.44444444444444,166.33333333333334,2495,41.583333333333336,3000000000,72.14428857715431
904,12,5,17,53.1764705882353,180.8,4520,75.33333333333333,5000000000,66.3716814159292
892,18,3,21,42.476190476190474,297.3333333333333,4460,74.33333333333333,3000000000,40.35874439461884
623,7,5,12,51.916666666666664,124.6,3115,51.916666666666664,5000000000,96.30818619582665
582,12,9,21,27.714285714285715,64.66666666666667,2910,48.5,9000000000,185.56701030927834
461,4,5,9,51.22222222222222,92.2,2305,38.416666666666664,5000000000,130.15184381778744
453,6,3,9,50.333333333333336,151,2265,37.75,3000000000,79.47019867549669
959,9,6,15,63.93333333333333,159.83333333333334,4795,79.91666666666667,6000000000,75.07820646506778
330,5,3,8,41.25,110,1650,27.5,3000000000,109.0909090909091
830,20,8,28,29.642857142857142,103.75,4150,69.16666666666667,8000000000,115.66265060240963
421,9,3,12,35.083333333333336,140.33333333333334,2105,35.083333333333336,3000000000,85.5106888361045
520,10,5,15,34.666666666666664,104,2600,43.333333333333336,5000000000,115.38461538461537
395,4,3,7,56.42857142857143,131.66666666666666,1975,32.916666666666664,3000000000,91.13924050632912
712,11,5,16,44.5,142.4,3560,59.333333333333336,5000000000,84.26966292134831
771,13,7,20,38.55,110.14285714285714,3855,64.25,7000000000,108.94941634241246
787,9,3,12,65.58333333333333,262.3333333333333,3935,65.58333333333333,3000000000,45.7433290978399
670,8,3,11,60.90909090909091,223.33333333333334,3350,55.833333333333336,3000000000,53.731343283582085
1225,17,4,21,58.333333333333336,306.25,6125,102.08333333333333,4000000000,39.183673469387756
540,11,4,15,36,135,2700,45,4000000000,88.8888888888889
880,10,5,15,58.666666666666664,176,4400,73.33333333333333,5000000000,68.18181818181819
809,15,6,21,38.523809523809526,134.83333333333334,4045,67.41666666666667,6000000000,88.99876390605685
509,6,3,9,56.55555555555556,169.66666666666666,2545,42.416666666666664,3000000000,70.7269155206287
499,11,3,14,35.642857142857146,166.33333333333334,2495,41.583333333333336,3000000000,72.14428857715431
648,10,3,13,49.84615384615385,216,3240,54,3000000000,55.55555555555555
449,7,3,10,44.9,149.66666666666666,2245,37.416666666666664,3000000000,80.1781737193764
258,4,5,9,28.666666666666668,51.6,1290,21.5,5000000000,232.5581395348837
446,4,3,7,63.714285714285715,148.66666666666666,2230,37.166666666666664,3000000000,80.71748878923768
603,17,3,20,30.15,201,3015,50.25,3000000000,59.701492537313435
513,5,5,10,51.3,102.6,2565,42.75,5000000000,116.95906432748538
599,8,3,11,54.45454545454545,199.66666666666666,2995,49.916666666666664,3000000000,60.10016694490819
898,9,8,17,52.8235294117647,112.25,4490,74.83333333333333,8000000000,106.9042316258352
570,13,3,16,35.625,190,2850,47.5,3000000000,63.1578947368421
421,6,4,10,42.1,105.25,2105,35.083333333333336,4000000000,114.01425178147268
434,9,3,12,36.166666666666664,144.66666666666666,2170,36.166666666666664,3000000000,82.94930875576037
683,8,3,11,62.09090909090909,227.66666666666666,3415,56.916666666666664,3000000000,52.7086383601757
373,7,4,11,33.90909090909091,93.25,1865,31.083333333333332,4000000000,128.686327077748
1156,11,7,18,64.22222222222223,165.14285714285714,5780,96.33333333333333,7000000000,72.66435986159169
267,5,3,8,33.375,89,1335,22.25,3000000000,134.83146067415728
978,15,6,21,46.57142857142857,163,4890,81.5,6000000000,73.61963190184049
287,9,3,12,23.916666666666668,95.66666666666667,1435,23.916666666666668,3000000000,125.4355400696864
1201,24,3,27,44.48148148148148,400.3333333333333,6005,100.08333333333333,3000000000,29.975020815986678
483,7,3,10,48.3,161,2415,40.25,3000000000,74.53416149068323
553,7,3,10,55.3,184.33333333333334,2765,46.083333333333336,3000000000,65.09945750452079
561,9,3,12,46.75,187,2805,46.75,3000000000,64.171122994652407
306,4,3,7,43.714285714285715,102,1530,25.5,3000000000,117.6470588235294
977,14,3,17,57.470588235294116,325.6666666666667,4885,81.41666666666667,3000000000,36.8474923234391
827,11,6,17,48.64705882352941,137.83333333333334,4135,68.91666666666667,6000000000,87.06166868198306
616,12,6,18,34.22222222222222,102.66666666666667,3080,51.333333333333336,6000000000,116.88311688311687
821,10,8,18,45.611111111111114,102.625,4105,68.41666666666667,8000000000,116.93057247259439
571,10,4,14,40.785714285714285,142.75,2855,47.583333333333336,4000000000,84.0630472854641
299,7,3,10,29.9,99.66666666666667,1495,24.916666666666668,3000000000,120.40133779264214
769,7,5,12,64.08333333333333,153.8,3845,64.08333333333333,5000000000,78.02340702210664
724,14,7,21,34.476190476190474,103.42857142857143,3620,60.333333333333336,7000000000,116.02209944751381
553,8,5,13,42.53846153846154,110.6,2765,46.083333333333336,5000000000,108.49909584086798
855,13,10,23,37.17391304347826,85.5,4275,71.25,10000000000,140.35087719298247
878,7,6,13,67.53846153846153,146.33333333333334,4390,73.16666666666667,6000000000,82.00455580865604
954,19,11,30,31.8,86.72727272727273,4770,79.5,11000000000,138.36477987421384
598,10,7,17,35.1764705882353,85.42857142857143,2990,49.833333333333336,7000000000,140.46822742474916
470,5,3,8,58.75,156.66666666666666,2350,39.166666666666664,3000000000,76.59574468085107
520,9,3,12,43.333333333333336,173.33333333333334,2600,43.333333333333336,3000000000,69.23076923076923
1170,13,8,21,55.714285714285715,146.25,5850,97.5,8000000000,82.05128205128204
413,7,4,11,37.54545454545455,103.25,2065,34.416666666666664,4000000000,116.2227602905569
723,13,3,16,45.1875,241,3615,60.25,3000000000,49.79253112033195
653,11,7,18,36.27777777777778,93.28571428571429,3265,54.416666666666664,7000000000,128.63705972434914
600,7,7,14,42.857142857142854,85.71428571428571,3000,50,7000000000,140
405,8,5,13,31.153846153846153,81,2025,33.75,5000000000,148.14814814814815
1013,9,5,14,72.35714285714286,202.6,5065,84.41666666666667,5000000000,59.23000987166831
557,11,6,17,32.76470588235294,92.83333333333333,2785,46.416666666666664,6000000000,129.26391382405745
422,6,3,9,46.888888888888886,140.66666666666666,2110,35.166666666666664,3000000000,85.30805687203792
450,8,3,11,40.90909090909091,150,2250,37.5,3000000000,80
476,5,3,8,59.5,158.66666666666666,2380,39.666666666666664,3000000000,75.63025210084035
394,7,3,10,39.4,131.33333333333334,1970,32.833333333333336,3000000000,91.3705583756345
728,8,4,12,60.666666666666664,182,3640,60.666666666666664,4000000000,65.93406593406594
1172,12,7,19,61.68421052631579,167.42857142857142,5860,97.66666666666667,7000000000,71.67235494880545
271,4,3,7,38.714285714285715,90.33333333333333,1355,22.583333333333332,3000000000,132.84132841328415
170,5,3,8,21.25,56.666666666666664,850,14.166666666666666,3000000000,211.76470588235296
866,20,3,23,37.65217391304348,288.6666666666667,4330,72.16666666666667,3000000000,41.57043879907621
762,12,5,17,44.8235294117647,152.4,3810,63.5,5000000000,78.74015748031495
509,5,3,8,63.625,169.66666666666666,2545,42.416666666666664,3000000000,70.7269155206287
541,11,3,14,38.642857142857146,180.33333333333334,2705,45.083333333333336,3000000000,66.54343807763401
949,16,4,20,47.45,237.25,4745,79.08333333333333,4000000000,50.579557428872505
608,7,3,10,60.8,202.66666666666666,3040,50.666666666666664,3000000000,59.21052631578947
599,9,3,12,49.916666666666664,199.66666666666666,2995,49.916666666666664,3000000000,60.10016694490819
327,3,3,6,54.5,109,1635,27.25,3000000000,110.09174311926604
646,13,4,17,38,161.5,3230,53.833333333333336,4000000000,74.30340557275541
455,5,4,9,50.55555555555556,113.75,2275,37.916666666666664,4000000000,105.49450549450549
429,9,3,12,35.75,143,2145,35.75,3000000000,83.91608391608392
794,13,3,16,49.625,264.6666666666667,3970,66.16666666666667,3000000000,45.34005037783375
750,10,9,19,39.473684210526315,83.33333333333333,3750,62.5,9000000000,144
622,9,3,12,51.833333333333336,207.33333333333334,3110,51.833333333333336,3000000000,57.877813504823145
438,8,3,11,39.81818181818182,146,2190,36.5,3000000000,82.1917808219178
1003,18,7,25,40.12,143.28571428571428,5015,83.58333333333333,7000000000,83.74875373878366
388,5,5,10,38.8,77.6,1940,32.333333333333336,5000000000,154.63917525773195
603,9,4,13,46.38461538461539,150.75,3015,50.25,4000000000,79.60199004975124
923,14,8,22,41.95454545454545,115.375,4615,76.91666666666667,8000000000,104.00866738894906
280,5,3,8,35,93.33333333333333,1400,23.333333333333332,3000000000,128.57142857142858
594,7,3,10,59.4,198,2970,49.5,3000000000,60.60606060606061
967,15,9,24,40.291666666666664,107.44444444444444,4835,80.58333333333333,9000000000,111.68562564632884
166,5,3,8,20.75,55.333333333333336,830,13.833333333333334,3000000000,216.86746987951807
298,4,3,7,42.57142857142857,99.33333333333333,1490,24.833333333333332,3000000000,120.8053691275168
1071,14,3,17,63,357,5355,89.25,3000000000,33.61344537815126
501,8,3,11,45.54545454545455,167,2505,41.75,3000000000,71.85628742514969
774,14,7,21,36.857142857142854,110.57142857142857,3870,64.5,7000000000,108.52713178294573
311,7,3,10,31.1,103.66666666666667,1555,25.916666666666668,3000000000,115.75562700964629
352,4,4,8,44,88,1760,29.333333333333332,4000000000,136.36363636363637
647,15,3,18,35.94444444444444,215.66666666666666,3235,53.916666666666664,3000000000,55.64142194744977
399,8,3,11,36.27272727272727,133,1995,33.25,3000000000,90.22556390977444
1009,10,7,17,59.35294117647059,144.14285714285714,5045,84.08333333333333,7000000000,83.25074331020812
442,7,4,11,40.18181818181818,110.5,2210,36.833333333333336,4000000000,108.5972850678733
959,17,5,22,43.59090909090909,191.8,4795,79.91666666666667,5000000000,62.56517205422314
402,9,4,13,30.923076923076923,100.5,2010,33.5,4000000000,119.40298507462687
1175,21,3,24,48.958333333333336,391.6666666666667,5875,97.91666666666667,3000000000,30.638297872340427
757,15,3,18,42.05555555555556,252.33333333333334,3785,63.083333333333336,3000000000,47.556142668428
852,11,3,14,60.857142857142854,284,4260,71,3000000000,42.25352112676057
851,11,15,26,32.73076923076923,56.733333333333334,4255,70.91666666666667,15000000000,211.51586368977672
597,11,6,17,35.11764705882353,99.5,2985,49.75,6000000000,120.60301507537689
673,5,3,8,84.125,224.33333333333334,3365,56.083333333333336,3000000000,53.49182763744428
409,5,3,8,51.125,136.33333333333334,2045,34.083333333333336,3000000000,88.01955990220048
1042,10,5,15,69.46666666666667,208.4,5210,86.83333333333333,5000000000,57.58157389635317
420,10,4,14,30,105,2100,35,4000000000,114.28571428571428
222,6,3,9,24.666666666666668,74,1110,18.5,3000000000,162.16216216216216
533,6,3,9,59.22222222222222,177.66666666666666,2665,44.416666666666664,3000000000,67.5422138836773
800,10,5,15,53.333333333333336,160,4000,66.66666666666667,5000000000,75
718,12,3,15,47.86666666666667,239.33333333333334,3590,59.833333333333336,3000000000,50.139275766016716
739,11,6,17,43.470588235294116,123.16666666666667,3695,61.583333333333336,6000000000,97.42895805142084
605,6,9,15,40.333333333333336,67.22222222222223,3025,50.416666666666664,9000000000,178.51239669421489
372,5,3,8,46.5,124,1860,31,3000000000,96.77419354838709
707,11,3,14,50.5,235.66666666666666,3535,58.916666666666664,3000000000,50.91937765205092
683,3,3,6,113.83333333333333,227.66666666666666,3415,56.916666666666664,3000000000,52.7086383601757
1038,7,7,14,74.14285714285714,148.28571428571428,5190,86.5,7000000000,80.92485549132948
411,5,3,8,51.375,137,2055,34.25,3000000000,87.59124087591242
415,12,3,15,27.666666666666668,138.33333333333334,2075,34.583333333333336,3000000000,86.74698795180721
373,11,3,14,26.642857142857142,124.33333333333333,1865,31.083333333333332,3000000000,96.514745308311
511,4,5,9,56.77777777777778,102.2,2555,42.583333333333336,5000000000,117.41682974559686
324,5,3,8,40.5,108,1620,27,3000000000,111.1111111111111
1049,23,9,32,32.78125,116.55555555555556,5245,87.41666666666667,9000000000,102.95519542421353
456,5,3,8,57,152,2280,38,3000000000,78.94736842105263
717,13,4,17,42.1764705882353,179.25,3585,59.75,4000000000,66.94560669456067
657,10,6,16,41.0625,109.5,3285,54.75,6000000000,109.58904109589042
1194,13,6,19,62.8421052631579,199,5970,99.5,6000000000,60.301507537688444
723,16,3,19,38.05263157894737,241,3615,60.25,3000000000,49.79253112033195
747,13,3,16,46.6875,249,3735,62.25,3000000000,48.192771084337345
980,11,8,19,51.578947368421055,122.5,4900,81.66666666666667,8000000000,97.95918367346938
794,10,9,19,41.78947368421053,88.22222222222223,3970,66.16666666666667,9000000000,136.02015113350126
1332,17,8,25,53.28,166.5,6660,111,8000000000,72.07207207207207
628,13,6,19,33.05263157894737,104.66666666666667,3140,52.333333333333336,6000000000,114.64968152866241
940,18,10,28,33.57142857142857,94,4700,78.33333333333333,10000000000,127.65957446808511
411,5,3,8,51.375,137,2055,34.25,3000000000,87.59124087591242
477,8,3,11,43.36363636363637,159,2385,39.75,3000000000,75.47169811320755
668,15,3,18,37.111111111111114,222.66666666666666,3340,55.666666666666664,3000000000,53.89221556886228
621,10,3,13,47.76923076923077,207,3105,51.75,3000000000,57.971014492753625
633,8,5,13,48.69230769230769,126.6,3165,52.75,5000000000,94.7867298578199
550,17,3,20,27.5,183.33333333333334,2750,45.833333333333336,3000000000,65.45454545454545
602,12,3,15,40.13333333333333,200.66666666666666,3010,50.166666666666664,3000000000,59.800664451827245
521,5,5,10,52.1,104.2,2605,43.416666666666664,5000000000,115.16314779270634
646,12,3,15,43.06666666666667,215.33333333333334,3230,53.833333333333336,3000000000,55.72755417956656
1266,17,9,26,48.69230769230769,140.66666666666666,6330,105.5,9000000000,85.30805687203792
532,8,4,12,44.333333333333336,133,2660,44.333333333333336,4000000000,90.22556390977444
958,14,5,19,50.421052631578945,191.6,4790,79.83333333333333,5000000000,62.630480167014625
692,11,3,14,49.42857142857143,230.66666666666666,3460,57.666666666666664,3000000000,52.02312138728323
725,15,5,20,36.25,145,3625,60.416666666666664,5000000000,82.75862068965517
254,5,4,9,28.22222222222222,63.5,1270,21.166666666666668,4000000000,188.9763779527559
570,9,3,12,47.5,190,2850,47.5,3000000000,63.1578947368421
835,16,3,19,43.94736842105263,278.3333333333333,4175,69.58333333333333,3000000000,43.11377245508982
236,6,3,9,26.22222222222222,78.66666666666667,1180,19.666666666666668,3000000000,152.5423728813559
254,5,3,8,31.75,84.66666666666667,1270,21.166666666666668,3000000000,141.7322834645669
650,15,3,18,36.111111111111114,216.66666666666666,3250,54.166666666666664,3000000000,55.38461538461539
761,12,6,18,42.27777777777778,126.83333333333333,3805,63.416666666666664,6000000000,94.61235216819975
403,8,4,12,33.583333333333336,100.75,2015,33.583333333333336,4000000000,119.10669975186103
682,13,3,16,42.625,227.33333333333334,3410,56.833333333333336,3000000000,52.785923753665685
638,6,7,13,49.07692307692308,91.14285714285714,3190,53.166666666666664,7000000000,131.6614420062696
429,8,3,11,39,143,2145,35.75,3000000000,83.91608391608392
1055,17,3,20,52.75,351.6666666666667,5275,87.91666666666667,3000000000,34.12322274881517
697,9,3,12,58.083333333333336,232.33333333333334,3485,58.083333333333336,3000000000,51.649928263988514
561,6,4,10,56.1,140.25,2805,46.75,4000000000,85.56149732620321
423,6,3,9,47,141,2115,35.25,3000000000,85.1063829787234
493,5,3,8,61.625,164.33333333333334,2465,41.083333333333336,3000000000,73.02231237322515
686,13,3,16,42.875,228.66666666666666,3430,57.166666666666664,3000000000,52.478134110787174
996,22,5,27,36.888888888888886,199.2,4980,83,5000000000,60.24096385542168
677,11,3,14,48.357142857142854,225.66666666666666,3385,56.416666666666664,3000000000,53.17577548005909
431,8,3,11,39.18181818181818,143.66666666666666,2155,35.916666666666664,3000000000,83.52668213457078
509,8,3,11,46.27272727272727,169.66666666666666,2545,42.416666666666664,3000000000,70.7269155206287
442,3,3,6,73.66666666666667,147.33333333333334,2210,36.833333333333336,3000000000,81.44796380090497
337,3,5,8,42.125,67.4,1685,28.083333333333332,5000000000,178.04154302670625
368,6,3,9,40.888888888888886,122.66666666666667,1840,30.666666666666668,3000000000,97.82608695652173
1024,16,10,26,39.38461538461539,102.4,5120,85.33333333333333,10000000000,117.1875
335,7,3,10,33.5,111.66666666666667,1675,27.916666666666668,3000000000,107.46268656716417
401,3,6,9,44.55555555555556,66.83333333333333,2005,33.416666666666664,6000000000,179.55112219451374
654,13,3,16,40.875,218,3270,54.5,3000000000,55.04587155963302
237,4,3,7,33.857142857142854,79,1185,19.75,3000000000,151.89873417721518
1343,23,3,26,51.65384615384615,447.6666666666667,6715,111.91666666666667,3000000000,26.805658972449738
908,17,12,29,31.310344827586206,75.66666666666667,4540,75.66666666666667,12000000000,158.59030837004406
264,4,3,7,37.714285714285715,88,1320,22,3000000000,136.36363636363637
531,7,3,10,53.1,177,2655,44.25,3000000000,67.79661016949153
430,8,3,11,39.09090909090909,143.33333333333334,2150,35.833333333333336,3000000000,83.72093023255813
284,4,3,7,40.57142857142857,94.66666666666667,1420,23.666666666666668,3000000000,126.76056338028168
714,17,7,24,29.75,102,3570,59.5,7000000000,117.6470588235294
888,11,5,16,55.5,177.6,4440,74,5000000000,67.56756756756758
877,13,6,19,46.1578947368421,146.16666666666666,4385,73.08333333333333,6000000000,82.09806157354619
229,5,4,9,25.444444444444443,57.25,1145,19.083333333333332,4000000000,209.60698689956334
231,5,4,9,25.666666666666668,57.75,1155,19.25,4000000000,207.7922077922078
457,12,3,15,30.466666666666665,152.33333333333334,2285,38.083333333333336,3000000000,78.77461706783369
1398,20,3,23,60.78260869565217,466,6990,116.5,3000000000,25.75107296137339
581,8,6,14,41.5,96.83333333333333,2905,48.416666666666664,6000000000,123.92426850258175
471,7,3,10,47.1,157,2355,39.25,3000000000,76.43312101910828
336,6,5,11,30.545454545454547,67.2,1680,28,5000000000,178.57142857142856
787,11,3,14,56.214285714285715,262.3333333333333,3935,65.58333333333333,3000000000,45.7433290978399
502,11,3,14,35.857142857142854,167.33333333333334,2510,41.833333333333336,3000000000,71.71314741035856
570,6,3,9,63.333333333333336,190,2850,47.5,3000000000,63.1578947368421
934,14,3,17,54.94117647058823,311.3333333333333,4670,77.83333333333333,3000000000,38.54389721627409
775,13,7,20,38.75,110.71428571428571,3875,64.58333333333333,7000000000,108.38709677419355
174,9,3,12,14.5,58,870,14.5,3000000000,206.89655172413794
313,9,4,13,24.076923076923077,78.25,1565,26.083333333333332,4000000000,153.3546325878594
590,16,3,19,31.05263157894737,196.66666666666666,2950,49.166666666666664,3000000000,61.016949152542374
282,5,3,8,35.25,94,1410,23.5,3000000000,127.65957446808511
950,19,3,22,43.18181818181818,316.6666666666667,4750,79.16666666666667,3000000000,37.89473684210526
791,11,3,14,56.5,263.6666666666667,3955,65.91666666666667,3000000000,45.51201011378002
882,16,3,19,46.421052631578945,294,4410,73.5,3000000000,40.816326530612244
597,12,5,17,35.11764705882353,119.4,2985,49.75,5000000000,100.50251256281408
767,19,9,28,27.392857142857142,85.22222222222223,3835,63.916666666666664,9000000000,140.80834419817472
455,10,3,13,35,151.66666666666666,2275,37.916666666666664,3000000000,79.12087912087912
743,9,6,15,49.53333333333333,123.83333333333333,3715,61.916666666666664,6000000000,96.90444145356662
346,4,3,7,49.42857142857143,115.33333333333333,1730,28.833333333333332,3000000000,104.04624277456647
751,11,3,14,53.642857142857146,250.33333333333334,3755,62.583333333333336,3000000000,47.93608521970706
626,11,3,14,44.714285714285715,208.66666666666666,3130,52.166666666666664,3000000000,57.50798722044728
360,8,3,11,32.72727272727273,120,1800,30,3000000000,100
1018,16,5,21,48.476190476190474,203.6,5090,84.83333333333333,5000000000,58.93909626719058
525,9,7,16,32.8125,75,2625,43.75,7000000000,160
206,6,3,9,22.88888888888889,68.66666666666667,1030,17.166666666666668,3000000000,174.75728155339803
271,5,4,9,30.11111111111111,67.75,1355,22.583333333333332,4000000000,177.1217712177122
291,4,5,9,32.333333333333336,58.2,1455,24.25,5000000000,206.18556701030928
523,7,4,11,47.54545454545455,130.75,2615,43.583333333333336,4000000000,91.77820267686424
725,10,3,13,55.76923076923077,241.66666666666666,3625,60.416666666666664,3000000000,49.6551724137931
470,9,6,15,31.333333333333332,78.33333333333333,2350,39.166666666666664,6000000000,153.19148936170214
574,12,3,15,38.266666666666666,191.33333333333334,2870,47.833333333333336,3000000000,62.7177700348432
565,11,4,15,37.666666666666664,141.25,2825,47.083333333333336,4000000000,84.95575221238938
749,14,3,17,44.05882352941177,249.66666666666666,3745,62.416666666666664,3000000000,48.06408544726302
995,20,3,23,43.26086956521739,331.6666666666667,4975,82.91666666666667,3000000000,36.18090452261306
503,11,3,14,35.92857142857143,167.66666666666666,2515,41.916666666666664,3000000000,71.57057654075547
529,7,3,10,52.9,176.33333333333334,2645,44.083333333333336,3000000000,68.05293005671076
1358,19,3,22,61.72727272727273,452.6666666666667,6790,113.16666666666667,3000000000,26.50957290132548
685,9,3,12,57.083333333333336,228.33333333333334,3425,57.083333333333336,3000000000,52.55474452554744
515,11,3,14,36.785714285714285,171.66666666666666,2575,42.916666666666664,3000000000,69.90291262135923
958,10,5,15,63.86666666666667,191.6,4790,79.83333333333333,5000000000,62.630480167014625
277,6,3,9,30.77777777777778,92.33333333333333,1385,23.083333333333332,3000000000,129.9638989169675
1143,20,3,23,49.69565217391305,381,5715,95.25,3000000000,31.496062992125985
1054,14,6,20,52.7,175.66666666666666,5270,87.83333333333333,6000000000,68.3111954459203
698,11,5,16,43.625,139.6,3490,58.166666666666664,5000000000,85.95988538681948
552,10,4,14,39.42857142857143,138,2760,46,4000000000,86.95652173913044
850,11,3,14,60.714285714285715,283.3333333333333,4250,70.83333333333333,3000000000,42.352941176470594
239,3,4,7,34.142857142857146,59.75,1195,19.916666666666668,4000000000,200.836820083682
506,11,7,18,28.11111111111111,72.28571428571429,2530,42.166666666666664,7000000000,166.00790513833994
659,8,5,13,50.69230769230769,131.8,3295,54.916666666666664,5000000000,91.04704097116844
687,7,7,14,49.07142857142857,98.14285714285714,3435,57.25,7000000000,122.27074235807859
311,4,4,8,38.875,77.75,1555,25.916666666666668,4000000000,154.34083601286173
433,6,3,9,48.111111111111114,144.33333333333334,2165,36.083333333333336,3000000000,83.14087759815241
606,18,3,21,28.857142857142858,202,3030,50.5,3000000000,59.40594059405941
619,7,3,10,61.9,206.33333333333334,3095,51.583333333333336,3000000000,58.158319870759286
1162,13,3,16,72.625,387.3333333333333,5810,96.83333333333333,3000000000,30.98106712564544
490,5,7,12,40.833333333333336,70,2450,40.833333333333336,7000000000,171.42857142857144
1620,22,3,25,64.8,540,8100,135,3000000000,22.222222222222225
246,3,3,6,41,82,1230,20.5,3000000000,146.34146341463415
832,9,4,13,64,208,4160,69.33333333333333,4000000000,57.69230769230769
573,10,7,17,33.705882352941174,81.85714285714286,2865,47.75,7000000000,146.59685863874347
476,10,3,13,36.61538461538461,158.66666666666666,2380,39.666666666666664,3000000000,75.63025210084035
425,12,3,15,28.333333333333332,141.66666666666666,2125,35.416666666666664,3000000000,84.70588235294119
864,14,3,17,50.8235294117647,288,4320,72,3000000000,41.666666666666664
681,7,3,10,68.1,227,3405,56.75,3000000000,52.86343612334802
595,14,3,17,35,198.33333333333334,2975,49.583333333333336,3000000000,60.50420168067227
749,13,3,16,46.8125,249.66666666666666,3745,62.416666666666664,3000000000,48.06408544726302
567,10,4,14,40.5,141.75,2835,47.25,4000000000,84.65608465608466
751,12,3,15,50.06666666666667,250.33333333333334,3755,62.583333333333336,3000000000,47.93608521970706
595,8,3,11,54.09090909090909,198.33333333333334,2975,49.583333333333336,3000000000,60.50420168067227
897,13,7,20,44.85,128.14285714285714,4485,74.75,7000000000,93.64548494983278
270,5,4,9,30,67.5,1350,22.5,4000000000,177.7777777777778
915,14,5,19,48.1578947368421,183,4575,76.25,5000000000,65.57377049180329
385,8,3,11,35,128.33333333333334,1925,32.083333333333336,3000000000,93.5064935064935
623,10,6,16,38.9375,103.83333333333333,3115,51.916666666666664,6000000000,115.56982343499199
924,6,6,12,77,154,4620,77,6000000000,77.92207792207792
903,13,4,17,53.11764705882353,225.75,4515,75.25,4000000000,53.15614617940199
330,5,4,9,36.666666666666664,82.5,1650,27.5,4000000000,145.45454545454547
1056,17,11,28,37.714285714285715,96,5280,88,11000000000,125
453,6,3,9,50.333333333333336,151,2265,37.75,3000000000,79.47019867549669
826,13,3,16,51.625,275.3333333333333,4130,68.83333333333333,3000000000,43.58353510895884
604,7,3,10,60.4,201.33333333333334,3020,50.333333333333336,3000000000,59.602649006622514
589,4,4,8,73.625,147.25,2945,49.083333333333336,4000000000,81.49405772495756
1160,18,11,29,40,105.45454545454545,5800,96.66666666666667,11000000000,113.79310344827584
734,12,3,15,48.93333333333333,244.66666666666666,3670,61.166666666666664,3000000000,49.04632152588556
757,6,11,17,44.529411764705884,68.81818181818181,3785,63.083333333333336,11000000000,174.37252311756936
355,5,3,8,44.375,118.33333333333333,1775,29.583333333333332,3000000000,101.40845070422536
1036,14,5,19,54.526315789473685,207.2,5180,86.33333333333333,5000000000,57.91505791505792
673,17,3,20,33.65,224.33333333333334,3365,56.083333333333336,3000000000,53.49182763744428
356,8,3,11,32.36363636363637,118.66666666666667,1780,29.666666666666668,3000000000,101.12359550561797
793,10,3,13,61,264.3333333333333,3965,66.08333333333333,3000000000,45.39722572509458
537,11,3,14,38.357142857142854,179,2685,44.75,3000000000,67.0391061452514
1162,12,3,15,77.46666666666667,387.3333333333333,5810,96.83333333333333,3000000000,30.98106712564544
430,7,3,10,43,143.33333333333334,2150,35.833333333333336,3000000000,83.72093023255813
459,8,3,11,41.72727272727273,153,2295,38.25,3000000000,78.4313725490196
373,6,4,10,37.3,93.25,1865,31.083333333333332,4000000000,128.686327077748
504,10,4,14,36,126,2520,42,4000000000,95.23809523809524
406,6,3,9,45.111111111111114,135.33333333333334,2030,33.833333333333336,3000000000,88.66995073891624
1052,13,9,22,47.81818181818182,116.88888888888889,5260,87.66666666666667,9000000000,102.6615969581749
540,5,3,8,67.5,180,2700,45,3000000000,66.66666666666666
778,9,3,12,64.83333333333333,259.3333333333333,3890,64.83333333333333,3000000000,46.27249357326478
363,6,3,9,40.333333333333336,121,1815,30.25,3000000000,99.17355371900827
702,7,5,12,58.5,140.4,3510,58.5,5000000000,85.47008547008546
240,4,3,7,34.285714285714285,80,1200,20,3000000000,150
1142,25,4,29,39.37931034482759,285.5,5710,95.16666666666667,4000000000,42.03152364273205
553,5,3,8,69.125,184.33333333333334,2765,46.083333333333336,3000000000,65.09945750452079
397,6,4,10,39.7,99.25,1985,33.083333333333336,4000000000,120.90680100755667
859,17,5,22,39.04545454545455,171.8,4295,71.58333333333333,5000000000,69.84866123399303
879,11,4,15,58.6,219.75,4395,73.25,4000000000,54.6075085324232
631,8,3,11,57.36363636363637,210.33333333333334,3155,52.583333333333336,3000000000,57.05229793977813
1178,13,8,21,56.095238095238095,147.25,5890,98.16666666666667,8000000000,81.49405772495756
521,10,3,13,40.07692307692308,173.66666666666666,2605,43.416666666666664,3000000000,69.0978886756238
581,7,3,10,58.1,193.66666666666666,2905,48.416666666666664,3000000000,61.96213425129088
208,4,3,7,29.714285714285715,69.33333333333333,1040,17.333333333333332,3000000000,173.0769230769231
409,9,3,12,34.083333333333336,136.33333333333334,2045,34.083333333333336,3000000000,88.01955990220048
541,8,7,15,36.06666666666667,77.28571428571429,2705,45.083333333333336,7000000000,155.26802218114602
978,18,3,21,46.57142857142857,326,4890,81.5,3000000000,36.809815950920246
536,13,3,16,33.5,178.66666666666666,2680,44.666666666666664,3000000000,67.16417910447761
328,5,3,8,41,109.33333333333333,1640,27.333333333333332,3000000000,109.7560975609756
1011,13,3,16,63.1875,337,5055,84.25,3000000000,35.60830860534125
382,9,3,12,31.833333333333332,127.33333333333333,1910,31.833333333333332,3000000000,94.24083769633508
311,7,3,10,31.1,103.66666666666667,1555,25.916666666666668,3000000000,115.75562700964629
313,5,3,8,39.125,104.33333333333333,1565,26.083333333333332,3000000000,115.01597444089457
590,8,7,15,39.333333333333336,84.28571428571429,2950,49.166666666666664,7000000000,142.3728813559322
705,8,5,13,54.23076923076923,141,3525,58.75,5000000000,85.1063829787234
962,9,4,13,74,240.5,4810,80.16666666666667,4000000000,49.896049896049895
752,12,6,18,41.77777777777778,125.33333333333333,3760,62.666666666666664,6000000000,95.74468085106383
615,11,7,18,34.166666666666664,87.85714285714286,3075,51.25,7000000000,136.58536585365852
460,10,6,16,28.75,76.66666666666667,2300,38.333333333333336,6000000000,156.52173913043478
753,10,3,13,57.92307692307692,251,3765,62.75,3000000000,47.808764940239044
770,10,4,14,55,192.5,3850,64.16666666666667,4000000000,62.33766233766233
759,14,4,18,42.166666666666664,189.75,3795,63.25,4000000000,63.241106719367586
620,17,5,22,28.181818181818183,124,3100,51.666666666666664,5000000000,96.77419354838709
759,15,3,18,42.166666666666664,253,3795,63.25,3000000000,47.430830039525695
318,10,3,13,24.46153846153846,106,1590,26.5,3000000000,113.20754716981132
469,6,4,10,46.9,117.25,2345,39.083333333333336,4000000000,102.34541577825159
574,15,3,18,31.88888888888889,191.33333333333334,2870,47.833333333333336,3000000000,62.7177700348432
508,6,4,10,50.8,127,2540,42.333333333333336,4000000000,94.48818897637796
384,10,3,13,29.53846153846154,128,1920,32,3000000000,93.75
509,9,3,12,42.416666666666664,169.66666666666666,2545,42.416666666666664,3000000000,70.7269155206287
857,10,6,16,53.5625,142.83333333333334,4285,71.41666666666667,6000000000,84.01400233372227
599,9,4,13,46.07692307692308,149.75,2995,49.916666666666664,4000000000,80.13355592654425
896,15,6,21,42.666666666666664,149.33333333333334,4480,74.66666666666667,6000000000,80.35714285714285
277,8,3,11,25.181818181818183,92.33333333333333,1385,23.083333333333332,3000000000,129.9638989169675
1137,17,3,20,56.85,379,5685,94.75,3000000000,31.6622691292876
1393,17,3,20,69.65,464.3333333333333,6965,116.08333333333333,3000000000,25.843503230437904
519,7,3,10,51.9,173,2595,43.25,3000000000,69.36416184971098
601,11,4,15,40.06666666666667,150.25,3005,50.083333333333336,4000000000,79.86688851913478
218,4,4,8,27.25,54.5,1090,18.166666666666668,4000000000,220.18348623853208
1152,9,8,17,67.76470588235294,144,5760,96,8000000000,83.33333333333333
667,10,4,14,47.642857142857146,166.75,3335,55.583333333333336,4000000000,71.9640179910045
1053,11,12,23,45.78260869565217,87.75,5265,87.75,12000000000,136.75213675213678
527,5,5,10,52.7,105.4,2635,43.916666666666664,5000000000,113.85199240986718
350,8,3,11,31.818181818181817,116.66666666666667,1750,29.166666666666668,3000000000,102.85714285714285
865,13,12,25,34.6,72.08333333333333,4325,72.08333333333333,12000000000,166.47398843930637
473,9,9,18,26.27777777777778,52.55555555555556,2365,39.416666666666664,9000000000,228.32980972515858
885,10,3,13,68.07692307692308,295,4425,73.75,3000000000,40.67796610169491
824,14,5,19,43.36842105263158,164.8,4120,68.66666666666667,5000000000,72.81553398058252
355,4,3,7,50.714285714285715,118.33333333333333,1775,29.583333333333332,3000000000,101.40845070422536
1122,19,5,24,46.75,224.4,5610,93.5,5000000000,53.475935828877
384,7,3,10,38.4,128,1920,32,3000000000,93.75
650,7,4,11,59.09090909090909,162.5,3250,54.166666666666664,4000000000,73.84615384615385
432,6,4,10,43.2,108,2160,36,4000000000,111.1111111111111
565,11,6,17,33.23529411764706,94.16666666666667,2825,47.083333333333336,6000000000,127.43362831858407
710,17,3,20,35.5,236.66666666666666,3550,59.166666666666664,3000000000,50.70422535211268
143,4,3,7,20.428571428571427,47.666666666666664,715,11.916666666666666,3000000000,251.74825174825176
387,6,3,9,43,129,1935,32.25,3000000000,93.02325581395348
965,18,3,21,45.95238095238095,321.6666666666667,4825,80.41666666666667,3000000000,37.30569948186528
739,10,3,13,56.84615384615385,246.33333333333334,3695,61.583333333333336,3000000000,48.71447902571042
585,4,4,8,73.125,146.25,2925,48.75,4000000000,82.05128205128204
628,8,3,11,57.09090909090909,209.33333333333334,3140,52.333333333333336,3000000000,57.324840764331206
489,6,5,11,44.45454545454545,97.8,2445,40.75,5000000000,122.69938650306747
1097,21,9,30,36.56666666666667,121.88888888888889,5485,91.41666666666667,9000000000,98.45031905195988
756,12,7,19,39.78947368421053,108,3780,63,7000000000,111.1111111111111
902,15,6,21,42.95238095238095,150.33333333333334,4510,75.16666666666667,6000000000,79.82261640798227
573,10,4,14,40.92857142857143,143.25,2865,47.75,4000000000,83.7696335078534
243,3,3,6,40.5,81,1215,20.25,3000000000,148.14814814814815
659,13,3,16,41.1875,219.66666666666666,3295,54.916666666666664,3000000000,54.628224582701066
1102,13,3,16,68.875,367.3333333333333,5510,91.83333333333333,3000000000,32.667876588021784
490,9,5,14,35,98,2450,40.833333333333336,5000000000,122.44897959183672
675,15,4,19,35.526315789473685,168.75,3375,56.25,4000000000,71.1111111111111
659,7,4,11,59.90909090909091,164.75,3295,54.916666666666664,4000000000,72.83763277693475
392,7,3,10,39.2,130.66666666666666,1960,32.666666666666664,3000000000,91.83673469387756
591,6,5,11,53.72727272727273,118.2,2955,49.25,5000000000,101.52284263959392
1317,18,3,21,62.714285714285715,439,6585,109.75,3000000000,27.33485193621868
369,7,3,10,36.9,123,1845,30.75,3000000000,97.5609756097561
1082,18,6,24,45.083333333333336,180.33333333333334,5410,90.16666666666667,6000000000,66.54343807763401
635,7,3,10,63.5,211.66666666666666,3175,52.916666666666664,3000000000,56.69291338582677
423,7,3,10,42.3,141,2115,35.25,3000000000,85.1063829787234
872,14,9,23,37.91304347826087,96.88888888888889,4360,72.66666666666667,9000000000,123.8532110091743
691,8,3,11,62.81818181818182,230.33333333333334,3455,57.583333333333336,3000000000,52.098408104196814
573,10,3,13,44.07692307692308,191,2865,47.75,3000000000,62.82722513089005
335,6,3,9,37.22222222222222,111.66666666666667,1675,27.916666666666668,3000000000,107.46268656716417
503,3,3,6,83.83333333333333,167.66666666666666,2515,41.916666666666664,3000000000,71.57057654075547
382,7,3,10,38.2,127.33333333333333,1910,31.833333333333332,3000000000,94.24083769633508
546,11,10,21,26,54.6,2730,45.5,10000000000,219.7802197802198
281,6,3,9,31.22222222222222,93.66666666666667,1405,23.416666666666668,3000000000,128.1138790035587
639,10,3,13,49.15384615384615,213,3195,53.25,3000000000,56.33802816901408
517,9,4,13,39.76923076923077,129.25,2585,43.083333333333336,4000000000,92.84332688588007
558,9,5,14,39.857142857142854,111.6,2790,46.5,5000000000,107.52688172043011
939,12,5,17,55.23529411764706,187.8,4695,78.25,5000000000,63.897763578274756
306,8,3,11,27.818181818181817,102,1530,25.5,3000000000,117.6470588235294
520,11,3,14,37.142857142857146,173.33333333333334,2600,43.333333333333336,3000000000,69.23076923076923
451,10,3,13,34.69230769230769,150.33333333333334,2255,37.583333333333336,3000000000,79.82261640798227
806,10,3,13,62,268.6666666666667,4030,67.16666666666667,3000000000,44.66501240694789
769,6,5,11,69.9090909090909,153.8,3845,64.08333333333333,5000000000,78.02340702210664
832,5,3,8,104,277.3333333333333,4160,69.33333333333333,3000000000,43.269230769230774
188,5,3,8,23.5,62.666666666666664,940,15.666666666666666,3000000000,191.48936170212767
748,13,8,21,35.61904761904762,93.5,3740,62.333333333333336,8000000000,128.34224598930481
372,6,3,9,41.333333333333336,124,1860,31,3000000000,96.77419354838709
479,11,3,14,34.214285714285715,159.66666666666666,2395,39.916666666666664,3000000000,75.15657620041755
466,5,3,8,58.25,155.33333333333334,2330,38.833333333333336,3000000000,77.25321888412017
721,11,8,19,37.94736842105263,90.125,3605,60.083333333333336,8000000000,133.14840499306518
1024,14,5,19,53.89473684210526,204.8,5120,85.33333333333333,5000000000,58.59375
463,6,3,9,51.44444444444444,154.33333333333334,2315,38.583333333333336,3000000000,77.7537796976242
645,19,5,24,26.875,129,3225,53.75,5000000000,93.02325581395348
745,12,6,18,41.388888888888886,124.16666666666667,3725,62.083333333333336,6000000000,96.64429530201342
1118,14,8,22,50.81818181818182,139.75,5590,93.16666666666667,8000000000,85.86762075134168
463,7,3,10,46.3,154.33333333333334,2315,38.583333333333336,3000000000,77.7537796976242
696,15,5,20,34.8,139.2,3480,58,5000000000,86.20689655172414
744,9,4,13,57.23076923076923,186,3720,62,4000000000,64.51612903225806
362,5,3,8,45.25,120.66666666666667,1810,30.166666666666668,3000000000,99.4475138121547
698,15,3,18,38.77777777777778,232.66666666666666,3490,58.166666666666664,3000000000,51.5759312320917
882,16,3,19,46.421052631578945,294,4410,73.5,3000000000,40.816326530612244
457,5,4,9,50.77777777777778,114.25,2285,38.083333333333336,4000000000,105.03282275711159
1587,14,8,22,72.13636363636364,198.375,7935,132.25,8000000000,60.49149338374291
531,4,5,9,59,106.2,2655,44.25,5000000000,112.99435028248587
966,16,4,20,48.3,241.5,4830,80.5,4000000000,49.68944099378882
578,8,5,13,44.46153846153846,115.6,2890,48.166666666666664,5000000000,103.80622837370242
260,6,3,9,28.88888888888889,86.66666666666667,1300,21.666666666666668,3000000000,138.46153846153845
474,9,4,13,36.46153846153846,118.5,2370,39.5,4000000000,101.26582278481013
654,10,4,14,46.714285714285715,163.5,3270,54.5,4000000000,73.39449541284404
703,17,4,21,33.476190476190474,175.75,3515,58.583333333333336,4000000000,68.27880512091038
542,11,8,19,28.526315789473685,67.75,2710,45.166666666666664,8000000000,177.1217712177122
524,9,3,12,43.666666666666664,174.66666666666666,2620,43.666666666666664,3000000000,68.70229007633587
322,5,3,8,40.25,107.33333333333333,1610,26.833333333333332,3000000000,111.80124223602486
539,9,3,12,44.916666666666664,179.66666666666666,2695,44.916666666666664,3000000000,66.79035250463822
1117,17,7,24,46.541666666666664,159.57142857142858,5585,93.08333333333333,7000000000,75.20143240823636
262,5,3,8,32.75,87.33333333333333,1310,21.833333333333332,3000000000,137.40458015267174
762,9,3,12,63.5,254,3810,63.5,3000000000,47.24409448818898
777,16,3,19,40.89473684210526,259,3885,64.75,3000000000,46.33204633204633
415,9,3,12,34.583333333333336,138.33333333333334,2075,34.583333333333336,3000000000,86.74698795180721
480,11,3,14,34.285714285714285,160,2400,40,3000000000,75
582,8,5,13,44.76923076923077,116.4,2910,48.5,5000000000,103.09278350515464
773,14,3,17,45.470588235294116,257.6666666666667,3865,64.41666666666667,3000000000,46.57179818887451
867,19,4,23,37.69565217391305,216.75,4335,72.25,4000000000,55.363321799307954
609,14,5,19,32.05263157894737,121.8,3045,50.75,5000000000,98.52216748768473
509,5,3,8,63.625,169.66666666666666,2545,42.416666666666664,3000000000,70.7269155206287
458,7,3,10,45.8,152.66666666666666,2290,38.166666666666664,3000000000,78.60262008733625
744,16,3,19,39.1578947368421,248,3720,62,3000000000,48.387096774193544
1110,23,3,26,42.69230769230769,370,5550,92.5,3000000000,32.432432432432435
677,8,5,13,52.07692307692308,135.4,3385,56.416666666666664,5000000000,88.62629246676515
795,9,5,14,56.785714285714285,159,3975,66.25,5000000000,75.47169811320755
857,18,3,21,40.80952380952381,285.6666666666667,4285,71.41666666666667,3000000000,42.00700116686114
597,6,3,9,66.33333333333333,199,2985,49.75,3000000000,60.301507537688444
442,9,4,13,34,110.5,2210,36.833333333333336,4000000000,108.5972850678733
300,5,3,8,37.5,100,1500,25,3000000000,120
640,12,3,15,42.666666666666664,213.33333333333334,3200,53.333333333333336,3000000000,56.25
535,6,4,10,53.5,133.75,2675,44.583333333333336,4000000000,89.7196261682243
417,6,3,9,46.333333333333336,139,2085,34.75,3000000000,86.33093525179855
532,4,3,7,76,177.33333333333334,2660,44.333333333333336,3000000000,67.66917293233082
844,12,4,16,52.75,211,4220,70.33333333333333,4000000000,56.872037914691944
480,4,3,7,68.57142857142857,160,2400,40,3000000000,75
688,13,4,17,40.470588235294116,172,3440,57.333333333333336,4000000000,69.76744186046511
656,7,4,11,59.63636363636363,164,3280,54.666666666666664,4000000000,73.17073170731707
1204,9,11,20,60.2,109.45454545454545,6020,100.33333333333333,11000000000,109.63455149501662
794,17,3,20,39.7,264.6666666666667,3970,66.16666666666667,3000000000,45.34005037783375
560,9,3,12,46.666666666666664,186.66666666666666,2800,46.666666666666664,3000000000,64.28571428571429
622,12,3,15,41.46666666666667,207.33333333333334,3110,51.833333333333336,3000000000,57.877813504823145
431,9,3,12,35.916666666666664,143.66666666666666,2155,35.916666666666664,3000000000,83.52668213457078
517,11,3,14,36.92857142857143,172.33333333333334,2585,43.083333333333336,3000000000,69.63249516441006
404,8,3,11,36.72727272727273,134.66666666666666,2020,33.666666666666664,3000000000,89.10891089108911
578,13,6,19,30.42105263157895,96.33333333333333,2890,48.166666666666664,6000000000,124.56747404844292
305,7,3,10,30.5,101.66666666666667,1525,25.416666666666668,3000000000,118.03278688524588
647,6,10,16,40.4375,64.7,3235,53.916666666666664,10000000000,185.47140649149924
486,7,3,10,48.6,162,2430,40.5,3000000000,74.07407407407408
499,8,3,11,45.36363636363637,166.33333333333334,2495,41.583333333333336,3000000000,72.14428857715431
471,3,4,7,67.28571428571429,117.75,2355,39.25,4000000000,101.91082802547771
664,10,3,13,51.07692307692308,221.33333333333334,3320,55.333333333333336,3000000000,54.21686746987952
633,6,4,10,63.3,158.25,3165,52.75,4000000000,75.82938388625593
670,10,9,19,35.26315789473684,74.44444444444444,3350,55.833333333333336,9000000000,161.19402985074626
696,12,4,16,43.5,174,3480,58,4000000000,68.9655172413793
1030,16,8,24,42.916666666666664,128.75,5150,85.83333333333333,8000000000,93.20388349514563
745,6,4,10,74.5,186.25,3725,62.083333333333336,4000000000,64.42953020134227
407,3,3,6,67.83333333333333,135.66666666666666,2035,33.916666666666664,3000000000,88.45208845208846
1388,18,11,29,47.86206896551724,126.18181818181819,6940,115.66666666666667,11000000000,95.10086455331412
466,10,3,13,35.84615384615385,155.33333333333334,2330,38.833333333333336,3000000000,77.25321888412017
1129,13,11,24,47.041666666666664,102.63636363636364,5645,94.08333333333333,11000000000,116.91762621789195
1330,19,3,22,60.45454545454545,443.3333333333333,6650,110.83333333333333,3000000000,27.06766917293233
863,15,3,18,47.94444444444444,287.6666666666667,4315,71.91666666666667,3000000000,41.71494785631517
864,9,3,12,72,288,4320,72,3000000000,41.666666666666664
330,7,3,10,33,110,1650,27.5,3000000000,109.0909090909091
394,4,3,7,56.285714285714285,131.33333333333334,1970,32.833333333333336,3000000000,91.3705583756345
643,4,3,7,91.85714285714286,214.33333333333334,3215,53.583333333333336,3000000000,55.987558320373246
962,19,11,30,32.06666666666667,87.45454545454545,4810,80.16666666666667,11000000000,137.2141372141372
415,9,4,13,31.923076923076923,103.75,2075,34.583333333333336,4000000000,115.66265060240963
537,5,4,9,59.666666666666664,134.25,2685,44.75,4000000000,89.38547486033521
635,7,9,16,39.6875,70.55555555555556,3175,52.916666666666664,9000000000,170.07874015748033
678,7,5,12,56.5,135.6,3390,56.5,5000000000,88.49557522123894
701,9,3,12,58.416666666666664,233.66666666666666,3505,58.416666666666664,3000000000,51.35520684736092
476,14,3,17,28,158.66666666666666,2380,39.666666666666664,3000000000,75.63025210084035
541,10,4,14,38.642857142857146,135.25,2705,45.083333333333336,4000000000,88.724584103512
441,8,4,12,36.75,110.25,2205,36.75,4000000000,108.843537414966
375,5,3,8,46.875,125,1875,31.25,3000000000,96
1504,23,3,26,57.84615384615385,501.3333333333333,7520,125.33333333333333,3000000000,23.93617021276596
1138,16,3,19,59.89473684210526,379.3333333333333,5690,94.83333333333333,3000000000,31.634446397188054
1020,14,11,25,40.8,92.72727272727273,5100,85,11000000000,129.41176470588235
686,7,6,13,52.76923076923077,114.33333333333333,3430,57.166666666666664,6000000000,104.95626822157435
466,12,3,15,31.066666666666666,155.33333333333334,2330,38.833333333333336,3000000000,77.25321888412017
884,9,6,15,58.93333333333333,147.33333333333334,4420,73.66666666666667,6000000000,81.44796380090497
669,8,6,14,47.785714285714285,111.5,3345,55.75,6000000000,107.62331838565022
1807,25,13,38,47.55263157894737,139,9035,150.58333333333334,13000000000,86.33093525179855
558,4,3,7,79.71428571428571,186,2790,46.5,3000000000,64.51612903225806
806,4,5,9,89.55555555555556,161.2,4030,67.16666666666667,5000000000,74.44168734491313
254,5,3,8,31.75,84.66666666666667,1270,21.166666666666668,3000000000,141.7322834645669
712,12,4,16,44.5,178,3560,59.333333333333336,4000000000,67.41573033707864
397,7,3,10,39.7,132.33333333333334,1985,33.083333333333336,3000000000,90.6801007556675
739,14,6,20,36.95,123.16666666666667,3695,61.583333333333336,6000000000,97.42895805142084
988,18,8,26,38,123.5,4940,82.33333333333333,8000000000,97.16599190283401
583,6,4,10,58.3,145.75,2915,48.583333333333336,4000000000,82.3327615780446
685,8,3,11,62.27272727272727,228.33333333333334,3425,57.083333333333336,3000000000,52.55474452554744
323,4,6,10,32.3,53.833333333333336,1615,26.916666666666668,6000000000,222.91021671826624
841,14,3,17,49.470588235294116,280.3333333333333,4205,70.08333333333333,3000000000,42.80618311533888
854,21,3,24,35.583333333333336,284.6666666666667,4270,71.16666666666667,3000000000,42.15456674473067
614,7,5,12,51.166666666666664,122.8,3070,51.166666666666664,5000000000,97.7198697068404
455,5,4,9,50.55555555555556,113.75,2275,37.916666666666664,4000000000,105.49450549450549
726,13,3,16,45.375,242,3630,60.5,3000000000,49.586776859504134
259,3,3,6,43.166666666666664,86.33333333333333,1295,21.583333333333332,3000000000,138.996138996139
377,7,5,12,31.416666666666668,75.4,1885,31.416666666666668,5000000000,159.15119363395226
692,10,5,15,46.13333333333333,138.4,3460,57.666666666666664,5000000000,86.70520231213874
1045,13,7,20,52.25,149.28571428571428,5225,87.08333333333333,7000000000,80.38277511961722
495,7,3,10,49.5,165,2475,41.25,3000000000,72.72727272727273
344,4,4,8,43,86,1720,28.666666666666668,4000000000,139.53488372093022
703,14,4,18,39.05555555555556,175.75,3515,58.583333333333336,4000000000,68.27880512091038
875,13,3,16,54.6875,291.6666666666667,4375,72.91666666666667,3000000000,41.14285714285714
660,10,6,16,41.25,110,3300,55,6000000000,109.0909090909091
652,10,3,13,50.15384615384615,217.33333333333334,3260,54.333333333333336,3000000000,55.214723926380366
527,6,4,10,52.7,131.75,2635,43.916666666666664,4000000000,91.08159392789375
255,4,5,9,28.333333333333332,51,1275,21.25,5000000000,235.2941176470588
534,10,5,15,35.6,106.8,2670,44.5,5000000000,112.35955056179775
655,7,7,14,46.785714285714285,93.57142857142857,3275,54.583333333333336,7000000000,128.24427480916032
960,12,6,18,53.333333333333336,160,4800,80,6000000000,75
763,9,4,13,58.69230769230769,190.75,3815,63.583333333333336,4000000000,62.90956749672346
654,12,5,17,38.470588235294116,130.8,3270,54.5,5000000000,91.74311926605505
482,5,4,9,53.55555555555556,120.5,2410,40.166666666666664,4000000000,99.5850622406639
644,12,3,15,42.93333333333333,214.66666666666666,3220,53.666666666666664,3000000000,55.90062111801243
668,12,3,15,44.53333333333333,222.66666666666666,3340,55.666666666666664,3000000000,53.89221556886228
506,4,10,14,36.142857142857146,50.6,2530,42.166666666666664,10000000000,237.15415019762847
363,7,4,11,33,90.75,1815,30.25,4000000000,132.23140495867767
180,6,4,10,18,45,900,15,4000000000,266.66666666666663
370,5,3,8,46.25,123.33333333333333,1850,30.833333333333332,3000000000,97.2972972972973
620,9,4,13,47.69230769230769,155,3100,51.666666666666664,4000000000,77.41935483870968
504,8,4,12,42,126,2520,42,4000000000,95.23809523809524
1018,20,3,23,44.26086956521739,339.3333333333333,5090,84.83333333333333,3000000000,35.36345776031435
823,7,5,12,68.58333333333333,164.6,4115,68.58333333333333,5000000000,72.90400972053463
665,6,3,9,73.88888888888889,221.66666666666666,3325,55.416666666666664,3000000000,54.13533834586466
871,13,3,16,54.4375,290.3333333333333,4355,72.58333333333333,3000000000,41.33180252583238
394,4,3,7,56.285714285714285,131.33333333333334,1970,32.833333333333336,3000000000,91.3705583756345
548,5,3,8,68.5,182.66666666666666,2740,45.666666666666664,3000000000,65.69343065693431
584,10,3,13,44.92307692307692,194.66666666666666,2920,48.666666666666664,3000000000,61.64383561643836
971,6,10,16,60.6875,97.1,4855,80.91666666666667,10000000000,123.58393408856848
857,9,3,12,71.41666666666667,285.6666666666667,4285,71.41666666666667,3000000000,42.00700116686114
492,11,3,14,35.142857142857146,164,2460,41,3000000000,73.17073170731707
290,5,3,8,36.25,96.66666666666667,1450,24.166666666666668,3000000000,124.13793103448275
547,6,3,9,60.77777777777778,182.33333333333334,2735,45.583333333333336,3000000000,65.81352833638024
669,9,4,13,51.46153846153846,167.25,3345,55.75,4000000000,71.74887892376682
695,7,3,10,69.5,231.66666666666666,3475,57.916666666666664,3000000000,51.79856115107914
698,11,3,14,49.857142857142854,232.66666666666666,3490,58.166666666666664,3000000000,51.5759312320917
530,9,3,12,44.166666666666664,176.66666666666666,2650,44.166666666666664,3000000000,67.9245283018868
719,8,3,11,65.36363636363636,239.66666666666666,3595,59.916666666666664,3000000000,50.06954102920724
732,12,3,15,48.8,244,3660,61,3000000000,49.18032786885246
391,4,3,7,55.857142857142854,130.33333333333334,1955,32.583333333333336,3000000000,92.07161125319692
704,15,3,18,39.111111111111114,234.66666666666666,3520,58.666666666666664,3000000000,51.13636363636364
994,22,3,25,39.76,331.3333333333333,4970,82.83333333333333,3000000000,36.21730382293763
779,19,3,22,35.40909090909091,259.6666666666667,3895,64.91666666666667,3000000000,46.21309370988446
1239,15,10,25,49.56,123.9,6195,103.25,10000000000,96.85230024213075
493,9,3,12,41.083333333333336,164.33333333333334,2465,41.083333333333336,3000000000,73.02231237322515
399,5,3,8,49.875,133,1995,33.25,3000000000,90.22556390977444
768,13,3,16,48,256,3840,64,3000000000,46.875
207,6,3,9,23,69,1035,17.25,3000000000,173.91304347826087
278,6,4,10,27.8,69.5,1390,23.166666666666668,4000000000,172.6618705035971
261,5,4,9,29,65.25,1305,21.75,4000000000,183.9080459770115
337,5,3,8,42.125,112.33333333333333,1685,28.083333333333332,3000000000,106.82492581602374
549,10,3,13,42.23076923076923,183,2745,45.75,3000000000,65.57377049180329
521,8,4,12,43.416666666666664,130.25,2605,43.416666666666664,4000000000,92.13051823416507
578,8,4,12,48.166666666666664,144.5,2890,48.166666666666664,4000000000,83.04498269896195
571,7,5,12,47.583333333333336,114.2,2855,47.583333333333336,5000000000,105.07880910683012
580,8,5,13,44.61538461538461,116,2900,48.333333333333336,5000000000,103.44827586206897
674,11,5,16,42.125,134.8,3370,56.166666666666664,5000000000,89.02077151335313
574,8,3,11,52.18181818181818,191.33333333333334,2870,47.833333333333336,3000000000,62.7177700348432
522,7,6,13,40.15384615384615,87,2610,43.5,6000000000,137.9310344827586
1042,11,14,25,41.68,74.42857142857143,5210,86.83333333333333,14000000000,161.22840690978887
429,7,3,10,42.9,143,2145,35.75,3000000000,83.91608391608392
641,8,4,12,53.416666666666664,160.25,3205,53.416666666666664,4000000000,74.88299531981279
783,8,3,11,71.18181818181819,261,3915,65.25,3000000000,45.97701149425288
864,14,3,17,50.8235294117647,288,4320,72,3000000000,41.666666666666664
1473,26,6,32,46.03125,245.5,7365,122.75,6000000000,48.87983706720977
494,11,3,14,35.285714285714285,164.66666666666666,2470,41.166666666666664,3000000000,72.87449392712551
887,12,7,19,46.68421052631579,126.71428571428571,4435,73.91666666666667,7000000000,94.70124013528748
761,8,3,11,69.18181818181819,253.66666666666666,3805,63.416666666666664,3000000000,47.306176084099874
744,9,6,15,49.6,124,3720,62,6000000000,96.77419354838709
1303,30,3,33,39.484848484848484,434.3333333333333,6515,108.58333333333333,3000000000,27.628549501151188
507,6,3,9,56.333333333333336,169,2535,42.25,3000000000,71.0059171597633
194,5,3,8,24.25,64.66666666666667,970,16.166666666666668,3000000000,185.56701030927834
435,6,3,9,48.333333333333336,145,2175,36.25,3000000000,82.75862068965517
545,8,4,12,45.416666666666664,136.25,2725,45.416666666666664,4000000000,88.07339449541284
182,4,3,7,26,60.666666666666664,910,15.166666666666666,3000000000,197.8021978021978
514,8,5,13,39.53846153846154,102.8,2570,42.833333333333336,5000000000,116.73151750972762
347,6,3,9,38.55555555555556,115.66666666666667,1735,28.916666666666668,3000000000,103.7463976945245
551,9,3,12,45.916666666666664,183.66666666666666,2755,45.916666666666664,3000000000,65.33575317604357
619,6,3,9,68.77777777777777,206.33333333333334,3095,51.583333333333336,3000000000,58.158319870759286
522,7,3,10,52.2,174,2610,43.5,3000000000,68.9655172413793
610,11,3,14,43.57142857142857,203.33333333333334,3050,50.833333333333336,3000000000,59.01639344262294
287,4,3,7,41,95.66666666666667,1435,23.916666666666668,3000000000,125.4355400696864
868,15,3,18,48.22222222222222,289.3333333333333,4340,72.33333333333333,3000000000,41.474654377880185
564,12,3,15,37.6,188,2820,47,3000000000,63.829787234042556
576,15,6,21,27.428571428571427,96,2880,48,6000000000,125
666,11,3,14,47.57142857142857,222,3330,55.5,3000000000,54.05405405405405
554,7,4,11,50.36363636363637,138.5,2770,46.166666666666664,4000000000,86.64259927797835
865,12,5,17,50.88235294117647,173,4325,72.08333333333333,5000000000,69.36416184971098
482,11,3,14,34.42857142857143,160.66666666666666,2410,40.166666666666664,3000000000,74.68879668049793
596,14,3,17,35.05882352941177,198.66666666666666,2980,49.666666666666664,3000000000,60.4026845637584
604,14,3,17,35.529411764705884,201.33333333333334,3020,50.333333333333336,3000000000,59.602649006622514
607,12,5,17,35.705882352941174,121.4,3035,50.583333333333336,5000000000,98.84678747940691
1284,12,12,24,53.5,107,6420,107,12000000000,112.14953271028037
602,5,4,9,66.88888888888889,150.5,3010,50.166666666666664,4000000000,79.734219269103
1431,23,3,26,55.03846153846154,477,7155,119.25,3000000000,25.157232704402517
650,11,3,14,46.42857142857143,216.66666666666666,3250,54.166666666666664,3000000000,55.38461538461539
433,5,3,8,54.125,144.33333333333334,2165,36.083333333333336,3000000000,83.14087759815241
256,6,3,9,28.444444444444443,85.33333333333333,1280,21.333333333333332,3000000000,140.625
1383,19,9,28,49.392857142857146,153.66666666666666,6915,115.25,9000000000,78.09110629067246
264,3,5,8,33,52.8,1320,22,5000000000,227.27272727272728
516,9,3,12,43,172,2580,43,3000000000,69.76744186046511
553,12,3,15,36.86666666666667,184.33333333333334,2765,46.083333333333336,3000000000,65.09945750452079
528,4,5,9,58.666666666666664,105.6,2640,44,5000000000,113.63636363636364
287,8,3,11,26.09090909090909,95.66666666666667,1435,23.916666666666668,3000000000,125.4355400696864
428,8,3,11,38.90909090909091,142.66666666666666,2140,35.666666666666664,3000000000,84.11214953271029
259,6,3,9,28.77777777777778,86.33333333333333,1295,21.583333333333332,3000000000,138.996138996139
459,6,4,10,45.9,114.75,2295,38.25,4000000000,104.57516339869282
506,6,4,10,50.6,126.5,2530,42.166666666666664,4000000000,94.86166007905139
941,15,5,20,47.05,188.2,4705,78.41666666666667,5000000000,63.76195536663124
1429,25,12,37,38.62162162162162,119.08333333333333,7145,119.08333333333333,12000000000,100.76976906927922
359,5,4,9,39.888888888888886,89.75,1795,29.916666666666668,4000000000,133.70473537604457
977,14,3,17,57.470588235294116,325.6666666666667,4885,81.41666666666667,3000000000,36.8474923234391
731,8,4,12,60.916666666666664,182.75,3655,60.916666666666664,4000000000,65.66347469220247
761,10,3,13,58.53846153846154,253.66666666666666,3805,63.416666666666664,3000000000,47.306176084099874
246,5,3,8,30.75,82,1230,20.5,3000000000,146.34146341463415
552,5,3,8,69,184,2760,46,3000000000,65.21739130434783
194,7,3,10,19.4,64.66666666666667,970,16.166666666666668,3000000000,185.56701030927834
1317,28,12,40,32.925,109.75,6585,109.75,12000000000,109.33940774487472
1218,24,3,27,45.111111111111114,406,6090,101.5,3000000000,29.556650246305416
647,12,3,15,43.13333333333333,215.66666666666666,3235,53.916666666666664,3000000000,55.64142194744977
428,6,5,11,38.90909090909091,85.6,2140,35.666666666666664,5000000000,140.18691588785046
456,4,4,8,57,114,2280,38,4000000000,105.26315789473684
695,7,6,13,53.46153846153846,115.83333333333333,3475,57.916666666666664,6000000000,103.59712230215828
1549,24,11,35,44.25714285714286,140.8181818181818,7745,129.08333333333334,11000000000,85.21626856036151
479,12,3,15,31.933333333333334,159.66666666666666,2395,39.916666666666664,3000000000,75.15657620041755
752,11,3,14,53.714285714285715,250.66666666666666,3760,62.666666666666664,3000000000,47.87234042553192
568,8,6,14,40.57142857142857,94.66666666666667,2840,47.333333333333336,6000000000,126.76056338028168
702,13,5,18,39,140.4,3510,58.5,5000000000,85.47008547008546
351,7,3,10,35.1,117,1755,29.25,3000000000,102.56410256410255
325,4,5,9,36.111111111111114,65,1625,27.083333333333332,5000000000,184.61538461538464
196,3,3,6,32.666666666666664,65.33333333333333,980,16.333333333333332,3000000000,183.67346938775512
340,4,3,7,48.57142857142857,113.33333333333333,1700,28.333333333333332,3000000000,105.88235294117648
670,11,5,16,41.875,134,3350,55.833333333333336,5000000000,89.55223880597015
315,5,3,8,39.375,105,1575,26.25,3000000000,114.28571428571428
1020,22,3,25,40.8,340,5100,85,3000000000,35.29411764705882
631,16,3,19,33.21052631578947,210.33333333333334,3155,52.583333333333336,3000000000,57.05229793977813
563,10,3,13,43.30769230769231,187.66666666666666,2815,46.916666666666664,3000000000,63.94316163410302
1209,23,13,36,33.583333333333336,93,6045,100.75,13000000000,129.03225806451613
674,7,4,11,61.27272727272727,168.5,3370,56.166666666666664,4000000000,71.2166172106825
547,9,6,15,36.46666666666667,91.16666666666667,2735,45.583333333333336,6000000000,131.6270566727605
1256,17,3,20,62.8,418.6666666666667,6280,104.66666666666667,3000000000,28.662420382165603
618,9,3,12,51.5,206,3090,51.5,3000000000,58.25242718446602
382,3,3,6,63.666666666666664,127.33333333333333,1910,31.833333333333332,3000000000,94.24083769633508
406,7,3,10,40.6,135.33333333333334,2030,33.833333333333336,3000000000,88.66995073891624
579,9,6,15,38.6,96.5,2895,48.25,6000000000,124.35233160621762
236,6,3,9,26.22222222222222,78.66666666666667,1180,19.666666666666668,3000000000,152.5423728813559
720,9,3,12,60,240,3600,60,3000000000,50
603,8,3,11,54.81818181818182,201,3015,50.25,3000000000,59.701492537313435
1105,13,3,16,69.0625,368.3333333333333,5525,92.08333333333333,3000000000,32.579185520361996
827,9,5,14,59.07142857142857,165.4,4135,68.91666666666667,5000000000,72.55139056831922
788,12,3,15,52.53333333333333,262.6666666666667,3940,65.66666666666667,3000000000,45.68527918781725
453,5,5,10,45.3,90.6,2265,37.75,5000000000,132.45033112582783
491,11,3,14,35.07142857142857,163.66666666666666,2455,40.916666666666664,3000000000,73.31975560081467
510,9,3,12,42.5,170,2550,42.5,3000000000,70.58823529411764
1212,25,10,35,34.628571428571426,121.2,6060,101,10000000000,99.00990099009901
534,13,4,17,31.41176470588235,133.5,2670,44.5,4000000000,89.8876404494382
919,15,11,26,35.34615384615385,83.54545454545455,4595,76.58333333333333,11000000000,143.63438520130578
345,5,3,8,43.125,115,1725,28.75,3000000000,104.34782608695652
762,16,3,19,40.10526315789474,254,3810,63.5,3000000000,47.24409448818898
967,17,3,20,48.35,322.3333333333333,4835,80.58333333333333,3000000000,37.22854188210962
615,8,5,13,47.30769230769231,123,3075,51.25,5000000000,97.5609756097561
349,7,4,11,31.727272727272727,87.25,1745,29.083333333333332,4000000000,137.53581661891118
838,13,3,16,52.375,279.3333333333333,4190,69.83333333333333,3000000000,42.95942720763723
921,14,9,23,40.04347826086956,102.33333333333333,4605,76.75,9000000000,117.26384364820846
935,12,7,19,49.21052631578947,133.57142857142858,4675,77.91666666666667,7000000000,89.83957219251336
505,13,8,21,24.047619047619047,63.125,2525,42.083333333333336,8000000000,190.0990099009901
802,8,5,13,61.69230769230769,160.4,4010,66.83333333333333,5000000000,74.81296758104739
590,17,3,20,29.5,196.66666666666666,2950,49.166666666666664,3000000000,61.016949152542374
632,12,4,16,39.5,158,3160,52.666666666666664,4000000000,75.94936708860759
461,8,5,13,35.46153846153846,92.2,2305,38.416666666666664,5000000000,130.15184381778744
322,6,4,10,32.2,80.5,1610,26.833333333333332,4000000000,149.06832298136646
873,12,5,17,51.35294117647059,174.6,4365,72.75,5000000000,68.72852233676976
756,7,3,10,75.6,252,3780,63,3000000000,47.61904761904762
1266,16,3,19,66.63157894736842,422,6330,105.5,3000000000,28.43601895734597
565,8,3,11,51.36363636363637,188.33333333333334,2825,47.083333333333336,3000000000,63.716814159292035
479,11,3,14,34.214285714285715,159.66666666666666,2395,39.916666666666664,3000000000,75.15657620041755
554,9,4,13,42.61538461538461,138.5,2770,46.166666666666664,4000000000,86.64259927797835
1316,22,5,27,48.74074074074074,263.2,6580,109.66666666666667,5000000000,45.59270516717325
606,7,4,11,55.09090909090909,151.5,3030,50.5,4000000000,79.20792079207921
1564,28,8,36,43.44444444444444,195.5,7820,130.33333333333334,8000000000,61.381074168797944
442,4,4,8,55.25,110.5,2210,36.833333333333336,4000000000,108.5972850678733
457,13,3,16,28.5625,152.33333333333334,2285,38.083333333333336,3000000000,78.77461706783369
319,8,3,11,29,106.33333333333333,1595,26.583333333333332,3000000000,112.85266457680251
421,11,3,14,30.071428571428573,140.33333333333334,2105,35.083333333333336,3000000000,85.5106888361045
703,15,3,18,39.05555555555556,234.33333333333334,3515,58.583333333333336,3000000000,51.209103840682786
1036,13,4,17,60.94117647058823,259,5180,86.33333333333333,4000000000,46.33204633204634
343,4,3,7,49,114.33333333333333,1715,28.583333333333332,3000000000,104.95626822157435
579,9,3,12,48.25,193,2895,48.25,3000000000,62.17616580310881
604,9,5,14,43.142857142857146,120.8,3020,50.333333333333336,5000000000,99.33774834437085
380,7,3,10,38,126.66666666666667,1900,31.666666666666668,3000000000,94.73684210526316
454,11,5,16,28.375,90.8,2270,37.833333333333336,5000000000,132.15859030837004
519,10,6,16,32.4375,86.5,2595,43.25,6000000000,138.72832369942196
422,9,4,13,32.46153846153846,105.5,2110,35.166666666666664,4000000000,113.74407582938389
454,11,3,14,32.42857142857143,151.33333333333334,2270,37.833333333333336,3000000000,79.29515418502203
358,5,4,9,39.77777777777778,89.5,1790,29.833333333333332,4000000000,134.0782122905028
271,6,3,9,30.11111111111111,90.33333333333333,1355,22.583333333333332,3000000000,132.84132841328415
276,4,3,7,39.42857142857143,92,1380,23,3000000000,130.43478260869566
283,5,3,8,35.375,94.33333333333333,1415,23.583333333333332,3000000000,127.20848056537103
711,6,9,15,47.4,79,3555,59.25,9000000000,151.89873417721518
421,10,3,13,32.38461538461539,140.33333333333334,2105,35.083333333333336,3000000000,85.5106888361045
912,13,6,19,48,152,4560,76,6000000000,78.94736842105263
380,7,4,11,34.54545454545455,95,1900,31.666666666666668,4000000000,126.3157894736842
770,7,7,14,55,110,3850,64.16666666666667,7000000000,109.09090909090908
599,13,6,19,31.526315789473685,99.83333333333333,2995,49.916666666666664,6000000000,120.20033388981638
499,4,9,13,38.38461538461539,55.44444444444444,2495,41.583333333333336,9000000000,216.43286573146293
719,11,3,14,51.357142857142854,239.66666666666666,3595,59.916666666666664,3000000000,50.06954102920724
205,6,5,11,18.636363636363637,41,1025,17.083333333333332,5000000000,292.68292682926835
542,9,4,13,41.69230769230769,135.5,2710,45.166666666666664,4000000000,88.5608856088561
532,6,3,9,59.111111111111114,177.33333333333334,2660,44.333333333333336,3000000000,67.66917293233082
557,12,5,17,32.76470588235294,111.4,2785,46.416666666666664,5000000000,107.71992818671454
320,8,3,11,29.09090909090909,106.66666666666667,1600,26.666666666666668,3000000000,112.5
607,9,5,14,43.357142857142854,121.4,3035,50.583333333333336,5000000000,98.84678747940691
507,4,3,7,72.42857142857143,169,2535,42.25,3000000000,71.0059171597633
498,7,3,10,49.8,166,2490,41.5,3000000000,72.28915662650603
850,12,3,15,56.666666666666664,283.3333333333333,4250,70.83333333333333,3000000000,42.352941176470594
1014,13,5,18,56.333333333333336,202.8,5070,84.5,5000000000,59.171597633136095
457,6,4,10,45.7,114.25,2285,38.083333333333336,4000000000,105.03282275711159
932,7,5,12,77.66666666666667,186.4,4660,77.66666666666667,5000000000,64.37768240343347
662,15,3,18,36.77777777777778,220.66666666666666,3310,55.166666666666664,3000000000,54.38066465256797
416,6,3,9,46.22222222222222,138.66666666666666,2080,34.666666666666664,3000000000,86.53846153846155
661,9,3,12,55.083333333333336,220.33333333333334,3305,55.083333333333336,3000000000,54.462934947049924
523,6,8,14,37.357142857142854,65.375,2615,43.583333333333336,8000000000,183.55640535372848
938,16,3,19,49.36842105263158,312.6666666666667,4690,78.16666666666667,3000000000,38.379530916844345
372,5,8,13,28.615384615384617,46.5,1860,31,8000000000,258.06451612903226
446,12,4,16,27.875,111.5,2230,37.166666666666664,4000000000,107.62331838565024
579,8,3,11,52.63636363636363,193,2895,48.25,3000000000,62.17616580310881
1320,18,6,24,55,220,6600,110,6000000000,54.54545454545455
733,17,3,20,36.65,244.33333333333334,3665,61.083333333333336,3000000000,49.113233287858115
160,5,3,8,20,53.333333333333336,800,13.333333333333334,3000000000,225
383,5,6,11,34.81818181818182,63.833333333333336,1915,31.916666666666668,6000000000,187.98955613577024
696,8,3,11,63.27272727272727,232,3480,58,3000000000,51.724137931034484
332,3,3,6,55.333333333333336,110.66666666666667,1660,27.666666666666668,3000000000,108.43373493975903
831,19,3,22,37.77272727272727,277,4155,69.25,3000000000,43.321299638989174
1031,6,3,9,114.55555555555556,343.6666666666667,5155,85.91666666666667,3000000000,34.91755577109602
828,10,8,18,46,103.5,4140,69,8000000000,115.94202898550725
1171,18,3,21,55.76190476190476,390.3333333333333,5855,97.58333333333333,3000000000,30.742954739538856
372,9,3,12,31,124,1860,31,3000000000,96.77419354838709
352,6,3,9,39.111111111111114,117.33333333333333,1760,29.333333333333332,3000000000,102.27272727272728
617,14,4,18,34.27777777777778,154.25,3085,51.416666666666664,4000000000,77.79578606158833
766,10,3,13,58.92307692307692,255.33333333333334,3830,63.833333333333336,3000000000,46.99738903394256
934,10,9,19,49.1578947368421,103.77777777777777,4670,77.83333333333333,9000000000,115.63169164882228
1056,7,4,11,96,264,5280,88,4000000000,45.45454545454545
414,4,3,7,59.142857142857146,138,2070,34.5,3000000000,86.95652173913044
1384,18,4,22,62.90909090909091,346,6920,115.33333333333333,4000000000,34.68208092485549
587,5,6,11,53.36363636363637,97.83333333333333,2935,48.916666666666664,6000000000,122.65758091993186
779,15,5,20,38.95,155.8,3895,64.91666666666667,5000000000,77.02182284980744
341,4,6,10,34.1,56.833333333333336,1705,28.416666666666668,6000000000,211.14369501466274
212,3,3,6,35.333333333333336,70.66666666666667,1060,17.666666666666668,3000000000,169.81132075471697
477,10,4,14,34.07142857142857,119.25,2385,39.75,4000000000,100.62893081761007
427,11,3,14,30.5,142.33333333333334,2135,35.583333333333336,3000000000,84.30913348946135
576,7,5,12,48,115.2,2880,48,5000000000,104.16666666666667
791,14,3,17,46.529411764705884,263.6666666666667,3955,65.91666666666667,3000000000,45.51201011378002
651,6,3,9,72.33333333333333,217,3255,54.25,3000000000,55.29953917050691
1126,26,4,30,37.53333333333333,281.5,5630,93.83333333333333,4000000000,42.62877442273535
623,6,4,10,62.3,155.75,3115,51.916666666666664,4000000000,77.04654895666131
833,5,6,11,75.72727272727273,138.83333333333334,4165,69.41666666666667,6000000000,86.4345738295318
720,9,3,12,60,240,3600,60,3000000000,50
370,3,4,7,52.857142857142854,92.5,1850,30.833333333333332,4000000000,129.72972972972974
592,8,4,12,49.333333333333336,148,2960,49.333333333333336,4000000000,81.08108108108108
450,8,4,12,37.5,112.5,2250,37.5,4000000000,106.66666666666667
1002,12,8,20,50.1,125.25,5010,83.5,8000000000,95.80838323353294
396,10,3,13,30.46153846153846,132,1980,33,3000000000,90.9090909090909
609,10,8,18,33.833333333333336,76.125,3045,50.75,8000000000,157.63546798029557
445,14,3,17,26.176470588235293,148.33333333333334,2225,37.083333333333336,3000000000,80.89887640449437
357,5,3,8,44.625,119,1785,29.75,3000000000,100.84033613445379
565,10,3,13,43.46153846153846,188.33333333333334,2825,47.083333333333336,3000000000,63.716814159292035
326,5,3,8,40.75,108.66666666666667,1630,27.166666666666668,3000000000,110.42944785276073
1067,21,6,27,39.51851851851852,177.83333333333334,5335,88.91666666666667,6000000000,67.47891283973757
464,10,3,13,35.69230769230769,154.66666666666666,2320,38.666666666666664,3000000000,77.58620689655173
361,7,3,10,36.1,120.33333333333333,1805,30.083333333333332,3000000000,99.7229916897507
756,9,4,13,58.15384615384615,189,3780,63,4000000000,63.492063492063494
1217,16,13,29,41.96551724137931,93.61538461538461,6085,101.41666666666667,13000000000,128.18405916187345
566,7,6,13,43.53846153846154,94.33333333333333,2830,47.166666666666664,6000000000,127.20848056537103
786,5,7,12,65.5,112.28571428571429,3930,65.5,7000000000,106.87022900763358
850,18,5,23,36.95652173913044,170,4250,70.83333333333333,5000000000,70.58823529411764
409,7,3,10,40.9,136.33333333333334,2045,34.083333333333336,3000000000,88.01955990220048
781,12,3,15,52.06666666666667,260.3333333333333,3905,65.08333333333333,3000000000,46.09475032010244
685,14,3,17,40.294117647058826,228.33333333333334,3425,57.083333333333336,3000000000,52.55474452554744
548,15,3,18,30.444444444444443,182.66666666666666,2740,45.666666666666664,3000000000,65.69343065693431
303,3,3,6,50.5,101,1515,25.25,3000000000,118.81188118811882
1213,17,9,26,46.65384615384615,134.77777777777777,6065,101.08333333333333,9000000000,89.03544929925803
302,5,3,8,37.75,100.66666666666667,1510,25.166666666666668,3000000000,119.20529801324503
424,6,3,9,47.111111111111114,141.33333333333334,2120,35.333333333333336,3000000000,84.90566037735849
462,8,3,11,42,154,2310,38.5,3000000000,77.92207792207792
578,8,3,11,52.54545454545455,192.66666666666666,2890,48.166666666666664,3000000000,62.28373702422146
597,7,4,11,54.27272727272727,149.25,2985,49.75,4000000000,80.40201005025126
880,14,3,17,51.76470588235294,293.3333333333333,4400,73.33333333333333,3000000000,40.909090909090914
804,12,5,17,47.294117647058826,160.8,4020,67,5000000000,74.6268656716418
322,6,5,11,29.272727272727273,64.4,1610,26.833333333333332,5000000000,186.33540372670808
1032,13,5,18,57.333333333333336,206.4,5160,86,5000000000,58.13953488372093
962,17,3,20,48.1,320.6666666666667,4810,80.16666666666667,3000000000,37.42203742203742
511,7,3,10,51.1,170.33333333333334,2555,42.583333333333336,3000000000,70.45009784735812
550,8,3,11,50,183.33333333333334,2750,45.833333333333336,3000000000,65.45454545454545
651,7,6,13,50.07692307692308,108.5,3255,54.25,6000000000,110.59907834101382
1247,19,8,27,46.18518518518518,155.875,6235,103.91666666666667,8000000000,76.98476343223737
1120,18,3,21,53.333333333333336,373.3333333333333,5600,93.33333333333333,3000000000,32.142857142857146
381,6,3,9,42.333333333333336,127,1905,31.75,3000000000,94.48818897637796
753,9,6,15,50.2,125.5,3765,62.75,6000000000,95.61752988047809
691,6,5,11,62.81818181818182,138.2,3455,57.583333333333336,5000000000,86.83068017366135
551,8,3,11,50.09090909090909,183.66666666666666,2755,45.916666666666664,3000000000,65.33575317604357
426,8,3,11,38.72727272727273,142,2130,35.5,3000000000,84.50704225352113
448,10,3,13,34.46153846153846,149.33333333333334,2240,37.333333333333336,3000000000,80.35714285714285
386,6,4,10,38.6,96.5,1930,32.166666666666664,4000000000,124.35233160621762
406,6,3,9,45.111111111111114,135.33333333333334,2030,33.833333333333336,3000000000,88.66995073891624
1158,26,3,29,39.93103448275862,386,5790,96.5,3000000000,31.088082901554404
333,9,3,12,27.75,111,1665,27.75,3000000000,108.1081081081081
479,5,4,9,53.22222222222222,119.75,2395,39.916666666666664,4000000000,100.20876826722339
933,15,3,18,51.833333333333336,311,4665,77.75,3000000000,38.58520900321543
1066,24,3,27,39.48148148148148,355.3333333333333,5330,88.83333333333333,3000000000,33.77110694183865
641,9,3,12,53.416666666666664,213.66666666666666,3205,53.416666666666664,3000000000,56.1622464898596
569,9,3,12,47.416666666666664,189.66666666666666,2845,47.416666666666664,3000000000,63.26889279437611
759,6,5,11,69,151.8,3795,63.25,5000000000,79.05138339920948
543,9,3,12,45.25,181,2715,45.25,3000000000,66.29834254143647
753,14,9,23,32.73913043478261,83.66666666666667,3765,62.75,9000000000,143.42629482071712
910,17,3,20,45.5,303.3333333333333,4550,75.83333333333333,3000000000,39.56043956043956
862,18,3,21,41.04761904761905,287.3333333333333,4310,71.83333333333333,3000000000,41.76334106728539
693,8,7,15,46.2,99,3465,57.75,7000000000,121.21212121212122
727,17,3,20,36.35,242.33333333333334,3635,60.583333333333336,3000000000,49.51856946354883
598,6,6,12,49.833333333333336,99.66666666666667,2990,49.833333333333336,6000000000,120.40133779264214
603,9,3,12,50.25,201,3015,50.25,3000000000,59.701492537313435
660,5,5,10,66,132,3300,55,5000000000,90.9090909090909
432,10,3,13,33.23076923076923,144,2160,36,3000000000,83.33333333333333
713,16,3,19,37.526315789473685,237.66666666666666,3565,59.416666666666664,3000000000,50.490883590462836
676,11,5,16,42.25,135.2,3380,56.333333333333336,5000000000,88.75739644970415
292,3,5,8,36.5,58.4,1460,24.333333333333332,5000000000,205.4794520547945
588,7,3,10,58.8,196,2940,49,3000000000,61.224489795918366
608,11,3,14,43.42857142857143,202.66666666666666,3040,50.666666666666664,3000000000,59.21052631578947
1103,15,7,22,50.13636363636363,157.57142857142858,5515,91.91666666666667,7000000000,76.15593834995467
788,10,3,13,60.61538461538461,262.6666666666667,3940,65.66666666666667,3000000000,45.68527918781725
282,5,3,8,35.25,94,1410,23.5,3000000000,127.65957446808511
958,16,3,19,50.421052631578945,319.3333333333333,4790,79.83333333333333,3000000000,37.57828810020877
902,13,3,16,56.375,300.6666666666667,4510,75.16666666666667,3000000000,39.91130820399113
761,9,3,12,63.416666666666664,253.66666666666666,3805,63.416666666666664,3000000000,47.306176084099874
1109,15,3,18,61.611111111111114,369.6666666666667,5545,92.41666666666667,3000000000,32.46167718665464
660,11,3,14,47.142857142857146,220,3300,55,3000000000,54.54545454545455
406,5,3,8,50.75,135.33333333333334,2030,33.833333333333336,3000000000,88.66995073891624
515,7,4,11,46.81818181818182,128.75,2575,42.916666666666664,4000000000,93.20388349514563
619,7,6,13,47.61538461538461,103.16666666666667,3095,51.583333333333336,6000000000,116.31663974151857
407,8,3,11,37,135.66666666666666,2035,33.916666666666664,3000000000,88.45208845208846
734,10,3,13,56.46153846153846,244.66666666666666,3670,61.166666666666664,3000000000,49.04632152588556
379,8,3,11,34.45454545454545,126.33333333333333,1895,31.583333333333332,3000000000,94.9868073878628
681,13,3,16,42.5625,227,3405,56.75,3000000000,52.86343612334802
412,7,3,10,41.2,137.33333333333334,2060,34.333333333333336,3000000000,87.37864077669902
591,13,5,18,32.833333333333336,118.2,2955,49.25,5000000000,101.52284263959392
493,11,5,16,30.8125,98.6,2465,41.083333333333336,5000000000,121.70385395537524
977,11,3,14,69.78571428571429,325.6666666666667,4885,81.41666666666667,3000000000,36.8474923234391
456,6,3,9,50.666666666666664,152,2280,38,3000000000,78.94736842105263
731,9,3,12,60.916666666666664,243.66666666666666,3655,60.916666666666664,3000000000,49.24760601915185
557,11,3,14,39.785714285714285,185.66666666666666,2785,46.416666666666664,3000000000,64.63195691202873
559,11,3,14,39.92857142857143,186.33333333333334,2795,46.583333333333336,3000000000,64.40071556350627
711,14,3,17,41.8235294117647,237,3555,59.25,3000000000,50.63291139240506
507,10,3,13,39,169,2535,42.25,3000000000,71.0059171597633
138,4,4,8,17.25,34.5,690,11.5,4000000000,347.82608695652175
449,9,3,12,37.416666666666664,149.66666666666666,2245,37.416666666666664,3000000000,80.1781737193764
594,8,3,11,54,198,2970,49.5,3000000000,60.60606060606061
505,5,5,10,50.5,101,2525,42.083333333333336,5000000000,118.8118811881188
667,7,3,10,66.7,222.33333333333334,3335,55.583333333333336,3000000000,53.973013493253376
559,7,4,11,50.81818181818182,139.75,2795,46.583333333333336,4000000000,85.86762075134168
369,8,4,12,30.75,92.25,1845,30.75,4000000000,130.08130081300814
637,12,4,16,39.8125,159.25,3185,53.083333333333336,4000000000,75.35321821036106
371,6,3,9,41.22222222222222,123.66666666666667,1855,30.916666666666668,3000000000,97.03504043126685
535,13,4,17,31.470588235294116,133.75,2675,44.583333333333336,4000000000,89.7196261682243
332,6,5,11,30.181818181818183,66.4,1660,27.666666666666668,5000000000,180.72289156626505
613,11,5,16,38.3125,122.6,3065,51.083333333333336,5000000000,97.87928221859706
576,11,9,20,28.8,64,2880,48,9000000000,187.5
604,8,6,14,43.142857142857146,100.66666666666667,3020,50.333333333333336,6000000000,119.20529801324503
574,10,5,15,38.266666666666666,114.8,2870,47.833333333333336,5000000000,104.52961672473867
1577,22,3,25,63.08,525.6666666666666,7885,131.41666666666666,3000000000,22.8281547241598
410,4,3,7,58.57142857142857,136.66666666666666,2050,34.166666666666664,3000000000,87.8048780487805
567,12,3,15,37.8,189,2835,47.25,3000000000,63.492063492063494
430,6,4,10,43,107.5,2150,35.833333333333336,4000000000,111.62790697674417
360,11,3,14,25.714285714285715,120,1800,30,3000000000,100
1126,13,3,16,70.375,375.3333333333333,5630,93.83333333333333,3000000000,31.97158081705151
1005,20,7,27,37.22222222222222,143.57142857142858,5025,83.75,7000000000,83.58208955223881
1305,16,8,24,54.375,163.125,6525,108.75,8000000000,73.56321839080461
1660,34,3,37,44.86486486486486,553.3333333333334,8300,138.33333333333334,3000000000,21.686746987951803
722,11,4,15,48.13333333333333,180.5,3610,60.166666666666664,4000000000,66.4819944598338
336,5,6,11,30.545454545454547,56,1680,28,6000000000,214.2857142857143
366,6,3,9,40.666666666666664,122,1830,30.5,3000000000,98.36065573770492
820,10,3,13,63.07692307692308,273.3333333333333,4100,68.33333333333333,3000000000,43.90243902439025
705,10,7,17,41.470588235294116,100.71428571428571,3525,58.75,7000000000,119.14893617021276
414,5,3,8,51.75,138,2070,34.5,3000000000,86.95652173913044
208,3,3,6,34.666666666666664,69.33333333333333,1040,17.333333333333332,3000000000,173.0769230769231
545,7,3,10,54.5,181.66666666666666,2725,45.416666666666664,3000000000,66.05504587155963
475,11,3,14,33.92857142857143,158.33333333333334,2375,39.583333333333336,3000000000,75.78947368421052
505,6,3,9,56.111111111111114,168.33333333333334,2525,42.083333333333336,3000000000,71.28712871287128
492,8,3,11,44.72727272727273,164,2460,41,3000000000,73.17073170731707
604,4,5,9,67.11111111111111,120.8,3020,50.333333333333336,5000000000,99.33774834437085
616,15,3,18,34.22222222222222,205.33333333333334,3080,51.333333333333336,3000000000,58.441558441558435
999,22,7,29,34.44827586206897,142.71428571428572,4995,83.25,7000000000,84.08408408408408
620,10,3,13,47.69230769230769,206.66666666666666,3100,51.666666666666664,3000000000,58.06451612903226
604,13,3,16,37.75,201.33333333333334,3020,50.333333333333336,3000000000,59.602649006622514
313,8,3,11,28.454545454545453,104.33333333333333,1565,26.083333333333332,3000000000,115.01597444089457
556,5,4,9,61.77777777777778,139,2780,46.333333333333336,4000000000,86.33093525179855
1101,19,8,27,40.77777777777778,137.625,5505,91.75,8000000000,87.19346049046321
482,6,4,10,48.2,120.5,2410,40.166666666666664,4000000000,99.5850622406639
657,11,3,14,46.92857142857143,219,3285,54.75,3000000000,54.79452054794521
1256,16,7,23,54.608695652173914,179.42857142857142,6280,104.66666666666667,7000000000,66.87898089171975
426,6,3,9,47.333333333333336,142,2130,35.5,3000000000,84.50704225352113
537,4,3,7,76.71428571428571,179,2685,44.75,3000000000,67.0391061452514
552,9,6,15,36.8,92,2760,46,6000000000,130.43478260869566
433,6,3,9,48.111111111111114,144.33333333333334,2165,36.083333333333336,3000000000,83.14087759815241
227,3,3,6,37.833333333333336,75.66666666666667,1135,18.916666666666668,3000000000,158.59030837004406
511,9,3,12,42.583333333333336,170.33333333333334,2555,42.583333333333336,3000000000,70.45009784735812
675,9,8,17,39.705882352941174,84.375,3375,56.25,8000000000,142.2222222222222
787,11,3,14,56.214285714285715,262.3333333333333,3935,65.58333333333333,3000000000,45.7433290978399
404,9,3,12,33.666666666666664,134.66666666666666,2020,33.666666666666664,3000000000,89.10891089108911
662,6,3,9,73.55555555555556,220.66666666666666,3310,55.166666666666664,3000000000,54.38066465256797
809,10,3,13,62.23076923076923,269.6666666666667,4045,67.41666666666667,3000000000,44.499381953028426
790,12,10,22,35.90909090909091,79,3950,65.83333333333333,10000000000,151.89873417721518
481,10,3,13,37,160.33333333333334,2405,40.083333333333336,3000000000,74.84407484407484
590,8,5,13,45.38461538461539,118,2950,49.166666666666664,5000000000,101.69491525423729
384,5,4,9,42.666666666666664,96,1920,32,4000000000,125
704,7,4,11,64,176,3520,58.666666666666664,4000000000,68.18181818181819
812,17,3,20,40.6,270.6666666666667,4060,67.66666666666667,3000000000,44.33497536945812
492,10,3,13,37.84615384615385,164,2460,41,3000000000,73.17073170731707
578,7,3,10,57.8,192.66666666666666,2890,48.166666666666664,3000000000,62.28373702422146
1195,14,12,26,45.96153846153846,99.58333333333333,5975,99.58333333333333,12000000000,120.50209205020921
747,11,5,16,46.6875,149.4,3735,62.25,5000000000,80.32128514056225
415,12,5,17,24.41176470588235,83,2075,34.583333333333336,5000000000,144.57831325301203
946,14,5,19,49.78947368421053,189.2,4730,78.83333333333333,5000000000,63.42494714587738
361,8,3,11,32.81818181818182,120.33333333333333,1805,30.083333333333332,3000000000,99.7229916897507
943,15,8,23,41,117.875,4715,78.58333333333333,8000000000,101.80275715800637
490,12,3,15,32.666666666666664,163.33333333333334,2450,40.833333333333336,3000000000,73.46938775510203
428,3,4,7,61.142857142857146,107,2140,35.666666666666664,4000000000,112.14953271028038
564,10,4,14,40.285714285714285,141,2820,47,4000000000,85.1063829787234
481,6,5,11,43.72727272727273,96.2,2405,40.083333333333336,5000000000,124.74012474012473
404,6,3,9,44.888888888888886,134.66666666666666,2020,33.666666666666664,3000000000,89.10891089108911
1014,12,6,18,56.333333333333336,169,5070,84.5,6000000000,71.0059171597633
456,12,3,15,30.4,152,2280,38,3000000000,78.94736842105263
595,11,3,14,42.5,198.33333333333334,2975,49.583333333333336,3000000000,60.50420168067227
608,8,5,13,46.76923076923077,121.6,3040,50.666666666666664,5000000000,98.6842105263158
587,11,4,15,39.13333333333333,146.75,2935,48.916666666666664,4000000000,81.77172061328791
253,7,3,10,25.3,84.33333333333333,1265,21.083333333333332,3000000000,142.2924901185771
266,3,4,7,38,66.5,1330,22.166666666666668,4000000000,180.45112781954887
805,11,3,14,57.5,268.3333333333333,4025,67.08333333333333,3000000000,44.72049689440994
973,14,8,22,44.22727272727273,121.625,4865,81.08333333333333,8000000000,98.6639260020555
395,5,3,8,49.375,131.66666666666666,1975,32.916666666666664,3000000000,91.13924050632912
515,7,5,12,42.916666666666664,103,2575,42.916666666666664,5000000000,116.50485436893204
730,13,3,16,45.625,243.33333333333334,3650,60.833333333333336,3000000000,49.31506849315068
1056,22,9,31,34.064516129032256,117.33333333333333,5280,88,9000000000,102.27272727272727
934,10,4,14,66.71428571428571,233.5,4670,77.83333333333333,4000000000,51.391862955032124
529,6,4,10,52.9,132.25,2645,44.083333333333336,4000000000,90.73724007561437
1189,19,4,23,51.69565217391305,297.25,5945,99.08333333333333,4000000000,40.37005887300252
670,10,3,13,51.53846153846154,223.33333333333334,3350,55.833333333333336,3000000000,53.731343283582085
388,6,7,13,29.846153846153847,55.42857142857143,1940,32.333333333333336,7000000000,216.49484536082474
280,5,3,8,35,93.33333333333333,1400,23.333333333333332,3000000000,128.57142857142858
1195,19,9,28,42.67857142857143,132.77777777777777,5975,99.58333333333333,9000000000,90.3765690376569
253,4,3,7,36.142857142857146,84.33333333333333,1265,21.083333333333332,3000000000,142.2924901185771
602,7,3,10,60.2,200.66666666666666,3010,50.166666666666664,3000000000,59.800664451827245
488,10,3,13,37.53846153846154,162.66666666666666,2440,40.666666666666664,3000000000,73.7704918032787
624,14,3,17,36.705882352941174,208,3120,52,3000000000,57.69230769230769
1004,17,3,20,50.2,334.6666666666667,5020,83.66666666666667,3000000000,35.85657370517928
450,11,3,14,32.142857142857146,150,2250,37.5,3000000000,80
388,5,3,8,48.5,129.33333333333334,1940,32.333333333333336,3000000000,92.78350515463917
815,13,3,16,50.9375,271.6666666666667,4075,67.91666666666667,3000000000,44.17177914110429
530,5,3,8,66.25,176.66666666666666,2650,44.166666666666664,3000000000,67.9245283018868
615,7,3,10,61.5,205,3075,51.25,3000000000,58.53658536585366
539,12,3,15,35.93333333333333,179.66666666666666,2695,44.916666666666664,3000000000,66.79035250463822
536,6,3,9,59.55555555555556,178.66666666666666,2680,44.666666666666664,3000000000,67.16417910447761
861,9,7,16,53.8125,123,4305,71.75,7000000000,97.5609756097561
1709,25,15,40,42.725,113.93333333333334,8545,142.41666666666666,15000000000,105.3247513165594
525,5,3,8,65.625,175,2625,43.75,3000000000,68.57142857142857
741,9,8,17,43.588235294117645,92.625,3705,61.75,8000000000,129.55465587044534
598,12,4,16,37.375,149.5,2990,49.833333333333336,4000000000,80.2675585284281
670,17,3,20,33.5,223.33333333333334,3350,55.833333333333336,3000000000,53.731343283582085
633,10,3,13,48.69230769230769,211,3165,52.75,3000000000,56.87203791469194
826,10,3,13,63.53846153846154,275.3333333333333,4130,68.83333333333333,3000000000,43.58353510895884
1054,11,6,17,62,175.66666666666666,5270,87.83333333333333,6000000000,68.3111954459203
867,16,3,19,45.63157894736842,289,4335,72.25,3000000000,41.52249134948097
686,7,3,10,68.6,228.66666666666666,3430,57.166666666666664,3000000000,52.478134110787174
277,10,3,13,21.307692307692307,92.33333333333333,1385,23.083333333333332,3000000000,129.9638989169675
206,5,3,8,25.75,68.66666666666667,1030,17.166666666666668,3000000000,174.75728155339803
506,7,5,12,42.166666666666664,101.2,2530,42.166666666666664,5000000000,118.57707509881423
482,5,3,8,60.25,160.66666666666666,2410,40.166666666666664,3000000000,74.68879668049793
491,7,3,10,49.1,163.66666666666666,2455,40.916666666666664,3000000000,73.31975560081467
600,15,3,18,33.333333333333336,200,3000,50,3000000000,60
487,9,3,12,40.583333333333336,162.33333333333334,2435,40.583333333333336,3000000000,73.92197125256672
914,9,9,18,50.77777777777778,101.55555555555556,4570,76.16666666666667,9000000000,118.16192560175054
823,8,3,11,74.81818181818181,274.3333333333333,4115,68.58333333333333,3000000000,43.74240583232078
1197,21,3,24,49.875,399,5985,99.75,3000000000,30.075187969924812
729,9,6,15,48.6,121.5,3645,60.75,6000000000,98.76543209876543
604,8,3,11,54.90909090909091,201.33333333333334,3020,50.333333333333336,3000000000,59.602649006622514
465,7,3,10,46.5,155,2325,38.75,3000000000,77.41935483870968
942,12,10,22,42.81818181818182,94.2,4710,78.5,10000000000,127.38853503184714
800,14,3,17,47.05882352941177,266.6666666666667,4000,66.66666666666667,3000000000,45
453,8,4,12,37.75,113.25,2265,37.75,4000000000,105.96026490066225
550,9,3,12,45.833333333333336,183.33333333333334,2750,45.833333333333336,3000000000,65.45454545454545
991,15,4,19,52.1578947368421,247.75,4955,82.58333333333333,4000000000,48.435923309788095
498,5,3,8,62.25,166,2490,41.5,3000000000,72.28915662650603
740,14,3,17,43.529411764705884,246.66666666666666,3700,61.666666666666664,3000000000,48.64864864864865
619,6,3,9,68.77777777777777,206.33333333333334,3095,51.583333333333336,3000000000,58.158319870759286
332,7,3,10,33.2,110.66666666666667,1660,27.666666666666668,3000000000,108.43373493975903
524,7,3,10,52.4,174.66666666666666,2620,43.666666666666664,3000000000,68.70229007633587
491,7,3,10,49.1,163.66666666666666,2455,40.916666666666664,3000000000,73.31975560081467
877,5,3,8,109.625,292.3333333333333,4385,73.08333333333333,3000000000,41.049030786773095
716,9,3,12,59.666666666666664,238.66666666666666,3580,59.666666666666664,3000000000,50.27932960893855
765,13,3,16,47.8125,255,3825,63.75,3000000000,47.05882352941176
791,13,3,16,49.4375,263.6666666666667,3955,65.91666666666667,3000000000,45.51201011378002
201,6,4,10,20.1,50.25,1005,16.75,4000000000,238.80597014925374
341,4,3,7,48.714285714285715,113.66666666666667,1705,28.416666666666668,3000000000,105.57184750733137
317,5,7,12,26.416666666666668,45.285714285714285,1585,26.416666666666668,7000000000,264.9842271293375
296,6,3,9,32.888888888888886,98.66666666666667,1480,24.666666666666668,3000000000,121.62162162162161
584,12,3,15,38.93333333333333,194.66666666666666,2920,48.666666666666664,3000000000,61.64383561643836
743,13,3,16,46.4375,247.66666666666666,3715,61.916666666666664,3000000000,48.45222072678331
554,4,4,8,69.25,138.5,2770,46.166666666666664,4000000000,86.64259927797835
1052,26,3,29,36.275862068965516,350.6666666666667,5260,87.66666666666667,3000000000,34.22053231939163
902,13,7,20,45.1,128.85714285714286,4510,75.16666666666667,7000000000,93.12638580931262
423,8,3,11,38.45454545454545,141,2115,35.25,3000000000,85.1063829787234
754,13,4,17,44.35294117647059,188.5,3770,62.833333333333336,4000000000,63.6604774535809
593,12,3,15,39.53333333333333,197.66666666666666,2965,49.416666666666664,3000000000,60.708263069139974
664,15,3,18,36.888888888888886,221.33333333333334,3320,55.333333333333336,3000000000,54.21686746987952
1357,16,9,25,54.28,150.77777777777777,6785,113.08333333333333,9000000000,79.58732498157701
561,8,5,13,43.15384615384615,112.2,2805,46.75,5000000000,106.951871657754
766,15,3,18,42.55555555555556,255.33333333333334,3830,63.833333333333336,3000000000,46.99738903394256
610,9,5,14,43.57142857142857,122,3050,50.833333333333336,5000000000,98.36065573770492
679,6,4,10,67.9,169.75,3395,56.583333333333336,4000000000,70.6921944035346
595,7,3,10,59.5,198.33333333333334,2975,49.583333333333336,3000000000,60.50420168067227
418,8,3,11,38,139.33333333333334,2090,34.833333333333336,3000000000,86.1244019138756
551,7,8,15,36.733333333333334,68.875,2755,45.916666666666664,8000000000,174.22867513611615
328,6,3,9,36.44444444444444,109.33333333333333,1640,27.333333333333332,3000000000,109.7560975609756
388,4,4,8,48.5,97,1940,32.333333333333336,4000000000,123.71134020618557
897,13,3,16,56.0625,299,4485,74.75,3000000000,40.13377926421405
744,11,5,16,46.5,148.8,3720,62,5000000000,80.64516129032259
496,4,3,7,70.85714285714286,165.33333333333334,2480,41.333333333333336,3000000000,72.58064516129032
649,15,4,19,34.1578947368421,162.25,3245,54.083333333333336,4000000000,73.95993836671802
316,3,3,6,52.666666666666664,105.33333333333333,1580,26.333333333333332,3000000000,113.9240506329114
440,5,4,9,48.888888888888886,110,2200,36.666666666666664,4000000000,109.0909090909091
353,5,3,8,44.125,117.66666666666667,1765,29.416666666666668,3000000000,101.98300283286119
1226,17,11,28,43.785714285714285,111.45454545454545,6130,102.16666666666667,11000000000,107.66721044045676
1149,24,9,33,34.81818181818182,127.66666666666667,5745,95.75,9000000000,93.99477806788512
294,3,3,6,49,98,1470,24.5,3000000000,122.44897959183673
776,21,4,25,31.04,194,3880,64.66666666666667,4000000000,61.855670103092784
332,6,4,10,33.2,83,1660,27.666666666666668,4000000000,144.57831325301203
508,7,3,10,50.8,169.33333333333334,2540,42.333333333333336,3000000000,70.86614173228345
752,13,3,16,47,250.66666666666666,3760,62.666666666666664,3000000000,47.87234042553192
596,11,3,14,42.57142857142857,198.66666666666666,2980,49.666666666666664,3000000000,60.4026845637584
1154,19,9,28,41.214285714285715,128.22222222222223,5770,96.16666666666667,9000000000,93.58752166377816
400,5,5,10,40,80,2000,33.333333333333336,5000000000,150
494,8,6,14,35.285714285714285,82.33333333333333,2470,41.166666666666664,6000000000,145.74898785425103
968,10,8,18,53.77777777777778,121,4840,80.66666666666667,8000000000,99.17355371900825
1087,14,3,17,63.94117647058823,362.3333333333333,5435,90.58333333333333,3000000000,33.11867525298988
659,9,9,18,36.611111111111114,73.22222222222223,3295,54.916666666666664,9000000000,163.8846737481032
243,5,3,8,30.375,81,1215,20.25,3000000000,148.14814814814815
863,16,10,26,33.19230769230769,86.3,4315,71.91666666666667,10000000000,139.04982618771726
952,9,8,17,56,119,4760,79.33333333333333,8000000000,100.84033613445379
338,7,4,11,30.727272727272727,84.5,1690,28.166666666666668,4000000000,142.0118343195266
404,10,3,13,31.076923076923077,134.66666666666666,2020,33.666666666666664,3000000000,89.10891089108911
945,16,4,20,47.25,236.25,4725,78.75,4000000000,50.79365079365079
470,6,4,10,47,117.5,2350,39.166666666666664,4000000000,102.1276595744681
817,7,3,10,81.7,272.3333333333333,4085,68.08333333333333,3000000000,44.06364749082008
303,3,5,8,37.875,60.6,1515,25.25,5000000000,198.01980198019803
659,16,5,21,31.38095238095238,131.8,3295,54.916666666666664,5000000000,91.04704097116844
379,8,3,11,34.45454545454545,126.33333333333333,1895,31.583333333333332,3000000000,94.9868073878628
552,11,3,14,39.42857142857143,184,2760,46,3000000000,65.21739130434783
660,9,3,12,55,220,3300,55,3000000000,54.54545454545455
701,5,3,8,87.625,233.66666666666666,3505,58.416666666666664,3000000000,51.35520684736092
336,5,3,8,42,112,1680,28,3000000000,107.14285714285715
548,11,3,14,39.142857142857146,182.66666666666666,2740,45.666666666666664,3000000000,65.69343065693431
1014,18,3,21,48.285714285714285,338,5070,84.5,3000000000,35.50295857988165
351,7,3,10,35.1,117,1755,29.25,3000000000,102.56410256410255
300,5,6,11,27.272727272727273,50,1500,25,6000000000,240
670,7,3,10,67,223.33333333333334,3350,55.833333333333336,3000000000,53.731343283582085
1176,18,3,21,56,392,5880,98,3000000000,30.612244897959183
439,6,3,9,48.77777777777778,146.33333333333334,2195,36.583333333333336,3000000000,82.00455580865604
330,5,4,9,36.666666666666664,82.5,1650,27.5,4000000000,145.45454545454547
697,6,3,9,77.44444444444444,232.33333333333334,3485,58.083333333333336,3000000000,51.649928263988514
625,8,4,12,52.083333333333336,156.25,3125,52.083333333333336,4000000000,76.8
817,8,4,12,68.08333333333333,204.25,4085,68.08333333333333,4000000000,58.7515299877601
695,11,3,14,49.642857142857146,231.66666666666666,3475,57.916666666666664,3000000000,51.79856115107914
636,6,4,10,63.6,159,3180,53,4000000000,75.47169811320755
794,12,3,15,52.93333333333333,264.6666666666667,3970,66.16666666666667,3000000000,45.34005037783375
560,15,4,19,29.473684210526315,140,2800,46.666666666666664,4000000000,85.71428571428572
471,6,3,9,52.333333333333336,157,2355,39.25,3000000000,76.43312101910828
432,10,3,13,33.23076923076923,144,2160,36,3000000000,83.33333333333333
802,11,6,17,47.1764705882353,133.66666666666666,4010,66.83333333333333,6000000000,89.77556109725687
450,10,3,13,34.61538461538461,150,2250,37.5,3000000000,80
741,11,5,16,46.3125,148.2,3705,61.75,5000000000,80.97165991902834
409,7,3,10,40.9,136.33333333333334,2045,34.083333333333336,3000000000,88.01955990220048
706,12,3,15,47.06666666666667,235.33333333333334,3530,58.833333333333336,3000000000,50.991501416430594
598,8,3,11,54.36363636363637,199.33333333333334,2990,49.833333333333336,3000000000,60.20066889632107
427,8,3,11,38.81818181818182,142.33333333333334,2135,35.583333333333336,3000000000,84.30913348946135
379,5,3,8,47.375,126.33333333333333,1895,31.583333333333332,3000000000,94.9868073878628
619,6,7,13,47.61538461538461,88.42857142857143,3095,51.583333333333336,7000000000,135.702746365105
1313,20,10,30,43.766666666666666,131.3,6565,109.41666666666667,10000000000,91.3937547600914
383,10,3,13,29.46153846153846,127.66666666666667,1915,31.916666666666668,3000000000,93.99477806788512
635,7,7,14,45.357142857142854,90.71428571428571,3175,52.916666666666664,7000000000,132.28346456692915
435,4,3,7,62.142857142857146,145,2175,36.25,3000000000,82.75862068965517
676,15,3,18,37.55555555555556,225.33333333333334,3380,56.333333333333336,3000000000,53.25443786982248
412,5,3,8,51.5,137.33333333333334,2060,34.333333333333336,3000000000,87.37864077669902
450,6,3,9,50,150,2250,37.5,3000000000,80
444,9,3,12,37,148,2220,37,3000000000,81.08108108108108
383,5,3,8,47.875,127.66666666666667,1915,31.916666666666668,3000000000,93.99477806788512
478,4,5,9,53.111111111111114,95.6,2390,39.833333333333336,5000000000,125.52301255230124
900,9,5,14,64.28571428571429,180,4500,75,5000000000,66.66666666666666
977,21,3,24,40.708333333333336,325.6666666666667,4885,81.41666666666667,3000000000,36.8474923234391
1240,17,4,21,59.04761904761905,310,6200,103.33333333333333,4000000000,38.70967741935484
576,6,3,9,64,192,2880,48,3000000000,62.5
589,16,3,19,31,196.33333333333334,2945,49.083333333333336,3000000000,61.120543293718164
778,11,3,14,55.57142857142857,259.3333333333333,3890,64.83333333333333,3000000000,46.27249357326478
508,7,6,13,39.07692307692308,84.66666666666667,2540,42.333333333333336,6000000000,141.7322834645669
1161,10,9,19,61.10526315789474,129,5805,96.75,9000000000,93.02325581395348
481,11,3,14,34.357142857142854,160.33333333333334,2405,40.083333333333336,3000000000,74.84407484407484
549,7,6,13,42.23076923076923,91.5,2745,45.75,6000000000,131.14754098360658
195,7,3,10,19.5,65,975,16.25,3000000000,184.6153846153846
313,3,3,6,52.166666666666664,104.33333333333333,1565,26.083333333333332,3000000000,115.01597444089457
101,3,3,6,16.833333333333332,33.666666666666664,505,8.416666666666666,3000000000,356.43564356435644
1482,22,3,25,59.28,494,7410,123.5,3000000000,24.291497975708502
705,12,4,16,44.0625,176.25,3525,58.75,4000000000,68.08510638297872
569,9,4,13,43.76923076923077,142.25,2845,47.416666666666664,4000000000,84.3585237258348
468,6,3,9,52,156,2340,39,3000000000,76.92307692307693
497,4,5,9,55.22222222222222,99.4,2485,41.416666666666664,5000000000,120.72434607645876
330,5,3,8,41.25,110,1650,27.5,3000000000,109.0909090909091
791,9,4,13,60.84615384615385,197.75,3955,65.91666666666667,4000000000,60.6826801517067
793,12,3,15,52.86666666666667,264.3333333333333,3965,66.08333333333333,3000000000,45.39722572509458
433,5,3,8,54.125,144.33333333333334,2165,36.083333333333336,3000000000,83.14087759815241
1016,18,3,21,48.38095238095238,338.6666666666667,5080,84.66666666666667,3000000000,35.433070866141726
404,11,3,14,28.857142857142858,134.66666666666666,2020,33.666666666666664,3000000000,89.10891089108911
470,9,3,12,39.166666666666664,156.66666666666666,2350,39.166666666666664,3000000000,76.59574468085107
828,16,3,19,43.578947368421055,276,4140,69,3000000000,43.47826086956522
1135,24,7,31,36.61290322580645,162.14285714285714,5675,94.58333333333333,7000000000,74.00881057268722
717,11,5,16,44.8125,143.4,3585,59.75,5000000000,83.68200836820084
472,5,5,10,47.2,94.4,2360,39.333333333333336,5000000000,127.11864406779661
1109,10,10,20,55.45,110.9,5545,92.41666666666667,10000000000,108.20559062218214
631,17,6,23,27.434782608695652,105.16666666666667,3155,52.583333333333336,6000000000,114.10459587955626
1281,17,5,22,58.22727272727273,256.2,6405,106.75,5000000000,46.8384074941452
818,11,6,17,48.11764705882353,136.33333333333334,4090,68.16666666666667,6000000000,88.01955990220048
489,5,4,9,54.333333333333336,122.25,2445,40.75,4000000000,98.15950920245399
1061,17,4,21,50.523809523809526,265.25,5305,88.41666666666667,4000000000,45.24033930254477
1162,14,3,17,68.3529411764706,387.3333333333333,5810,96.83333333333333,3000000000,30.98106712564544
651,10,3,13,50.07692307692308,217,3255,54.25,3000000000,55.29953917050691
548,5,5,10,54.8,109.6,2740,45.666666666666664,5000000000,109.48905109489051
543,3,4,7,77.57142857142857,135.75,2715,45.25,4000000000,88.39779005524862
1293,14,12,26,49.73076923076923,107.75,6465,107.75,12000000000,111.36890951276102
877,15,7,22,39.86363636363637,125.28571428571429,4385,73.08333333333333,7000000000,95.78107183580389
616,11,4,15,41.06666666666667,154,3080,51.333333333333336,4000000000,77.92207792207792
570,11,3,14,40.714285714285715,190,2850,47.5,3000000000,63.1578947368421
421,8,3,11,38.27272727272727,140.33333333333334,2105,35.083333333333336,3000000000,85.5106888361045
460,8,4,12,38.333333333333336,115,2300,38.333333333333336,4000000000,104.34782608695652
949,16,6,22,43.13636363636363,158.16666666666666,4745,79.08333333333333,6000000000,75.86933614330874
460,6,4,10,46,115,2300,38.333333333333336,4000000000,104.34782608695652
324,7,3,10,32.4,108,1620,27,3000000000,111.1111111111111
493,4,4,8,61.625,123.25,2465,41.083333333333336,4000000000,97.3630831643002
664,9,5,14,47.42857142857143,132.8,3320,55.333333333333336,5000000000,90.36144578313252
331,9,3,12,27.583333333333332,110.33333333333333,1655,27.583333333333332,3000000000,108.76132930513594
330,5,3,8,41.25,110,1650,27.5,3000000000,109.0909090909091
616,9,3,12,51.333333333333336,205.33333333333334,3080,51.333333333333336,3000000000,58.441558441558435
738,11,7,18,41,105.42857142857143,3690,61.5,7000000000,113.82113821138212
643,15,3,18,35.72222222222222,214.33333333333334,3215,53.583333333333336,3000000000,55.987558320373246
370,3,4,7,52.857142857142854,92.5,1850,30.833333333333332,4000000000,129.72972972972974
766,9,6,15,51.06666666666667,127.66666666666667,3830,63.833333333333336,6000000000,93.99477806788512
461,6,7,13,35.46153846153846,65.85714285714286,2305,38.416666666666664,7000000000,182.2125813449024
633,9,3,12,52.75,211,3165,52.75,3000000000,56.87203791469194
487,6,4,10,48.7,121.75,2435,40.583333333333336,4000000000,98.56262833675565
1022,15,3,18,56.77777777777778,340.6666666666667,5110,85.16666666666667,3000000000,35.22504892367906
1288,17,13,30,42.93333333333333,99.07692307692308,6440,107.33333333333333,13000000000,121.11801242236025
399,9,3,12,33.25,133,1995,33.25,3000000000,90.22556390977444
800,13,9,22,36.36363636363637,88.88888888888889,4000,66.66666666666667,9000000000,135
364,7,3,10,36.4,121.33333333333333,1820,30.333333333333332,3000000000,98.9010989010989
299,6,3,9,33.22222222222222,99.66666666666667,1495,24.916666666666668,3000000000,120.40133779264214
583,16,3,19,30.68421052631579,194.33333333333334,2915,48.583333333333336,3000000000,61.74957118353345
1012,20,3,23,44,337.3333333333333,5060,84.33333333333333,3000000000,35.57312252964427
584,4,3,7,83.42857142857143,194.66666666666666,2920,48.666666666666664,3000000000,61.64383561643836
379,3,3,6,63.166666666666664,126.33333333333333,1895,31.583333333333332,3000000000,94.9868073878628
686,9,3,12,57.166666666666664,228.66666666666666,3430,57.166666666666664,3000000000,52.478134110787174
707,8,4,12,58.916666666666664,176.75,3535,58.916666666666664,4000000000,67.89250353606789
636,8,6,14,45.42857142857143,106,3180,53,6000000000,113.20754716981132
309,4,3,7,44.142857142857146,103,1545,25.75,3000000000,116.50485436893204
365,7,3,10,36.5,121.66666666666667,1825,30.416666666666668,3000000000,98.63013698630137
791,9,4,13,60.84615384615385,197.75,3955,65.91666666666667,4000000000,60.6826801517067
1739,35,3,38,45.76315789473684,579.6666666666666,8695,144.91666666666666,3000000000,20.701552616446236
1122,20,10,30,37.4,112.2,5610,93.5,10000000000,106.951871657754
587,5,10,15,39.13333333333333,58.7,2935,48.916666666666664,10000000000,204.42930153321979
476,8,3,11,43.27272727272727,158.66666666666666,2380,39.666666666666664,3000000000,75.63025210084035
621,10,3,13,47.76923076923077,207,3105,51.75,3000000000,57.971014492753625
909,15,7,22,41.31818181818182,129.85714285714286,4545,75.75,7000000000,92.40924092409242
424,3,5,8,53,84.8,2120,35.333333333333336,5000000000,141.50943396226415
468,6,4,10,46.8,117,2340,39,4000000000,102.56410256410255
584,9,3,12,48.666666666666664,194.66666666666666,2920,48.666666666666664,3000000000,61.64383561643836
1056,19,8,27,39.111111111111114,132,5280,88,8000000000,90.9090909090909
581,9,3,12,48.416666666666664,193.66666666666666,2905,48.416666666666664,3000000000,61.96213425129088
461,13,3,16,28.8125,153.66666666666666,2305,38.416666666666664,3000000000,78.09110629067246
642,12,3,15,42.8,214,3210,53.5,3000000000,56.074766355140184
336,6,3,9,37.333333333333336,112,1680,28,3000000000,107.14285714285715
568,7,3,10,56.8,189.33333333333334,2840,47.333333333333336,3000000000,63.38028169014084
1093,17,3,20,54.65,364.3333333333333,5465,91.08333333333333,3000000000,32.93687099725526
349,4,4,8,43.625,87.25,1745,29.083333333333332,4000000000,137.53581661891118
935,8,4,12,77.91666666666667,233.75,4675,77.91666666666667,4000000000,51.33689839572192
496,8,3,11,45.09090909090909,165.33333333333334,2480,41.333333333333336,3000000000,72.58064516129032
601,10,3,13,46.23076923076923,200.33333333333334,3005,50.083333333333336,3000000000,59.90016638935108
896,13,6,19,47.1578947368421,149.33333333333334,4480,74.66666666666667,6000000000,80.35714285714285
525,10,3,13,40.38461538461539,175,2625,43.75,3000000000,68.57142857142857
667,10,3,13,51.30769230769231,222.33333333333334,3335,55.583333333333336,3000000000,53.973013493253376
436,7,3,10,43.6,145.33333333333334,2180,36.333333333333336,3000000000,82.56880733944953
536,11,6,17,31.529411764705884,89.33333333333333,2680,44.666666666666664,6000000000,134.32835820895522
439,10,3,13,33.76923076923077,146.33333333333334,2195,36.583333333333336,3000000000,82.00455580865604
910,9,5,14,65,182,4550,75.83333333333333,5000000000,65.93406593406594
286,7,3,10,28.6,95.33333333333333,1430,23.833333333333332,3000000000,125.87412587412588
258,5,5,10,25.8,51.6,1290,21.5,5000000000,232.5581395348837
678,12,3,15,45.2,226,3390,56.5,3000000000,53.097345132743364
1889,32,14,46,41.06521739130435,134.92857142857142,9445,157.41666666666666,14000000000,88.93594494441503
1085,15,3,18,60.27777777777778,361.6666666666667,5425,90.41666666666667,3000000000,33.17972350230414
876,11,3,14,62.57142857142857,292,4380,73,3000000000,41.0958904109589
564,4,4,8,70.5,141,2820,47,4000000000,85.1063829787234
879,18,3,21,41.857142857142854,293,4395,73.25,3000000000,40.955631399317404
622,8,3,11,56.54545454545455,207.33333333333334,3110,51.833333333333336,3000000000,57.877813504823145
419,7,3,10,41.9,139.66666666666666,2095,34.916666666666664,3000000000,85.91885441527447
178,4,3,7,25.428571428571427,59.333333333333336,890,14.833333333333334,3000000000,202.24719101123594
431,4,3,7,61.57142857142857,143.66666666666666,2155,35.916666666666664,3000000000,83.52668213457078
421,7,3,10,42.1,140.33333333333334,2105,35.083333333333336,3000000000,85.5106888361045
875,14,7,21,41.666666666666664,125,4375,72.91666666666667,7000000000,96
412,9,3,12,34.333333333333336,137.33333333333334,2060,34.333333333333336,3000000000,87.37864077669902
301,5,4,9,33.44444444444444,75.25,1505,25.083333333333332,4000000000,159.468438538206
605,6,4,10,60.5,151.25,3025,50.416666666666664,4000000000,79.33884297520662
1117,26,14,40,27.925,79.78571428571429,5585,93.08333333333333,14000000000,150.40286481647271
421,4,3,7,60.142857142857146,140.33333333333334,2105,35.083333333333336,3000000000,85.5106888361045
365,5,3,8,45.625,121.66666666666667,1825,30.416666666666668,3000000000,98.63013698630137
942,24,4,28,33.642857142857146,235.5,4710,78.5,4000000000,50.955414012738856
685,4,3,7,97.85714285714286,228.33333333333334,3425,57.083333333333336,3000000000,52.55474452554744
584,7,6,13,44.92307692307692,97.33333333333333,2920,48.666666666666664,6000000000,123.28767123287672
178,3,3,6,29.666666666666668,59.333333333333336,890,14.833333333333334,3000000000,202.24719101123594
259,6,3,9,28.77777777777778,86.33333333333333,1295,21.583333333333332,3000000000,138.996138996139
620,4,9,13,47.69230769230769,68.88888888888889,3100,51.666666666666664,9000000000,174.1935483870968
361,5,5,10,36.1,72.2,1805,30.083333333333332,5000000000,166.2049861495845
366,7,3,10,36.6,122,1830,30.5,3000000000,98.36065573770492
550,4,3,7,78.57142857142857,183.33333333333334,2750,45.833333333333336,3000000000,65.45454545454545
534,10,7,17,31.41176470588235,76.28571428571429,2670,44.5,7000000000,157.30337078651684
569,7,4,11,51.72727272727273,142.25,2845,47.416666666666664,4000000000,84.3585237258348
972,14,7,21,46.285714285714285,138.85714285714286,4860,81,7000000000,86.41975308641975
687,10,3,13,52.84615384615385,229,3435,57.25,3000000000,52.40174672489083
627,11,3,14,44.785714285714285,209,3135,52.25,3000000000,57.41626794258373
679,13,3,16,42.4375,226.33333333333334,3395,56.583333333333336,3000000000,53.01914580265096
763,15,6,21,36.333333333333336,127.16666666666667,3815,63.583333333333336,6000000000,94.36435124508517
439,7,3,10,43.9,146.33333333333334,2195,36.583333333333336,3000000000,82.00455580865604
632,13,3,16,39.5,210.66666666666666,3160,52.666666666666664,3000000000,56.9620253164557
658,17,3,20,32.9,219.33333333333334,3290,54.833333333333336,3000000000,54.7112462006079
516,5,3,8,64.5,172,2580,43,3000000000,69.76744186046511
449,11,4,15,29.933333333333334,112.25,2245,37.416666666666664,4000000000,106.9042316258352
672,5,5,10,67.2,134.4,3360,56,5000000000,89.28571428571428
536,8,3,11,48.72727272727273,178.66666666666666,2680,44.666666666666664,3000000000,67.16417910447761
739,5,6,11,67.18181818181819,123.16666666666667,3695,61.583333333333336,6000000000,97.42895805142084
466,5,3,8,58.25,155.33333333333334,2330,38.833333333333336,3000000000,77.25321888412017
734,15,3,18,40.77777777777778,244.66666666666666,3670,61.166666666666664,3000000000,49.04632152588556
641,5,4,9,71.22222222222223,160.25,3205,53.416666666666664,4000000000,74.88299531981279
409,6,3,9,45.44444444444444,136.33333333333334,2045,34.083333333333336,3000000000,88.01955990220048
1065,18,7,25,42.6,152.14285714285714,5325,88.75,7000000000,78.87323943661971
699,11,5,16,43.6875,139.8,3495,58.25,5000000000,85.83690987124464
821,8,7,15,54.733333333333334,117.28571428571429,4105,68.41666666666667,7000000000,102.3142509135201
401,5,6,11,36.45454545454545,66.83333333333333,2005,33.416666666666664,6000000000,179.55112219451374
368,6,3,9,40.888888888888886,122.66666666666667,1840,30.666666666666668,3000000000,97.82608695652173
953,19,3,22,43.31818181818182,317.6666666666667,4765,79.41666666666667,3000000000,37.775445960125914
660,12,4,16,41.25,165,3300,55,4000000000,72.72727272727273
432,5,5,10,43.2,86.4,2160,36,5000000000,138.88888888888889
603,13,4,17,35.470588235294116,150.75,3015,50.25,4000000000,79.60199004975124
1746,18,9,27,64.66666666666667,194,8730,145.5,9000000000,61.855670103092784
267,6,3,9,29.666666666666668,89,1335,22.25,3000000000,134.83146067415728
979,18,8,26,37.65384615384615,122.375,4895,81.58333333333333,8000000000,98.05924412665985
617,12,6,18,34.27777777777778,102.83333333333333,3085,51.416666666666664,6000000000,116.69367909238251
506,16,3,19,26.63157894736842,168.66666666666666,2530,42.166666666666664,3000000000,71.14624505928855
506,8,5,13,38.92307692307692,101.2,2530,42.166666666666664,5000000000,118.57707509881423
559,10,3,13,43,186.33333333333334,2795,46.583333333333336,3000000000,64.40071556350627
256,8,3,11,23.272727272727273,85.33333333333333,1280,21.333333333333332,3000000000,140.625
498,6,3,9,55.333333333333336,166,2490,41.5,3000000000,72.28915662650603
521,12,5,17,30.647058823529413,104.2,2605,43.416666666666664,5000000000,115.16314779270634
437,13,3,16,27.3125,145.66666666666666,2185,36.416666666666664,3000000000,82.37986270022884
1169,27,3,30,38.96666666666667,389.6666666666667,5845,97.41666666666667,3000000000,30.795551753635586
1003,10,7,17,59,143.28571428571428,5015,83.58333333333333,7000000000,83.74875373878366
1066,23,3,26,41,355.3333333333333,5330,88.83333333333333,3000000000,33.77110694183865
515,13,4,17,30.294117647058822,128.75,2575,42.916666666666664,4000000000,93.20388349514563
603,6,3,9,67,201,3015,50.25,3000000000,59.701492537313435
419,4,4,8,52.375,104.75,2095,34.916666666666664,4000000000,114.55847255369929
1105,17,3,20,55.25,368.3333333333333,5525,92.08333333333333,3000000000,32.579185520361996
586,9,3,12,48.833333333333336,195.33333333333334,2930,48.833333333333336,3000000000,61.4334470989761
327,4,3,7,46.714285714285715,109,1635,27.25,3000000000,110.09174311926604
364,8,3,11,33.09090909090909,121.33333333333333,1820,30.333333333333332,3000000000,98.9010989010989
781,21,5,26,30.03846153846154,156.2,3905,65.08333333333333,5000000000,76.8245838668374
340,3,3,6,56.666666666666664,113.33333333333333,1700,28.333333333333332,3000000000,105.88235294117648
557,9,5,14,39.785714285714285,111.4,2785,46.416666666666664,5000000000,107.71992818671454
485,10,4,14,34.642857142857146,121.25,2425,40.416666666666664,4000000000,98.96907216494846
727,12,3,15,48.46666666666667,242.33333333333334,3635,60.583333333333336,3000000000,49.51856946354883
1309,19,3,22,59.5,436.3333333333333,6545,109.08333333333333,3000000000,27.501909854851032
530,11,3,14,37.857142857142854,176.66666666666666,2650,44.166666666666664,3000000000,67.9245283018868
1012,17,3,20,50.6,337.3333333333333,5060,84.33333333333333,3000000000,35.57312252964427
309,9,3,12,25.75,103,1545,25.75,3000000000,116.50485436893204
463,4,3,7,66.14285714285714,154.33333333333334,2315,38.583333333333336,3000000000,77.7537796976242
303,5,3,8,37.875,101,1515,25.25,3000000000,118.81188118811882
542,9,4,13,41.69230769230769,135.5,2710,45.166666666666664,4000000000,88.5608856088561
390,7,4,11,35.45454545454545,97.5,1950,32.5,4000000000,123.07692307692307
824,14,3,17,48.470588235294116,274.6666666666667,4120,68.66666666666667,3000000000,43.68932038834951
764,8,3,11,69.45454545454545,254.66666666666666,3820,63.666666666666664,3000000000,47.12041884816754
387,7,3,10,38.7,129,1935,32.25,3000000000,93.02325581395348
236,4,4,8,29.5,59,1180,19.666666666666668,4000000000,203.38983050847455
451,6,3,9,50.111111111111114,150.33333333333334,2255,37.583333333333336,3000000000,79.82261640798227
654,13,7,20,32.7,93.42857142857143,3270,54.5,7000000000,128.44036697247705
368,7,3,10,36.8,122.66666666666667,1840,30.666666666666668,3000000000,97.82608695652173
702,17,3,20,35.1,234,3510,58.5,3000000000,51.28205128205128
695,13,4,17,40.88235294117647,173.75,3475,57.916666666666664,4000000000,69.06474820143886
748,9,4,13,57.53846153846154,187,3740,62.333333333333336,4000000000,64.171122994652407
511,8,5,13,39.30769230769231,102.2,2555,42.583333333333336,5000000000,117.41682974559686
578,8,7,15,38.53333333333333,82.57142857142857,2890,48.166666666666664,7000000000,145.32871972318338
596,3,3,6,99.33333333333333,198.66666666666666,2980,49.666666666666664,3000000000,60.4026845637584
774,15,8,23,33.65217391304348,96.75,3870,64.5,8000000000,124.03100775193799
692,14,3,17,40.705882352941174,230.66666666666666,3460,57.666666666666664,3000000000,52.02312138728323
1339,12,8,20,66.95,167.375,6695,111.58333333333333,8000000000,71.69529499626587
804,9,3,12,67,268,4020,67,3000000000,44.776119402985074
847,13,3,16,52.9375,282.3333333333333,4235,70.58333333333333,3000000000,42.502951593860686
355,11,3,14,25.357142857142858,118.33333333333333,1775,29.583333333333332,3000000000,101.40845070422536
396,6,3,9,44,132,1980,33,3000000000,90.9090909090909
612,12,3,15,40.8,204,3060,51,3000000000,58.8235294117647
502,4,3,7,71.71428571428571,167.33333333333334,2510,41.833333333333336,3000000000,71.71314741035856
781,13,4,17,45.94117647058823,195.25,3905,65.08333333333333,4000000000,61.45966709346992
396,4,6,10,39.6,66,1980,33,6000000000,181.8181818181818
805,9,3,12,67.08333333333333,268.3333333333333,4025,67.08333333333333,3000000000,44.72049689440994
636,5,3,8,79.5,212,3180,53,3000000000,56.60377358490566
547,6,3,9,60.77777777777778,182.33333333333334,2735,45.583333333333336,3000000000,65.81352833638024
643,11,3,14,45.92857142857143,214.33333333333334,3215,53.583333333333336,3000000000,55.987558320373246
425,10,5,15,28.333333333333332,85,2125,35.416666666666664,5000000000,141.17647058823528
337,6,3,9,37.44444444444444,112.33333333333333,1685,28.083333333333332,3000000000,106.82492581602374
314,7,5,12,26.166666666666668,62.8,1570,26.166666666666668,5000000000,191.08280254777068
903,11,5,16,56.4375,180.6,4515,75.25,5000000000,66.44518272425249
702,9,8,17,41.294117647058826,87.75,3510,58.5,8000000000,136.75213675213678
473,5,3,8,59.125,157.66666666666666,2365,39.416666666666664,3000000000,76.10993657505286
759,17,3,20,37.95,253,3795,63.25,3000000000,47.430830039525695
256,8,3,11,23.272727272727273,85.33333333333333,1280,21.333333333333332,3000000000,140.625
554,7,5,12,46.166666666666664,110.8,2770,46.166666666666664,5000000000,108.30324909747294
482,12,5,17,28.352941176470587,96.4,2410,40.166666666666664,5000000000,124.48132780082989
473,13,3,16,29.5625,157.66666666666666,2365,39.416666666666664,3000000000,76.10993657505286
476,8,3,11,43.27272727272727,158.66666666666666,2380,39.666666666666664,3000000000,75.63025210084035
1028,23,3,26,39.53846153846154,342.6666666666667,5140,85.66666666666667,3000000000,35.01945525291829
543,5,3,8,67.875,181,2715,45.25,3000000000,66.29834254143647
933,7,5,12,77.75,186.6,4665,77.75,5000000000,64.30868167202573
404,4,3,7,57.714285714285715,134.66666666666666,2020,33.666666666666664,3000000000,89.10891089108911
415,9,3,12,34.583333333333336,138.33333333333334,2075,34.583333333333336,3000000000,86.74698795180721
676,13,3,16,42.25,225.33333333333334,3380,56.333333333333336,3000000000,53.25443786982248
355,4,3,7,50.714285714285715,118.33333333333333,1775,29.583333333333332,3000000000,101.40845070422536
199,7,3,10,19.9,66.33333333333333,995,16.583333333333332,3000000000,180.90452261306532
753,11,3,14,53.785714285714285,251,3765,62.75,3000000000,47.808764940239044
380,4,3,7,54.285714285714285,126.66666666666667,1900,31.666666666666668,3000000000,94.73684210526316
574,7,3,10,57.4,191.33333333333334,2870,47.833333333333336,3000000000,62.7177700348432
496,16,3,19,26.105263157894736,165.33333333333334,2480,41.333333333333336,3000000000,72.58064516129032
442,4,4,8,55.25,110.5,2210,36.833333333333336,4000000000,108.5972850678733
1026,23,3,26,39.46153846153846,342,5130,85.5,3000000000,35.08771929824562
720,3,5,8,90,144,3600,60,5000000000,83.33333333333333
517,6,3,9,57.44444444444444,172.33333333333334,2585,43.083333333333336,3000000000,69.63249516441006
175,3,3,6,29.166666666666668,58.333333333333336,875,14.583333333333334,3000000000,205.7142857142857
679,12,3,15,45.266666666666666,226.33333333333334,3395,56.583333333333336,3000000000,53.01914580265096
228,5,3,8,28.5,76,1140,19,3000000000,157.89473684210526
1095,19,5,24,45.625,219,5475,91.25,5000000000,54.79452054794521
1045,23,3,26,40.19230769230769,348.3333333333333,5225,87.08333333333333,3000000000,34.44976076555024
403,9,3,12,33.583333333333336,134.33333333333334,2015,33.583333333333336,3000000000,89.33002481389578
775,9,7,16,48.4375,110.71428571428571,3875,64.58333333333333,7000000000,108.38709677419355
1083,18,5,23,47.08695652173913,216.6,5415,90.25,5000000000,55.4016620498615
943,11,7,18,52.388888888888886,134.71428571428572,4715,78.58333333333333,7000000000,89.07741251325557
895,9,3,12,74.58333333333333,298.3333333333333,4475,74.58333333333333,3000000000,40.22346368715084
434,6,3,9,48.22222222222222,144.66666666666666,2170,36.166666666666664,3000000000,82.94930875576037
372,5,5,10,37.2,74.4,1860,31,5000000000,161.29032258064518
691,7,3,10,69.1,230.33333333333334,3455,57.583333333333336,3000000000,52.098408104196814
520,7,3,10,52,173.33333333333334,2600,43.333333333333336,3000000000,69.23076923076923
504,7,3,10,50.4,168,2520,42,3000000000,71.42857142857143
783,13,3,16,48.9375,261,3915,65.25,3000000000,45.97701149425288
393,6,3,9,43.666666666666664,131,1965,32.75,3000000000,91.6030534351145
904,14,6,20,45.2,150.66666666666666,4520,75.33333333333333,6000000000,79.64601769911505
282,5,4,9,31.333333333333332,70.5,1410,23.5,4000000000,170.2127659574468
668,14,3,17,39.294117647058826,222.66666666666666,3340,55.666666666666664,3000000000,53.89221556886228
795,12,3,15,53,265,3975,66.25,3000000000,45.283018867924525
425,10,3,13,32.69230769230769,141.66666666666666,2125,35.416666666666664,3000000000,84.70588235294119
1425,27,7,34,41.911764705882355,203.57142857142858,7125,118.75,7000000000,58.94736842105264
839,14,3,17,49.35294117647059,279.6666666666667,4195,69.91666666666667,3000000000,42.908224076281286
602,10,3,13,46.30769230769231,200.66666666666666,3010,50.166666666666664,3000000000,59.800664451827245
960,13,3,16,60,320,4800,80,3000000000,37.5
550,11,3,14,39.285714285714285,183.33333333333334,2750,45.833333333333336,3000000000,65.45454545454545
665,9,3,12,55.416666666666664,221.66666666666666,3325,55.416666666666664,3000000000,54.13533834586466
246,4,3,7,35.142857142857146,82,1230,20.5,3000000000,146.34146341463415
367,6,3,9,40.77777777777778,122.33333333333333,1835,30.583333333333332,3000000000,98.09264305177112
377,8,4,12,31.416666666666668,94.25,1885,31.416666666666668,4000000000,127.3209549071618
740,12,3,15,49.333333333333336,246.66666666666666,3700,61.666666666666664,3000000000,48.64864864864865
276,5,4,9,30.666666666666668,69,1380,23,4000000000,173.91304347826087
1127,10,3,13,86.6923076923077,375.6666666666667,5635,93.91666666666667,3000000000,31.943212067435667
784,14,3,17,46.11764705882353,261.3333333333333,3920,65.33333333333333,3000000000,45.91836734693878
731,11,3,14,52.214285714285715,243.66666666666666,3655,60.916666666666664,3000000000,49.24760601915185
589,13,3,16,36.8125,196.33333333333334,2945,49.083333333333336,3000000000,61.120543293718164
590,8,7,15,39.333333333333336,84.28571428571429,2950,49.166666666666664,7000000000,142.3728813559322
1260,27,3,30,42,420,6300,105,3000000000,28.57142857142857
166,4,3,7,23.714285714285715,55.333333333333336,830,13.833333333333334,3000000000,216.86746987951807
766,14,3,17,45.05882352941177,255.33333333333334,3830,63.833333333333336,3000000000,46.99738903394256
775,17,3,20,38.75,258.3333333333333,3875,64.58333333333333,3000000000,46.45161290322581
279,6,5,11,25.363636363636363,55.8,1395,23.25,5000000000,215.05376344086022
271,5,3,8,33.875,90.33333333333333,1355,22.583333333333332,3000000000,132.84132841328415
712,9,5,14,50.857142857142854,142.4,3560,59.333333333333336,5000000000,84.26966292134831
1027,15,3,18,57.05555555555556,342.3333333333333,5135,85.58333333333333,3000000000,35.05355404089581
429,7,5,12,35.75,85.8,2145,35.75,5000000000,139.86013986013984
967,15,3,18,53.72222222222222,322.3333333333333,4835,80.58333333333333,3000000000,37.22854188210962
363,5,3,8,45.375,121,1815,30.25,3000000000,99.17355371900827
408,6,4,10,40.8,102,2040,34,4000000000,117.6470588235294
528,11,3,14,37.714285714285715,176,2640,44,3000000000,68.18181818181819
648,8,3,11,58.90909090909091,216,3240,54,3000000000,55.55555555555555
407,7,3,10,40.7,135.66666666666666,2035,33.916666666666664,3000000000,88.45208845208846
302,6,3,9,33.55555555555556,100.66666666666667,1510,25.166666666666668,3000000000,119.20529801324503
534,9,4,13,41.07692307692308,133.5,2670,44.5,4000000000,89.8876404494382
721,6,6,12,60.083333333333336,120.16666666666667,3605,60.083333333333336,6000000000,99.86130374479889
422,4,3,7,60.285714285714285,140.66666666666666,2110,35.166666666666664,3000000000,85.30805687203792
459,7,3,10,45.9,153,2295,38.25,3000000000,78.4313725490196
1088,12,8,20,54.4,136,5440,90.66666666666667,8000000000,88.23529411764706
593,9,7,16,37.0625,84.71428571428571,2965,49.416666666666664,7000000000,141.65261382799326
669,10,3,13,51.46153846153846,223,3345,55.75,3000000000,53.81165919282511
418,3,4,7,59.714285714285715,104.5,2090,34.833333333333336,4000000000,114.83253588516745
369,4,3,7,52.714285714285715,123,1845,30.75,3000000000,97.5609756097561
463,6,3,9,51.44444444444444,154.33333333333334,2315,38.583333333333336,3000000000,77.7537796976242
522,5,3,8,65.25,174,2610,43.5,3000000000,68.9655172413793
721,12,3,15,48.06666666666667,240.33333333333334,3605,60.083333333333336,3000000000,49.930651872399444
704,8,3,11,64,234.66666666666666,3520,58.666666666666664,3000000000,51.13636363636364
457,9,3,12,38.083333333333336,152.33333333333334,2285,38.083333333333336,3000000000,78.77461706783369
539,9,3,12,44.916666666666664,179.66666666666666,2695,44.916666666666664,3000000000,66.79035250463822
1335,16,10,26,51.34615384615385,133.5,6675,111.25,10000000000,89.8876404494382
583,6,3,9,64.77777777777777,194.33333333333334,2915,48.583333333333336,3000000000,61.74957118353345
406,4,3,7,58,135.33333333333334,2030,33.833333333333336,3000000000,88.66995073891624
347,4,4,8,43.375,86.75,1735,28.916666666666668,4000000000,138.32853025936598
932,10,3,13,71.6923076923077,310.6666666666667,4660,77.66666666666667,3000000000,38.62660944206009
535,10,4,14,38.214285714285715,133.75,2675,44.583333333333336,4000000000,89.7196261682243
818,13,8,21,38.95238095238095,102.25,4090,68.16666666666667,8000000000,117.35941320293398
349,5,3,8,43.625,116.33333333333333,1745,29.083333333333332,3000000000,103.1518624641834
1045,19,5,24,43.541666666666664,209,5225,87.08333333333333,5000000000,57.41626794258373
442,6,4,10,44.2,110.5,2210,36.833333333333336,4000000000,108.5972850678733
654,12,3,15,43.6,218,3270,54.5,3000000000,55.04587155963302
775,7,3,10,77.5,258.3333333333333,3875,64.58333333333333,3000000000,46.45161290322581
767,8,4,12,63.916666666666664,191.75,3835,63.916666666666664,4000000000,62.58148631029987
410,7,4,11,37.27272727272727,102.5,2050,34.166666666666664,4000000000,117.07317073170732
415,7,4,11,37.72727272727273,103.75,2075,34.583333333333336,4000000000,115.66265060240963
574,4,3,7,82,191.33333333333334,2870,47.833333333333336,3000000000,62.7177700348432
468,8,3,11,42.54545454545455,156,2340,39,3000000000,76.92307692307693
401,7,3,10,40.1,133.66666666666666,2005,33.416666666666664,3000000000,89.77556109725687
396,12,3,15,26.4,132,1980,33,3000000000,90.9090909090909
868,14,3,17,51.05882352941177,289.3333333333333,4340,72.33333333333333,3000000000,41.474654377880185
221,4,3,7,31.571428571428573,73.66666666666667,1105,18.416666666666668,3000000000,162.89592760180994
581,5,3,8,72.625,193.66666666666666,2905,48.416666666666664,3000000000,61.96213425129088
628,9,8,17,36.94117647058823,78.5,3140,52.333333333333336,8000000000,152.86624203821657
570,7,3,10,57,190,2850,47.5,3000000000,63.1578947368421
800,14,4,18,44.44444444444444,200,4000,66.66666666666667,4000000000,59.99999999999999
340,11,3,14,24.285714285714285,113.33333333333333,1700,28.333333333333332,3000000000,105.88235294117648
416,5,5,10,41.6,83.2,2080,34.666666666666664,5000000000,144.23076923076925
673,14,3,17,39.588235294117645,224.33333333333334,3365,56.083333333333336,3000000000,53.49182763744428
825,13,3,16,51.5625,275,4125,68.75,3000000000,43.63636363636363
413,4,3,7,59,137.66666666666666,2065,34.416666666666664,3000000000,87.16707021791768
668,7,4,11,60.72727272727273,167,3340,55.666666666666664,4000000000,71.8562874251497
636,7,4,11,57.81818181818182,159,3180,53,4000000000,75.47169811320755
802,16,3,19,42.21052631578947,267.3333333333333,4010,66.83333333333333,3000000000,44.887780548628434
766,12,3,15,51.06666666666667,255.33333333333334,3830,63.833333333333336,3000000000,46.99738903394256
903,20,5,25,36.12,180.6,4515,75.25,5000000000,66.44518272425249
393,9,3,12,32.75,131,1965,32.75,3000000000,91.6030534351145
818,8,3,11,74.36363636363636,272.6666666666667,4090,68.16666666666667,3000000000,44.00977995110024
395,7,4,11,35.90909090909091,98.75,1975,32.916666666666664,4000000000,121.51898734177216
617,15,3,18,34.27777777777778,205.66666666666666,3085,51.416666666666664,3000000000,58.346839546191255
903,17,3,20,45.15,301,4515,75.25,3000000000,39.8671096345515
1019,19,6,25,40.76,169.83333333333334,5095,84.91666666666667,6000000000,70.65750736015701
383,8,3,11,34.81818181818182,127.66666666666667,1915,31.916666666666668,3000000000,93.99477806788512
421,12,6,18,23.38888888888889,70.16666666666667,2105,35.083333333333336,6000000000,171.021377672209
748,15,3,18,41.55555555555556,249.33333333333334,3740,62.333333333333336,3000000000,48.1283422459893
421,6,3,9,46.77777777777778,140.33333333333334,2105,35.083333333333336,3000000000,85.5106888361045
620,5,7,12,51.666666666666664,88.57142857142857,3100,51.666666666666664,7000000000,135.48387096774195
502,6,3,9,55.77777777777778,167.33333333333334,2510,41.833333333333336,3000000000,71.71314741035856
475,8,3,11,43.18181818181818,158.33333333333334,2375,39.583333333333336,3000000000,75.78947368421052
525,12,3,15,35,175,2625,43.75,3000000000,68.57142857142857
382,10,3,13,29.384615384615383,127.33333333333333,1910,31.833333333333332,3000000000,94.24083769633508
223,4,3,7,31.857142857142858,74.33333333333333,1115,18.583333333333332,3000000000,161.43497757847535
585,8,4,12,48.75,146.25,2925,48.75,4000000000,82.05128205128204
225,7,3,10,22.5,75,1125,18.75,3000000000,160
350,5,6,11,31.818181818181817,58.333333333333336,1750,29.166666666666668,6000000000,205.7142857142857
661,10,3,13,50.84615384615385,220.33333333333334,3305,55.083333333333336,3000000000,54.462934947049924
748,16,6,22,34,124.66666666666667,3740,62.333333333333336,6000000000,96.2566844919786
1208,8,10,18,67.11111111111111,120.8,6040,100.66666666666667,10000000000,99.33774834437085
475,7,5,12,39.583333333333336,95,2375,39.583333333333336,5000000000,126.3157894736842
845,10,10,20,42.25,84.5,4225,70.41666666666667,10000000000,142.0118343195266
1026,10,3,13,78.92307692307692,342,5130,85.5,3000000000,35.08771929824562
416,9,3,12,34.666666666666664,138.66666666666666,2080,34.666666666666664,3000000000,86.53846153846155
1145,18,3,21,54.523809523809526,381.6666666666667,5725,95.41666666666667,3000000000,31.441048034934493
605,10,4,14,43.214285714285715,151.25,3025,50.416666666666664,4000000000,79.33884297520662
846,25,3,28,30.214285714285715,282,4230,70.5,3000000000,42.5531914893617
378,5,3,8,47.25,126,1890,31.5,3000000000,95.23809523809524
442,8,3,11,40.18181818181818,147.33333333333334,2210,36.833333333333336,3000000000,81.44796380090497
637,6,6,12,53.083333333333336,106.16666666666667,3185,53.083333333333336,6000000000,113.0298273155416
189,4,3,7,27,63,945,15.75,3000000000,190.47619047619048
655,11,4,15,43.666666666666664,163.75,3275,54.583333333333336,4000000000,73.2824427480916
607,14,3,17,35.705882352941174,202.33333333333334,3035,50.583333333333336,3000000000,59.308072487644154
1045,16,3,19,55,348.3333333333333,5225,87.08333333333333,3000000000,34.44976076555024
656,9,3,12,54.666666666666664,218.66666666666666,3280,54.666666666666664,3000000000,54.8780487804878
790,12,4,16,49.375,197.5,3950,65.83333333333333,4000000000,60.75949367088608
763,12,4,16,47.6875,190.75,3815,63.583333333333336,4000000000,62.90956749672346
505,6,3,9,56.111111111111114,168.33333333333334,2525,42.083333333333336,3000000000,71.28712871287128
645,9,3,12,53.75,215,3225,53.75,3000000000,55.81395348837209
807,12,3,15,53.8,269,4035,67.25,3000000000,44.60966542750929
1012,12,3,15,67.46666666666667,337.3333333333333,5060,84.33333333333333,3000000000,35.57312252964427
655,10,3,13,50.38461538461539,218.33333333333334,3275,54.583333333333336,3000000000,54.9618320610687
1211,17,3,20,60.55,403.6666666666667,6055,100.91666666666667,3000000000,29.72749793559042
368,7,4,11,33.45454545454545,92,1840,30.666666666666668,4000000000,130.43478260869563
518,7,8,15,34.53333333333333,64.75,2590,43.166666666666664,8000000000,185.32818532818536
372,4,3,7,53.142857142857146,124,1860,31,3000000000,96.77419354838709
371,12,3,15,24.733333333333334,123.66666666666667,1855,30.916666666666668,3000000000,97.03504043126685
883,12,3,15,58.86666666666667,294.3333333333333,4415,73.58333333333333,3000000000,40.770101925254814
663,8,7,15,44.2,94.71428571428571,3315,55.25,7000000000,126.69683257918551
397,9,3,12,33.083333333333336,132.33333333333334,1985,33.083333333333336,3000000000,90.6801007556675
184,3,4,7,26.285714285714285,46,920,15.333333333333334,4000000000,260.86956521739125
534,6,6,12,44.5,89,2670,44.5,6000000000,134.83146067415728
392,8,5,13,30.153846153846153,78.4,1960,32.666666666666664,5000000000,153.06122448979593
710,12,3,15,47.333333333333336,236.66666666666666,3550,59.166666666666664,3000000000,50.70422535211268
477,5,3,8,59.625,159,2385,39.75,3000000000,75.47169811320755
672,12,7,19,35.36842105263158,96,3360,56,7000000000,125
505,7,3,10,50.5,168.33333333333334,2525,42.083333333333336,3000000000,71.28712871287128
534,10,3,13,41.07692307692308,178,2670,44.5,3000000000,67.41573033707864
568,11,7,18,31.555555555555557,81.14285714285714,2840,47.333333333333336,7000000000,147.88732394366195
966,19,3,22,43.90909090909091,322,4830,80.5,3000000000,37.267080745341616
336,8,3,11,30.545454545454547,112,1680,28,3000000000,107.14285714285715
843,18,3,21,40.142857142857146,281,4215,70.25,3000000000,42.704626334519574
441,5,3,8,55.125,147,2205,36.75,3000000000,81.63265306122449
634,4,5,9,70.44444444444444,126.8,3170,52.833333333333336,5000000000,94.6372239747634
679,8,7,15,45.266666666666666,97,3395,56.583333333333336,7000000000,123.71134020618557
748,9,6,15,49.86666666666667,124.66666666666667,3740,62.333333333333336,6000000000,96.2566844919786
722,12,5,17,42.470588235294116,144.4,3610,60.166666666666664,5000000000,83.10249307479225
470,7,6,13,36.15384615384615,78.33333333333333,2350,39.166666666666664,6000000000,153.19148936170214
817,5,11,16,51.0625,74.27272727272727,4085,68.08333333333333,11000000000,161.56670746634026
603,8,3,11,54.81818181818182,201,3015,50.25,3000000000,59.701492537313435
527,7,3,10,52.7,175.66666666666666,2635,43.916666666666664,3000000000,68.3111954459203
517,11,6,17,30.41176470588235,86.16666666666667,2585,43.083333333333336,6000000000,139.26499032882012
706,13,4,17,41.529411764705884,176.5,3530,58.833333333333336,4000000000,67.98866855524079
296,6,3,9,32.888888888888886,98.66666666666667,1480,24.666666666666668,3000000000,121.62162162162161
755,15,3,18,41.94444444444444,251.66666666666666,3775,62.916666666666664,3000000000,47.682119205298015
1176,13,3,16,73.5,392,5880,98,3000000000,30.612244897959183
569,5,3,8,71.125,189.66666666666666,2845,47.416666666666664,3000000000,63.26889279437611
702,11,3,14,50.142857142857146,234,3510,58.5,3000000000,51.28205128205128
565,10,3,13,43.46153846153846,188.33333333333334,2825,47.083333333333336,3000000000,63.716814159292035
277,5,3,8,34.625,92.33333333333333,1385,23.083333333333332,3000000000,129.9638989169675
852,13,6,19,44.8421052631579,142,4260,71,6000000000,84.50704225352113
596,9,3,12,49.666666666666664,198.66666666666666,2980,49.666666666666664,3000000000,60.4026845637584
268,3,5,8,33.5,53.6,1340,22.333333333333332,5000000000,223.8805970149254
982,13,3,16,61.375,327.3333333333333,4910,81.83333333333333,3000000000,36.65987780040734
448,11,3,14,32,149.33333333333334,2240,37.333333333333336,3000000000,80.35714285714285
677,15,3,18,37.611111111111114,225.66666666666666,3385,56.416666666666664,3000000000,53.17577548005909
458,5,5,10,45.8,91.6,2290,38.166666666666664,5000000000,131.0043668122271
639,14,3,17,37.588235294117645,213,3195,53.25,3000000000,56.33802816901408
417,6,6,12,34.75,69.5,2085,34.75,6000000000,172.6618705035971
833,10,3,13,64.07692307692308,277.6666666666667,4165,69.41666666666667,3000000000,43.2172869147659
1408,15,15,30,46.93333333333333,93.86666666666666,7040,117.33333333333333,15000000000,127.8409090909091
446,10,3,13,34.30769230769231,148.66666666666666,2230,37.166666666666664,3000000000,80.71748878923768
447,7,3,10,44.7,149,2235,37.25,3000000000,80.53691275167786
231,7,3,10,23.1,77,1155,19.25,3000000000,155.84415584415584
922,10,3,13,70.92307692307692,307.3333333333333,4610,76.83333333333333,3000000000,39.04555314533623
845,6,4,10,84.5,211.25,4225,70.41666666666667,4000000000,56.80473372781064
1041,12,9,21,49.57142857142857,115.66666666666667,5205,86.75,9000000000,103.7463976945245
445,5,3,8,55.625,148.33333333333334,2225,37.083333333333336,3000000000,80.89887640449437
1464,16,9,25,58.56,162.66666666666666,7320,122,9000000000,73.77049180327869
902,9,9,18,50.111111111111114,100.22222222222223,4510,75.16666666666667,9000000000,119.73392461197339
754,10,3,13,58,251.33333333333334,3770,62.833333333333336,3000000000,47.745358090185675
877,11,4,15,58.46666666666667,219.25,4385,73.08333333333333,4000000000,54.73204104903079
447,4,3,7,63.857142857142854,149,2235,37.25,3000000000,80.53691275167786
711,12,9,21,33.857142857142854,79,3555,59.25,9000000000,151.89873417721518
158,4,3,7,22.571428571428573,52.666666666666664,790,13.166666666666666,3000000000,227.8481012658228
540,9,3,12,45,180,2700,45,3000000000,66.66666666666666
658,12,10,22,29.90909090909091,65.8,3290,54.833333333333336,10000000000,182.370820668693
822,12,5,17,48.35294117647059,164.4,4110,68.5,5000000000,72.99270072992701
785,8,7,15,52.333333333333336,112.14285714285714,3925,65.41666666666667,7000000000,107.00636942675159
477,9,5,14,34.07142857142857,95.4,2385,39.75,5000000000,125.78616352201257
449,4,5,9,49.888888888888886,89.8,2245,37.416666666666664,5000000000,133.630289532294
301,3,3,6,50.166666666666664,100.33333333333333,1505,25.083333333333332,3000000000,119.60132890365449
723,11,3,14,51.642857142857146,241,3615,60.25,3000000000,49.79253112033195
630,6,3,9,70,210,3150,52.5,3000000000,57.14285714285714
443,7,6,13,34.07692307692308,73.83333333333333,2215,36.916666666666664,6000000000,162.52821670428895
648,11,3,14,46.285714285714285,216,3240,54,3000000000,55.55555555555555
1509,21,3,24,62.875,503,7545,125.75,3000000000,23.856858846918488
493,6,4,10,49.3,123.25,2465,41.083333333333336,4000000000,97.3630831643002
643,11,3,14,45.92857142857143,214.33333333333334,3215,53.583333333333336,3000000000,55.987558320373246
681,11,3,14,48.642857142857146,227,3405,56.75,3000000000,52.86343612334802
912,11,4,15,60.8,228,4560,76,4000000000,52.63157894736842
317,8,3,11,28.818181818181817,105.66666666666667,1585,26.416666666666668,3000000000,113.56466876971608
554,9,3,12,46.166666666666664,184.66666666666666,2770,46.166666666666664,3000000000,64.98194945848375
544,12,4,16,34,136,2720,45.333333333333336,4000000000,88.23529411764706
348,5,3,8,43.5,116,1740,29,3000000000,103.44827586206897
1101,17,3,20,55.05,367,5505,91.75,3000000000,32.69754768392371
685,11,3,14,48.92857142857143,228.33333333333334,3425,57.083333333333336,3000000000,52.55474452554744
836,7,12,19,44,69.66666666666667,4180,69.66666666666667,12000000000,172.2488038277512
356,5,4,9,39.55555555555556,89,1780,29.666666666666668,4000000000,134.83146067415728
644,15,3,18,35.77777777777778,214.66666666666666,3220,53.666666666666664,3000000000,55.90062111801243
887,13,6,19,46.68421052631579,147.83333333333334,4435,73.91666666666667,6000000000,81.17249154453212
330,3,3,6,55,110,1650,27.5,3000000000,109.0909090909091
721,11,3,14,51.5,240.33333333333334,3605,60.083333333333336,3000000000,49.930651872399444
441,6,6,12,36.75,73.5,2205,36.75,6000000000,163.26530612244898
1206,15,3,18,67,402,6030,100.5,3000000000,29.850746268656717
261,3,3,6,43.5,87,1305,21.75,3000000000,137.9310344827586
522,11,6,17,30.705882352941178,87,2610,43.5,6000000000,137.9310344827586
432,6,4,10,43.2,108,2160,36,4000000000,111.1111111111111
799,9,3,12,66.58333333333333,266.3333333333333,3995,66.58333333333333,3000000000,45.056320400500624
704,16,3,19,37.05263157894737,234.66666666666666,3520,58.666666666666664,3000000000,51.13636363636364
547,9,4,13,42.07692307692308,136.75,2735,45.583333333333336,4000000000,87.75137111517367
1025,13,3,16,64.0625,341.6666666666667,5125,85.41666666666667,3000000000,35.1219512195122
941,14,3,17,55.35294117647059,313.6666666666667,4705,78.41666666666667,3000000000,38.25717321997874
575,7,4,11,52.27272727272727,143.75,2875,47.916666666666664,4000000000,83.47826086956522
1325,19,10,29,45.689655172413794,132.5,6625,110.41666666666667,10000000000,90.56603773584905
990,10,3,13,76.15384615384616,330,4950,82.5,3000000000,36.36363636363637
735,6,8,14,52.5,91.875,3675,61.25,8000000000,130.6122448979592
309,4,4,8,38.625,77.25,1545,25.75,4000000000,155.33980582524273
407,7,3,10,40.7,135.66666666666666,2035,33.916666666666664,3000000000,88.45208845208846
521,8,5,13,40.07692307692308,104.2,2605,43.416666666666664,5000000000,115.16314779270634
441,4,3,7,63,147,2205,36.75,3000000000,81.63265306122449
627,7,7,14,44.785714285714285,89.57142857142857,3135,52.25,7000000000,133.9712918660287
252,5,5,10,25.2,50.4,1260,21,5000000000,238.0952380952381
557,4,3,7,79.57142857142857,185.66666666666666,2785,46.416666666666664,3000000000,64.63195691202873
860,18,3,21,40.95238095238095,286.6666666666667,4300,71.66666666666667,3000000000,41.860465116279066
373,9,3,12,31.083333333333332,124.33333333333333,1865,31.083333333333332,3000000000,96.514745308311
869,9,4,13,66.84615384615384,217.25,4345,72.41666666666667,4000000000,55.235903337169155
1396,16,6,22,63.45454545454545,232.66666666666666,6980,116.33333333333333,6000000000,51.5759312320917
453,5,3,8,56.625,151,2265,37.75,3000000000,79.47019867549669
807,9,7,16,50.4375,115.28571428571429,4035,67.25,7000000000,104.08921933085502
1515,29,8,37,40.945945945945944,189.375,7575,126.25,8000000000,63.366336633663366
215,4,3,7,30.714285714285715,71.66666666666667,1075,17.916666666666668,3000000000,167.44186046511626
330,8,3,11,30,110,1650,27.5,3000000000,109.0909090909091
388,7,4,11,35.27272727272727,97,1940,32.333333333333336,4000000000,123.71134020618557
580,13,5,18,32.22222222222222,116,2900,48.333333333333336,5000000000,103.44827586206897
526,4,3,7,75.14285714285714,175.33333333333334,2630,43.833333333333336,3000000000,68.44106463878326
329,4,4,8,41.125,82.25,1645,27.416666666666668,4000000000,145.8966565349544
564,12,3,15,37.6,188,2820,47,3000000000,63.829787234042556
376,9,3,12,31.333333333333332,125.33333333333333,1880,31.333333333333332,3000000000,95.74468085106383
324,7,4,11,29.454545454545453,81,1620,27,4000000000,148.14814814814815
497,11,3,14,35.5,165.66666666666666,2485,41.416666666666664,3000000000,72.43460764587526
622,11,3,14,44.42857142857143,207.33333333333334,3110,51.833333333333336,3000000000,57.877813504823145
306,6,3,9,34,102,1530,25.5,3000000000,117.6470588235294
618,8,3,11,56.18181818181818,206,3090,51.5,3000000000,58.25242718446602
363,9,3,12,30.25,121,1815,30.25,3000000000,99.17355371900827
661,7,3,10,66.1,220.33333333333334,3305,55.083333333333336,3000000000,54.462934947049924
424,5,4,9,47.111111111111114,106,2120,35.333333333333336,4000000000,113.2075471698113
554,8,7,15,36.93333333333333,79.14285714285714,2770,46.166666666666664,7000000000,151.62454873646212
333,5,5,10,33.3,66.6,1665,27.75,5000000000,180.1801801801802
501,9,3,12,41.75,167,2505,41.75,3000000000,71.85628742514969
965,17,3,20,48.25,321.6666666666667,4825,80.41666666666667,3000000000,37.30569948186528
690,13,3,16,43.125,230,3450,57.5,3000000000,52.17391304347826
1280,15,8,23,55.65217391304348,160,6400,106.66666666666667,8000000000,75
661,15,3,18,36.72222222222222,220.33333333333334,3305,55.083333333333336,3000000000,54.462934947049924
487,5,4,9,54.111111111111114,121.75,2435,40.583333333333336,4000000000,98.56262833675565
1381,17,6,23,60.04347826086956,230.16666666666666,6905,115.08333333333333,6000000000,52.13613323678494
616,14,3,17,36.23529411764706,205.33333333333334,3080,51.333333333333336,3000000000,58.441558441558435
777,13,3,16,48.5625,259,3885,64.75,3000000000,46.33204633204633
523,7,4,11,47.54545454545455,130.75,2615,43.583333333333336,4000000000,91.77820267686424
693,8,3,11,63,231,3465,57.75,3000000000,51.94805194805195
398,6,4,10,39.8,99.5,1990,33.166666666666664,4000000000,120.6030150753769
377,9,3,12,31.416666666666668,125.66666666666667,1885,31.416666666666668,3000000000,95.49071618037135
583,3,5,8,72.875,116.6,2915,48.583333333333336,5000000000,102.91595197255575
663,7,7,14,47.357142857142854,94.71428571428571,3315,55.25,7000000000,126.69683257918551
588,15,4,19,30.94736842105263,147,2940,49,4000000000,81.63265306122449
457,7,3,10,45.7,152.33333333333334,2285,38.083333333333336,3000000000,78.77461706783369
282,7,3,10,28.2,94,1410,23.5,3000000000,127.65957446808511
559,5,4,9,62.111111111111114,139.75,2795,46.583333333333336,4000000000,85.86762075134168
858,14,3,17,50.470588235294116,286,4290,71.5,3000000000,41.95804195804196
1017,20,8,28,36.32142857142857,127.125,5085,84.75,8000000000,94.3952802359882
718,4,3,7,102.57142857142857,239.33333333333334,3590,59.833333333333336,3000000000,50.139275766016716
223,4,4,8,27.875,55.75,1115,18.583333333333332,4000000000,215.24663677130047
592,8,4,12,49.333333333333336,148,2960,49.333333333333336,4000000000,81.08108108108108
544,11,3,14,38.857142857142854,181.33333333333334,2720,45.333333333333336,3000000000,66.17647058823529
634,5,6,11,57.63636363636363,105.66666666666667,3170,52.833333333333336,6000000000,113.56466876971608
887,10,3,13,68.23076923076923,295.6666666666667,4435,73.91666666666667,3000000000,40.58624577226606
701,10,3,13,53.92307692307692,233.66666666666666,3505,58.416666666666664,3000000000,51.35520684736092
515,11,4,15,34.333333333333336,128.75,2575,42.916666666666664,4000000000,93.20388349514563
540,7,3,10,54,180,2700,45,3000000000,66.66666666666666
1190,20,3,23,51.73913043478261,396.6666666666667,5950,99.16666666666667,3000000000,30.252100840336134
601,6,3,9,66.77777777777777,200.33333333333334,3005,50.083333333333336,3000000000,59.90016638935108
463,6,3,9,51.44444444444444,154.33333333333334,2315,38.583333333333336,3000000000,77.7537796976242
721,12,10,22,32.77272727272727,72.1,3605,60.083333333333336,10000000000,166.4355062413315
682,11,3,14,48.714285714285715,227.33333333333334,3410,56.833333333333336,3000000000,52.785923753665685
361,5,3,8,45.125,120.33333333333333,1805,30.083333333333332,3000000000,99.7229916897507
530,7,3,10,53,176.66666666666666,2650,44.166666666666664,3000000000,67.9245283018868
398,7,3,10,39.8,132.66666666666666,1990,33.166666666666664,3000000000,90.45226130653266
932,14,4,18,51.77777777777778,233,4660,77.66666666666667,4000000000,51.50214592274678
856,20,3,23,37.21739130434783,285.3333333333333,4280,71.33333333333333,3000000000,42.056074766355145
562,9,3,12,46.833333333333336,187.33333333333334,2810,46.833333333333336,3000000000,64.05693950177935
392,8,5,13,30.153846153846153,78.4,1960,32.666666666666664,5000000000,153.06122448979593
277,3,3,6,46.166666666666664,92.33333333333333,1385,23.083333333333332,3000000000,129.9638989169675
745,6,6,12,62.083333333333336,124.16666666666667,3725,62.083333333333336,6000000000,96.64429530201342
672,14,3,17,39.529411764705884,224,3360,56,3000000000,53.57142857142858
813,7,4,11,73.9090909090909,203.25,4065,67.75,4000000000,59.04059040590406
576,11,5,16,36,115.2,2880,48,5000000000,104.16666666666667
432,7,3,10,43.2,144,2160,36,3000000000,83.33333333333333
315,3,3,6,52.5,105,1575,26.25,3000000000,114.28571428571428
671,6,3,9,74.55555555555556,223.66666666666666,3355,55.916666666666664,3000000000,53.65126676602087
504,11,3,14,36,168,2520,42,3000000000,71.42857142857143
685,9,3,12,57.083333333333336,228.33333333333334,3425,57.083333333333336,3000000000,52.55474452554744
259,5,3,8,32.375,86.33333333333333,1295,21.583333333333332,3000000000,138.996138996139
313,10,3,13,24.076923076923077,104.33333333333333,1565,26.083333333333332,3000000000,115.01597444089457
767,15,5,20,38.35,153.4,3835,63.916666666666664,5000000000,78.22685788787484
868,20,7,27,32.148148148148145,124,4340,72.33333333333333,7000000000,96.7741935483871
636,12,4,16,39.75,159,3180,53,4000000000,75.47169811320755
284,5,3,8,35.5,94.66666666666667,1420,23.666666666666668,3000000000,126.76056338028168
154,3,3,6,25.666666666666668,51.333333333333336,770,12.833333333333334,3000000000,233.76623376623374
322,3,3,6,53.666666666666664,107.33333333333333,1610,26.833333333333332,3000000000,111.80124223602486
297,6,3,9,33,99,1485,24.75,3000000000,121.21212121212122
545,18,3,21,25.952380952380953,181.66666666666666,2725,45.416666666666664,3000000000,66.05504587155963
354,13,3,16,22.125,118,1770,29.5,3000000000,101.69491525423729
835,13,6,19,43.94736842105263,139.16666666666666,4175,69.58333333333333,6000000000,86.22754491017965
363,5,3,8,45.375,121,1815,30.25,3000000000,99.17355371900827
711,3,7,10,71.1,101.57142857142857,3555,59.25,7000000000,118.14345991561181
678,5,3,8,84.75,226,3390,56.5,3000000000,53.097345132743364
421,15,3,18,23.38888888888889,140.33333333333334,2105,35.083333333333336,3000000000,85.5106888361045
575,15,3,18,31.944444444444443,191.66666666666666,2875,47.916666666666664,3000000000,62.608695652173914
303,4,3,7,43.285714285714285,101,1515,25.25,3000000000,118.81188118811882
919,6,4,10,91.9,229.75,4595,76.58333333333333,4000000000,52.23068552774755
241,7,3,10,24.1,80.33333333333333,1205,20.083333333333332,3000000000,149.37759336099586
763,7,3,10,76.3,254.33333333333334,3815,63.583333333333336,3000000000,47.18217562254259
871,11,3,14,62.214285714285715,290.3333333333333,4355,72.58333333333333,3000000000,41.33180252583238
768,19,3,22,34.90909090909091,256,3840,64,3000000000,46.875
336,11,3,14,24,112,1680,28,3000000000,107.14285714285715
546,8,7,15,36.4,78,2730,45.5,7000000000,153.84615384615387
679,8,4,12,56.583333333333336,169.75,3395,56.583333333333336,4000000000,70.6921944035346
524,5,5,10,52.4,104.8,2620,43.666666666666664,5000000000,114.50381679389312
798,15,5,20,39.9,159.6,3990,66.5,5000000000,75.18796992481204
182,5,3,8,22.75,60.666666666666664,910,15.166666666666666,3000000000,197.8021978021978
400,8,3,11,36.36363636363637,133.33333333333334,2000,33.333333333333336,3000000000,90
471,10,3,13,36.23076923076923,157,2355,39.25,3000000000,76.43312101910828
939,8,4,12,78.25,234.75,4695,78.25,4000000000,51.11821086261981
605,8,3,11,55,201.66666666666666,3025,50.416666666666664,3000000000,59.50413223140496
611,12,3,15,40.733333333333334,203.66666666666666,3055,50.916666666666664,3000000000,58.91980360065467
650,8,3,11,59.09090909090909,216.66666666666666,3250,54.166666666666664,3000000000,55.38461538461539
615,15,3,18,34.166666666666664,205,3075,51.25,3000000000,58.53658536585366
831,9,3,12,69.25,277,4155,69.25,3000000000,43.321299638989174
312,5,5,10,31.2,62.4,1560,26,5000000000,192.30769230769232
505,6,3,9,56.111111111111114,168.33333333333334,2525,42.083333333333336,3000000000,71.28712871287128
202,6,3,9,22.444444444444443,67.33333333333333,1010,16.833333333333332,3000000000,178.21782178217822
524,7,6,13,40.30769230769231,87.33333333333333,2620,43.666666666666664,6000000000,137.40458015267174
394,5,3,8,49.25,131.33333333333334,1970,32.833333333333336,3000000000,91.3705583756345
748,9,3,12,62.333333333333336,249.33333333333334,3740,62.333333333333336,3000000000,48.1283422459893
696,12,6,18,38.666666666666664,116,3480,58,6000000000,103.44827586206897
734,7,3,10,73.4,244.66666666666666,3670,61.166666666666664,3000000000,49.04632152588556
736,10,4,14,52.57142857142857,184,3680,61.333333333333336,4000000000,65.21739130434781
656,13,6,19,34.526315789473685,109.33333333333333,3280,54.666666666666664,6000000000,109.7560975609756
863,14,10,24,35.958333333333336,86.3,4315,71.91666666666667,10000000000,139.04982618771726
408,8,3,11,37.09090909090909,136,2040,34,3000000000,88.23529411764706
212,3,3,6,35.333333333333336,70.66666666666667,1060,17.666666666666668,3000000000,169.81132075471697
73,4,3,7,10.428571428571429,24.333333333333332,365,6.083333333333333,3000000000,493.1506849315069
530,13,3,16,33.125,176.66666666666666,2650,44.166666666666664,3000000000,67.9245283018868
878,14,3,17,51.64705882352941,292.6666666666667,4390,73.16666666666667,3000000000,41.00227790432802
627,5,5,10,62.7,125.4,3135,52.25,5000000000,95.69377990430621
457,7,3,10,45.7,152.33333333333334,2285,38.083333333333336,3000000000,78.77461706783369
537,10,4,14,38.357142857142854,134.25,2685,44.75,4000000000,89.38547486033521
296,4,3,7,42.285714285714285,98.66666666666667,1480,24.666666666666668,3000000000,121.62162162162161
1175,15,8,23,51.08695652173913,146.875,5875,97.91666666666667,8000000000,81.70212765957446
413,4,5,9,45.888888888888886,82.6,2065,34.416666666666664,5000000000,145.27845036319613
866,18,3,21,41.23809523809524,288.6666666666667,4330,72.16666666666667,3000000000,41.57043879907621
638,8,6,14,45.57142857142857,106.33333333333333,3190,53.166666666666664,6000000000,112.85266457680251
685,13,3,16,42.8125,228.33333333333334,3425,57.083333333333336,3000000000,52.55474452554744
578,8,3,11,52.54545454545455,192.66666666666666,2890,48.166666666666664,3000000000,62.28373702422146
552,11,3,14,39.42857142857143,184,2760,46,3000000000,65.21739130434783
340,4,4,8,42.5,85,1700,28.333333333333332,4000000000,141.17647058823528
899,10,5,15,59.93333333333333,179.8,4495,74.91666666666667,5000000000,66.74082313681869
684,10,3,13,52.61538461538461,228,3420,57,3000000000,52.63157894736842
871,15,3,18,48.388888888888886,290.3333333333333,4355,72.58333333333333,3000000000,41.33180252583238
331,6,3,9,36.77777777777778,110.33333333333333,1655,27.583333333333332,3000000000,108.76132930513594
956,15,3,18,53.111111111111114,318.6666666666667,4780,79.66666666666667,3000000000,37.65690376569037
719,9,5,14,51.357142857142854,143.8,3595,59.916666666666664,5000000000,83.44923504867873
945,8,7,15,63,135,4725,78.75,7000000000,88.8888888888889
625,8,6,14,44.642857142857146,104.16666666666667,3125,52.083333333333336,6000000000,115.2
1311,15,3,18,72.83333333333333,437,6555,109.25,3000000000,27.45995423340961
372,7,3,10,37.2,124,1860,31,3000000000,96.77419354838709
248,5,3,8,31,82.66666666666667,1240,20.666666666666668,3000000000,145.16129032258064
357,6,5,11,32.45454545454545,71.4,1785,29.75,5000000000,168.0672268907563
435,5,3,8,54.375,145,2175,36.25,3000000000,82.75862068965517
535,8,6,14,38.214285714285715,89.16666666666667,2675,44.583333333333336,6000000000,134.57943925233644
303,3,3,6,50.5,101,1515,25.25,3000000000,118.81188118811882
359,5,3,8,44.875,119.66666666666667,1795,29.916666666666668,3000000000,100.27855153203343
836,16,5,21,39.80952380952381,167.2,4180,69.66666666666667,5000000000,71.77033492822966
390,8,3,11,35.45454545454545,130,1950,32.5,3000000000,92.3076923076923
626,5,6,11,56.90909090909091,104.33333333333333,3130,52.166666666666664,6000000000,115.01597444089457
236,4,3,7,33.714285714285715,78.66666666666667,1180,19.666666666666668,3000000000,152.5423728813559
382,8,4,12,31.833333333333332,95.5,1910,31.833333333333332,4000000000,125.65445026178011
541,8,5,13,41.61538461538461,108.2,2705,45.083333333333336,5000000000,110.90573012939002
226,4,3,7,32.285714285714285,75.33333333333333,1130,18.833333333333332,3000000000,159.2920353982301
738,6,6,12,61.5,123,3690,61.5,6000000000,97.5609756097561
758,10,3,13,58.30769230769231,252.66666666666666,3790,63.166666666666664,3000000000,47.4934036939314
492,9,3,12,41,164,2460,41,3000000000,73.17073170731707
266,5,3,8,33.25,88.66666666666667,1330,22.166666666666668,3000000000,135.33834586466165
400,7,4,11,36.36363636363637,100,2000,33.333333333333336,4000000000,119.99999999999999
1173,16,9,25,46.92,130.33333333333334,5865,97.75,9000000000,92.07161125319692
1078,13,5,18,59.888888888888886,215.6,5390,89.83333333333333,5000000000,55.65862708719852
1322,28,3,31,42.645161290322584,440.6666666666667,6610,110.16666666666667,3000000000,27.231467473524962
500,9,4,13,38.46153846153846,125,2500,41.666666666666664,4000000000,96
614,11,3,14,43.857142857142854,204.66666666666666,3070,51.166666666666664,3000000000,58.63192182410423
270,7,3,10,27,90,1350,22.5,3000000000,133.33333333333331
223,3,3,6,37.166666666666664,74.33333333333333,1115,18.583333333333332,3000000000,161.43497757847535
415,5,3,8,51.875,138.33333333333334,2075,34.583333333333336,3000000000,86.74698795180721
956,17,3,20,47.8,318.6666666666667,4780,79.66666666666667,3000000000,37.65690376569037
438,4,4,8,54.75,109.5,2190,36.5,4000000000,109.58904109589042
500,9,3,12,41.666666666666664,166.66666666666666,2500,41.666666666666664,3000000000,72
945,6,6,12,78.75,157.5,4725,78.75,6000000000,76.19047619047619
1100,19,3,22,50,366.6666666666667,5500,91.66666666666667,3000000000,32.72727272727273
264,8,3,11,24,88,1320,22,3000000000,136.36363636363637
525,11,3,14,37.5,175,2625,43.75,3000000000,68.57142857142857
713,21,4,25,28.52,178.25,3565,59.416666666666664,4000000000,67.3211781206171
518,11,6,17,30.470588235294116,86.33333333333333,2590,43.166666666666664,6000000000,138.996138996139
199,5,3,8,24.875,66.33333333333333,995,16.583333333333332,3000000000,180.90452261306532
459,8,3,11,41.72727272727273,153,2295,38.25,3000000000,78.4313725490196
699,6,4,10,69.9,174.75,3495,58.25,4000000000,68.6695278969957
798,15,6,21,38,133,3990,66.5,6000000000,90.22556390977444
755,7,3,10,75.5,251.66666666666666,3775,62.916666666666664,3000000000,47.682119205298015
740,9,5,14,52.857142857142854,148,3700,61.666666666666664,5000000000,81.08108108108108
959,17,8,25,38.36,119.875,4795,79.91666666666667,8000000000,100.10427528675703
719,10,7,17,42.294117647058826,102.71428571428571,3595,59.916666666666664,7000000000,116.8289290681502
621,7,4,11,56.45454545454545,155.25,3105,51.75,4000000000,77.29468599033817
635,9,3,12,52.916666666666664,211.66666666666666,3175,52.916666666666664,3000000000,56.69291338582677
475,4,6,10,47.5,79.16666666666667,2375,39.583333333333336,6000000000,151.57894736842104
272,3,3,6,45.333333333333336,90.66666666666667,1360,22.666666666666668,3000000000,132.35294117647058
766,17,3,20,38.3,255.33333333333334,3830,63.833333333333336,3000000000,46.99738903394256
816,8,6,14,58.285714285714285,136,4080,68,6000000000,88.23529411764706
186,3,3,6,31,62,930,15.5,3000000000,193.54838709677418
645,10,6,16,40.3125,107.5,3225,53.75,6000000000,111.62790697674419
530,13,3,16,33.125,176.66666666666666,2650,44.166666666666664,3000000000,67.9245283018868
697,8,3,11,63.36363636363637,232.33333333333334,3485,58.083333333333336,3000000000,51.649928263988514
629,10,4,14,44.92857142857143,157.25,3145,52.416666666666664,4000000000,76.31160572337043
762,18,3,21,36.285714285714285,254,3810,63.5,3000000000,47.24409448818898
609,10,3,13,46.84615384615385,203,3045,50.75,3000000000,59.11330049261083
483,6,4,10,48.3,120.75,2415,40.25,4000000000,99.37888198757764
623,15,3,18,34.611111111111114,207.66666666666666,3115,51.916666666666664,3000000000,57.784911717495994
1068,15,3,18,59.333333333333336,356,5340,89,3000000000,33.70786516853932
580,12,5,17,34.11764705882353,116,2900,48.333333333333336,5000000000,103.44827586206897
226,4,3,7,32.285714285714285,75.33333333333333,1130,18.833333333333332,3000000000,159.2920353982301
772,12,3,15,51.46666666666667,257.3333333333333,3860,64.33333333333333,3000000000,46.63212435233161
783,18,3,21,37.285714285714285,261,3915,65.25,3000000000,45.97701149425288
750,16,6,22,34.09090909090909,125,3750,62.5,6000000000,96
790,9,3,12,65.83333333333333,263.3333333333333,3950,65.83333333333333,3000000000,45.56962025316456
352,8,3,11,32,117.33333333333333,1760,29.333333333333332,3000000000,102.27272727272728
1073,15,9,24,44.708333333333336,119.22222222222223,5365,89.41666666666667,9000000000,100.65237651444546
816,11,5,16,51,163.2,4080,68,5000000000,73.52941176470588
592,6,5,11,53.81818181818182,118.4,2960,49.333333333333336,5000000000,101.35135135135135
567,7,3,10,56.7,189,2835,47.25,3000000000,63.492063492063494
552,7,3,10,55.2,184,2760,46,3000000000,65.21739130434783
938,13,5,18,52.111111111111114,187.6,4690,78.16666666666667,5000000000,63.96588486140724
908,15,5,20,45.4,181.6,4540,75.66666666666667,5000000000,66.07929515418502
396,8,3,11,36,132,1980,33,3000000000,90.9090909090909
756,11,3,14,54,252,3780,63,3000000000,47.61904761904762
328,9,3,12,27.333333333333332,109.33333333333333,1640,27.333333333333332,3000000000,109.7560975609756
1238,20,4,24,51.583333333333336,309.5,6190,103.16666666666667,4000000000,38.77221324717286
369,5,3,8,46.125,123,1845,30.75,3000000000,97.5609756097561
1003,12,3,15,66.86666666666666,334.3333333333333,5015,83.58333333333333,3000000000,35.89232303090728
369,9,5,14,26.357142857142858,73.8,1845,30.75,5000000000,162.60162601626018
445,7,3,10,44.5,148.33333333333334,2225,37.083333333333336,3000000000,80.89887640449437
833,11,4,15,55.53333333333333,208.25,4165,69.41666666666667,4000000000,57.62304921968787
1045,18,6,24,43.541666666666664,174.16666666666666,5225,87.08333333333333,6000000000,68.89952153110048
977,18,6,24,40.708333333333336,162.83333333333334,4885,81.41666666666667,6000000000,73.6949846468782
453,10,3,13,34.84615384615385,151,2265,37.75,3000000000,79.47019867549669
311,6,4,10,31.1,77.75,1555,25.916666666666668,4000000000,154.34083601286173
1004,17,8,25,40.16,125.5,5020,83.66666666666667,8000000000,95.61752988047809
674,7,3,10,67.4,224.66666666666666,3370,56.166666666666664,3000000000,53.41246290801187
564,10,4,14,40.285714285714285,141,2820,47,4000000000,85.1063829787234
913,19,3,22,41.5,304.3333333333333,4565,76.08333333333333,3000000000,39.430449069003295
1027,10,6,16,64.1875,171.16666666666666,5135,85.58333333333333,6000000000,70.10710808179162
621,19,7,26,23.884615384615383,88.71428571428571,3105,51.75,7000000000,135.2657004830918
676,6,3,9,75.11111111111111,225.33333333333334,3380,56.333333333333336,3000000000,53.25443786982248
388,3,3,6,64.66666666666667,129.33333333333334,1940,32.333333333333336,3000000000,92.78350515463917
659,7,3,10,65.9,219.66666666666666,3295,54.916666666666664,3000000000,54.628224582701066
530,12,3,15,35.333333333333336,176.66666666666666,2650,44.166666666666664,3000000000,67.9245283018868
418,10,3,13,32.15384615384615,139.33333333333334,2090,34.833333333333336,3000000000,86.1244019138756
444,8,3,11,40.36363636363637,148,2220,37,3000000000,81.08108108108108
356,6,4,10,35.6,89,1780,29.666666666666668,4000000000,134.83146067415728
363,5,3,8,45.375,121,1815,30.25,3000000000,99.17355371900827
788,12,6,18,43.77777777777778,131.33333333333334,3940,65.66666666666667,6000000000,91.3705583756345
976,21,3,24,40.666666666666664,325.3333333333333,4880,81.33333333333333,3000000000,36.88524590163935
382,11,3,14,27.285714285714285,127.33333333333333,1910,31.833333333333332,3000000000,94.24083769633508
1039,11,4,15,69.26666666666667,259.75,5195,86.58333333333333,4000000000,46.198267564966315
480,7,4,11,43.63636363636363,120,2400,40,4000000000,100
380,6,4,10,38,95,1900,31.666666666666668,4000000000,126.3157894736842
332,9,7,16,20.75,47.42857142857143,1660,27.666666666666668,7000000000,253.0120481927711
738,9,4,13,56.76923076923077,184.5,3690,61.5,4000000000,65.04065040650407
315,10,3,13,24.23076923076923,105,1575,26.25,3000000000,114.28571428571428
384,3,5,8,48,76.8,1920,32,5000000000,156.25
1186,16,12,28,42.357142857142854,98.83333333333333,5930,98.83333333333333,12000000000,121.41652613827995
444,6,3,9,49.333333333333336,148,2220,37,3000000000,81.08108108108108
463,14,3,17,27.235294117647058,154.33333333333334,2315,38.583333333333336,3000000000,77.7537796976242
576,10,7,17,33.88235294117647,82.28571428571429,2880,48,7000000000,145.83333333333334
608,9,3,12,50.666666666666664,202.66666666666666,3040,50.666666666666664,3000000000,59.21052631578947
255,5,4,9,28.333333333333332,63.75,1275,21.25,4000000000,188.23529411764704
522,10,5,15,34.8,104.4,2610,43.5,5000000000,114.94252873563218
639,14,3,17,37.588235294117645,213,3195,53.25,3000000000,56.33802816901408
649,11,3,14,46.357142857142854,216.33333333333334,3245,54.083333333333336,3000000000,55.46995377503852
946,12,3,15,63.06666666666667,315.3333333333333,4730,78.83333333333333,3000000000,38.05496828752643
711,5,10,15,47.4,71.1,3555,59.25,10000000000,168.77637130801688
210,3,3,6,35,70,1050,17.5,3000000000,171.42857142857144
823,9,6,15,54.86666666666667,137.16666666666666,4115,68.58333333333333,6000000000,87.48481166464155
677,9,3,12,56.416666666666664,225.66666666666666,3385,56.416666666666664,3000000000,53.17577548005909
676,8,5,13,52,135.2,3380,56.333333333333336,5000000000,88.75739644970415
514,10,6,16,32.125,85.66666666666667,2570,42.833333333333336,6000000000,140.07782101167317
686,12,6,18,38.111111111111114,114.33333333333333,3430,57.166666666666664,6000000000,104.95626822157435
553,15,5,20,27.65,110.6,2765,46.083333333333336,5000000000,108.49909584086798
624,12,3,15,41.6,208,3120,52,3000000000,57.69230769230769
883,13,4,17,51.94117647058823,220.75,4415,73.58333333333333,4000000000,54.36013590033975
658,6,3,9,73.11111111111111,219.33333333333334,3290,54.833333333333336,3000000000,54.7112462006079
608,13,3,16,38,202.66666666666666,3040,50.666666666666664,3000000000,59.21052631578947
760,13,3,16,47.5,253.33333333333334,3800,63.333333333333336,3000000000,47.36842105263158
719,18,7,25,28.76,102.71428571428571,3595,59.916666666666664,7000000000,116.8289290681502
794,12,6,18,44.111111111111114,132.33333333333334,3970,66.16666666666667,6000000000,90.6801007556675
587,11,3,14,41.92857142857143,195.66666666666666,2935,48.916666666666664,3000000000,61.32879045996593
949,12,13,25,37.96,73,4745,79.08333333333333,13000000000,164.38356164383563
380,6,3,9,42.22222222222222,126.66666666666667,1900,31.666666666666668,3000000000,94.73684210526316
407,9,3,12,33.916666666666664,135.66666666666666,2035,33.916666666666664,3000000000,88.45208845208846
335,6,6,12,27.916666666666668,55.833333333333336,1675,27.916666666666668,6000000000,214.92537313432834
512,5,3,8,64,170.66666666666666,2560,42.666666666666664,3000000000,70.3125
637,9,3,12,53.083333333333336,212.33333333333334,3185,53.083333333333336,3000000000,56.5149136577708
683,11,7,18,37.94444444444444,97.57142857142857,3415,56.916666666666664,7000000000,122.98682284040997
826,21,3,24,34.416666666666664,275.3333333333333,4130,68.83333333333333,3000000000,43.58353510895884
269,5,3,8,33.625,89.66666666666667,1345,22.416666666666668,3000000000,133.82899628252787
728,8,6,14,52,121.33333333333333,3640,60.666666666666664,6000000000,98.9010989010989
790,12,5,17,46.470588235294116,158,3950,65.83333333333333,5000000000,75.94936708860759
663,9,4,13,51,165.75,3315,55.25,4000000000,72.39819004524887
517,13,3,16,32.3125,172.33333333333334,2585,43.083333333333336,3000000000,69.63249516441006
663,9,3,12,55.25,221,3315,55.25,3000000000,54.29864253393665
625,5,4,9,69.44444444444444,156.25,3125,52.083333333333336,4000000000,76.8
952,15,12,27,35.25925925925926,79.33333333333333,4760,79.33333333333333,12000000000,151.2605042016807
302,5,4,9,33.55555555555556,75.5,1510,25.166666666666668,4000000000,158.94039735099338
336,4,5,9,37.333333333333336,67.2,1680,28,5000000000,178.57142857142856
731,16,4,20,36.55,182.75,3655,60.916666666666664,4000000000,65.66347469220247
755,10,3,13,58.07692307692308,251.66666666666666,3775,62.916666666666664,3000000000,47.682119205298015
542,7,5,12,45.166666666666664,108.4,2710,45.166666666666664,5000000000,110.70110701107012
586,6,3,9,65.11111111111111,195.33333333333334,2930,48.833333333333336,3000000000,61.4334470989761
603,8,6,14,43.07142857142857,100.5,3015,50.25,6000000000,119.40298507462687
980,14,9,23,42.608695652173914,108.88888888888889,4900,81.66666666666667,9000000000,110.20408163265306
765,10,9,19,40.26315789473684,85,3825,63.75,9000000000,141.17647058823528
359,8,3,11,32.63636363636363,119.66666666666667,1795,29.916666666666668,3000000000,100.27855153203343
529,5,3,8,66.125,176.33333333333334,2645,44.083333333333336,3000000000,68.05293005671076
948,17,6,23,41.21739130434783,158,4740,79,6000000000,75.94936708860759
595,10,3,13,45.76923076923077,198.33333333333334,2975,49.583333333333336,3000000000,60.50420168067227
687,9,3,12,57.25,229,3435,57.25,3000000000,52.40174672489083
621,8,3,11,56.45454545454545,207,3105,51.75,3000000000,57.971014492753625
654,10,4,14,46.714285714285715,163.5,3270,54.5,4000000000,73.39449541284404
505,11,3,14,36.07142857142857,168.33333333333334,2525,42.083333333333336,3000000000,71.28712871287128
398,4,3,7,56.857142857142854,132.66666666666666,1990,33.166666666666664,3000000000,90.45226130653266
246,5,3,8,30.75,82,1230,20.5,3000000000,146.34146341463415
493,7,3,10,49.3,164.33333333333334,2465,41.083333333333336,3000000000,73.02231237322515
372,5,3,8,46.5,124,1860,31,3000000000,96.77419354838709
1062,15,3,18,59,354,5310,88.5,3000000000,33.898305084745765
293,4,3,7,41.857142857142854,97.66666666666667,1465,24.416666666666668,3000000000,122.8668941979522
755,7,11,18,41.94444444444444,68.63636363636364,3775,62.916666666666664,11000000000,174.83443708609272
761,14,3,17,44.76470588235294,253.66666666666666,3805,63.416666666666664,3000000000,47.306176084099874
1501,20,9,29,51.758620689655174,166.77777777777777,7505,125.08333333333333,9000000000,71.95203197868088
318,5,4,9,35.333333333333336,79.5,1590,26.5,4000000000,150.9433962264151
719,14,3,17,42.294117647058826,239.66666666666666,3595,59.916666666666664,3000000000,50.06954102920724
1409,32,7,39,36.12820512820513,201.28571428571428,7045,117.41666666666667,7000000000,59.61674946770759
355,6,3,9,39.44444444444444,118.33333333333333,1775,29.583333333333332,3000000000,101.40845070422536
1078,12,3,15,71.86666666666666,359.3333333333333,5390,89.83333333333333,3000000000,33.39517625231911
335,6,3,9,37.22222222222222,111.66666666666667,1675,27.916666666666668,3000000000,107.46268656716417
853,12,4,16,53.3125,213.25,4265,71.08333333333333,4000000000,56.27198124267292
300,5,4,9,33.333333333333336,75,1500,25,4000000000,160
836,14,7,21,39.80952380952381,119.42857142857143,4180,69.66666666666667,7000000000,100.47846889952153
587,6,4,10,58.7,146.75,2935,48.916666666666664,4000000000,81.77172061328791
420,8,3,11,38.18181818181818,140,2100,35,3000000000,85.71428571428572
1169,13,3,16,73.0625,389.6666666666667,5845,97.41666666666667,3000000000,30.795551753635586
396,8,5,13,30.46153846153846,79.2,1980,33,5000000000,151.5151515151515
846,11,3,14,60.42857142857143,282,4230,70.5,3000000000,42.5531914893617
1022,16,3,19,53.78947368421053,340.6666666666667,5110,85.16666666666667,3000000000,35.22504892367906
369,5,3,8,46.125,123,1845,30.75,3000000000,97.5609756097561
656,13,6,19,34.526315789473685,109.33333333333333,3280,54.666666666666664,6000000000,109.7560975609756
598,12,3,15,39.86666666666667,199.33333333333334,2990,49.833333333333336,3000000000,60.20066889632107
1135,9,13,22,51.59090909090909,87.3076923076923,5675,94.58333333333333,13000000000,137.44493392070484
363,5,3,8,45.375,121,1815,30.25,3000000000,99.17355371900827
474,7,3,10,47.4,158,2370,39.5,3000000000,75.94936708860759
534,5,4,9,59.333333333333336,133.5,2670,44.5,4000000000,89.8876404494382
567,7,3,10,56.7,189,2835,47.25,3000000000,63.492063492063494
695,11,3,14,49.642857142857146,231.66666666666666,3475,57.916666666666664,3000000000,51.79856115107914
640,5,4,9,71.11111111111111,160,3200,53.333333333333336,4000000000,75
1053,13,5,18,58.5,210.6,5265,87.75,5000000000,56.98005698005698
598,6,3,9,66.44444444444444,199.33333333333334,2990,49.833333333333336,3000000000,60.20066889632107
920,16,4,20,46,230,4600,76.66666666666667,4000000000,52.17391304347826
540,5,4,9,60,135,2700,45,4000000000,88.8888888888889
519,8,4,12,43.25,129.75,2595,43.25,4000000000,92.48554913294798
791,13,4,17,46.529411764705884,197.75,3955,65.91666666666667,4000000000,60.6826801517067
750,12,7,19,39.473684210526315,107.14285714285714,3750,62.5,7000000000,112
286,4,3,7,40.857142857142854,95.33333333333333,1430,23.833333333333332,3000000000,125.87412587412588
443,4,3,7,63.285714285714285,147.66666666666666,2215,36.916666666666664,3000000000,81.26410835214448
536,13,3,16,33.5,178.66666666666666,2680,44.666666666666664,3000000000,67.16417910447761
549,5,3,8,68.625,183,2745,45.75,3000000000,65.57377049180329
516,6,5,11,46.90909090909091,103.2,2580,43,5000000000,116.27906976744185
394,6,4,10,39.4,98.5,1970,32.833333333333336,4000000000,121.82741116751268
366,6,4,10,36.6,91.5,1830,30.5,4000000000,131.14754098360658
1114,20,7,27,41.25925925925926,159.14285714285714,5570,92.83333333333333,7000000000,75.40394973070018
528,11,6,17,31.058823529411764,88,2640,44,6000000000,136.36363636363637
624,9,6,15,41.6,104,3120,52,6000000000,115.38461538461539
336,7,3,10,33.6,112,1680,28,3000000000,107.14285714285715
419,7,4,11,38.09090909090909,104.75,2095,34.916666666666664,4000000000,114.55847255369929
359,4,3,7,51.285714285714285,119.66666666666667,1795,29.916666666666668,3000000000,100.27855153203343
1029,13,10,23,44.73913043478261,102.9,5145,85.75,10000000000,116.61807580174927
627,8,3,11,57,209,3135,52.25,3000000000,57.41626794258373
764,8,5,13,58.76923076923077,152.8,3820,63.666666666666664,5000000000,78.53403141361258
661,6,7,13,50.84615384615385,94.42857142857143,3305,55.083333333333336,7000000000,127.08018154311648
562,14,3,17,33.05882352941177,187.33333333333334,2810,46.833333333333336,3000000000,64.05693950177935
869,12,3,15,57.93333333333333,289.6666666666667,4345,72.41666666666667,3000000000,41.42692750287687
912,17,3,20,45.6,304,4560,76,3000000000,39.473684210526315
521,10,4,14,37.214285714285715,130.25,2605,43.416666666666664,4000000000,92.13051823416507
430,6,4,10,43,107.5,2150,35.833333333333336,4000000000,111.62790697674417
307,7,3,10,30.7,102.33333333333333,1535,25.583333333333332,3000000000,117.26384364820846
506,7,3,10,50.6,168.66666666666666,2530,42.166666666666664,3000000000,71.14624505928855
538,7,4,11,48.90909090909091,134.5,2690,44.833333333333336,4000000000,89.21933085501858
1163,12,6,18,64.61111111111111,193.83333333333334,5815,96.91666666666667,6000000000,61.90885640584695
238,9,3,12,19.833333333333332,79.33333333333333,1190,19.833333333333332,3000000000,151.2605042016807
850,10,3,13,65.38461538461539,283.3333333333333,4250,70.83333333333333,3000000000,42.352941176470594
547,9,4,13,42.07692307692308,136.75,2735,45.583333333333336,4000000000,87.75137111517367
542,10,6,16,33.875,90.33333333333333,2710,45.166666666666664,6000000000,132.84132841328415
814,8,7,15,54.266666666666666,116.28571428571429,4070,67.83333333333333,7000000000,103.19410319410319
790,9,3,12,65.83333333333333,263.3333333333333,3950,65.83333333333333,3000000000,45.56962025316456
622,7,3,10,62.2,207.33333333333334,3110,51.833333333333336,3000000000,57.877813504823145
1010,21,11,32,31.5625,91.81818181818181,5050,84.16666666666667,11000000000,130.69306930693068
1411,30,3,33,42.75757575757576,470.3333333333333,7055,117.58333333333333,3000000000,25.51381998582566
516,11,3,14,36.857142857142854,172,2580,43,3000000000,69.76744186046511
894,15,3,18,49.666666666666664,298,4470,74.5,3000000000,40.26845637583893
446,6,4,10,44.6,111.5,2230,37.166666666666664,4000000000,107.62331838565024
464,7,3,10,46.4,154.66666666666666,2320,38.666666666666664,3000000000,77.58620689655173
1308,21,3,24,54.5,436,6540,109,3000000000,27.52293577981651
842,9,3,12,70.16666666666667,280.6666666666667,4210,70.16666666666667,3000000000,42.75534441805225
316,8,3,11,28.727272727272727,105.33333333333333,1580,26.333333333333332,3000000000,113.9240506329114
597,8,3,11,54.27272727272727,199,2985,49.75,3000000000,60.301507537688444
431,9,3,12,35.916666666666664,143.66666666666666,2155,35.916666666666664,3000000000,83.52668213457078
1037,17,7,24,43.208333333333336,148.14285714285714,5185,86.41666666666667,7000000000,81.00289296046287
462,4,3,7,66,154,2310,38.5,3000000000,77.92207792207792
636,11,4,15,42.4,159,3180,53,4000000000,75.47169811320755
1039,18,3,21,49.476190476190474,346.3333333333333,5195,86.58333333333333,3000000000,34.64870067372474
497,8,3,11,45.18181818181818,165.66666666666666,2485,41.416666666666664,3000000000,72.43460764587526
429,11,3,14,30.642857142857142,143,2145,35.75,3000000000,83.91608391608392
434,6,3,9,48.22222222222222,144.66666666666666,2170,36.166666666666664,3000000000,82.94930875576037
298,6,3,9,33.111111111111114,99.33333333333333,1490,24.833333333333332,3000000000,120.8053691275168
527,4,5,9,58.55555555555556,105.4,2635,43.916666666666664,5000000000,113.85199240986718
512,10,4,14,36.57142857142857,128,2560,42.666666666666664,4000000000,93.75
425,8,4,12,35.416666666666664,106.25,2125,35.416666666666664,4000000000,112.94117647058823
255,8,3,11,23.181818181818183,85,1275,21.25,3000000000,141.17647058823528
525,4,4,8,65.625,131.25,2625,43.75,4000000000,91.42857142857143
509,7,4,11,46.27272727272727,127.25,2545,42.416666666666664,4000000000,94.30255402750493
482,13,6,19,25.36842105263158,80.33333333333333,2410,40.166666666666664,6000000000,149.37759336099586
1234,15,8,23,53.65217391304348,154.25,6170,102.83333333333333,8000000000,77.79578606158833
1138,27,3,30,37.93333333333333,379.3333333333333,5690,94.83333333333333,3000000000,31.634446397188054
681,9,5,14,48.642857142857146,136.2,3405,56.75,5000000000,88.10572687224669
850,15,3,18,47.22222222222222,283.3333333333333,4250,70.83333333333333,3000000000,42.352941176470594
555,8,7,15,37,79.28571428571429,2775,46.25,7000000000,151.35135135135135
587,7,3,10,58.7,195.66666666666666,2935,48.916666666666664,3000000000,61.32879045996593
385,5,3,8,48.125,128.33333333333334,1925,32.083333333333336,3000000000,93.5064935064935
639,8,7,15,42.6,91.28571428571429,3195,53.25,7000000000,131.45539906103286
262,4,3,7,37.42857142857143,87.33333333333333,1310,21.833333333333332,3000000000,137.40458015267174
876,15,3,18,48.666666666666664,292,4380,73,3000000000,41.0958904109589
828,14,3,17,48.705882352941174,276,4140,69,3000000000,43.47826086956522
1066,9,4,13,82,266.5,5330,88.83333333333333,4000000000,45.0281425891182
396,8,3,11,36,132,1980,33,3000000000,90.9090909090909
277,3,3,6,46.166666666666664,92.33333333333333,1385,23.083333333333332,3000000000,129.9638989169675
274,5,3,8,34.25,91.33333333333333,1370,22.833333333333332,3000000000,131.38686131386862
861,19,3,22,39.13636363636363,287,4305,71.75,3000000000,41.811846689895475
387,7,4,11,35.18181818181818,96.75,1935,32.25,4000000000,124.03100775193799
517,11,3,14,36.92857142857143,172.33333333333334,2585,43.083333333333336,3000000000,69.63249516441006
488,11,7,18,27.11111111111111,69.71428571428571,2440,40.666666666666664,7000000000,172.13114754098362
384,10,3,13,29.53846153846154,128,1920,32,3000000000,93.75
719,10,5,15,47.93333333333333,143.8,3595,59.916666666666664,5000000000,83.44923504867873
383,9,3,12,31.916666666666668,127.66666666666667,1915,31.916666666666668,3000000000,93.99477806788512
676,13,3,16,42.25,225.33333333333334,3380,56.333333333333336,3000000000,53.25443786982248
808,7,8,15,53.86666666666667,101,4040,67.33333333333333,8000000000,118.81188118811882
754,8,9,17,44.35294117647059,83.77777777777777,3770,62.833333333333336,9000000000,143.23607427055703
383,5,3,8,47.875,127.66666666666667,1915,31.916666666666668,3000000000,93.99477806788512
541,8,4,12,45.083333333333336,135.25,2705,45.083333333333336,4000000000,88.724584103512
178,3,3,6,29.666666666666668,59.333333333333336,890,14.833333333333334,3000000000,202.24719101123594
365,8,3,11,33.18181818181818,121.66666666666667,1825,30.416666666666668,3000000000,98.63013698630137
502,8,3,11,45.63636363636363,167.33333333333334,2510,41.833333333333336,3000000000,71.71314741035856
513,12,3,15,34.2,171,2565,42.75,3000000000,70.17543859649123
362,9,3,12,30.166666666666668,120.66666666666667,1810,30.166666666666668,3000000000,99.4475138121547
1082,25,3,28,38.642857142857146,360.6666666666667,5410,90.16666666666667,3000000000,33.271719038817004
831,11,5,16,51.9375,166.2,4155,69.25,5000000000,72.20216606498195
531,11,3,14,37.92857142857143,177,2655,44.25,3000000000,67.79661016949153
408,7,3,10,40.8,136,2040,34,3000000000,88.23529411764706
940,19,7,26,36.15384615384615,134.28571428571428,4700,78.33333333333333,7000000000,89.36170212765957
1266,20,11,31,40.83870967741935,115.0909090909091,6330,105.5,11000000000,104.26540284360189
596,10,5,15,39.733333333333334,119.2,2980,49.666666666666664,5000000000,100.67114093959732
730,15,6,21,34.76190476190476,121.66666666666667,3650,60.833333333333336,6000000000,98.63013698630137
518,9,3,12,43.166666666666664,172.66666666666666,2590,43.166666666666664,3000000000,69.4980694980695
881,17,6,23,38.30434782608695,146.83333333333334,4405,73.41666666666667,6000000000,81.72531214528944
601,9,6,15,40.06666666666667,100.16666666666667,3005,50.083333333333336,6000000000,119.80033277870216
915,13,7,20,45.75,130.71428571428572,4575,76.25,7000000000,91.80327868852459
1035,13,4,17,60.88235294117647,258.75,5175,86.25,4000000000,46.3768115942029
773,8,3,11,70.27272727272727,257.6666666666667,3865,64.41666666666667,3000000000,46.57179818887451
1002,10,7,17,58.94117647058823,143.14285714285714,5010,83.5,7000000000,83.83233532934132
372,9,5,14,26.571428571428573,74.4,1860,31,5000000000,161.29032258064518
451,5,4,9,50.111111111111114,112.75,2255,37.583333333333336,4000000000,106.43015521064301
514,12,3,15,34.266666666666666,171.33333333333334,2570,42.833333333333336,3000000000,70.03891050583658
612,7,3,10,61.2,204,3060,51,3000000000,58.8235294117647
466,7,3,10,46.6,155.33333333333334,2330,38.833333333333336,3000000000,77.25321888412017
747,17,3,20,37.35,249,3735,62.25,3000000000,48.192771084337345
793,13,3,16,49.5625,264.3333333333333,3965,66.08333333333333,3000000000,45.39722572509458
481,13,3,16,30.0625,160.33333333333334,2405,40.083333333333336,3000000000,74.84407484407484
613,13,5,18,34.05555555555556,122.6,3065,51.083333333333336,5000000000,97.87928221859706
1164,15,10,25,46.56,116.4,5820,97,10000000000,103.09278350515464
650,12,3,15,43.333333333333336,216.66666666666666,3250,54.166666666666664,3000000000,55.38461538461539
395,6,3,9,43.888888888888886,131.66666666666666,1975,32.916666666666664,3000000000,91.13924050632912
1241,18,9,27,45.96296296296296,137.88888888888889,6205,103.41666666666667,9000000000,87.0265914585012
951,8,7,15,63.4,135.85714285714286,4755,79.25,7000000000,88.32807570977917
562,7,3,10,56.2,187.33333333333334,2810,46.833333333333336,3000000000,64.05693950177935
323,5,3,8,40.375,107.66666666666667,1615,26.916666666666668,3000000000,111.45510835913312
669,8,3,11,60.81818181818182,223,3345,55.75,3000000000,53.81165919282511
1164,17,3,20,58.2,388,5820,97,3000000000,30.927835051546392
219,5,3,8,27.375,73,1095,18.25,3000000000,164.3835616438356
494,6,3,9,54.888888888888886,164.66666666666666,2470,41.166666666666664,3000000000,72.87449392712551
867,18,3,21,41.285714285714285,289,4335,72.25,3000000000,41.52249134948097
354,4,3,7,50.57142857142857,118,1770,29.5,3000000000,101.69491525423729
328,4,3,7,46.857142857142854,109.33333333333333,1640,27.333333333333332,3000000000,109.7560975609756
1104,17,4,21,52.57142857142857,276,5520,92,4000000000,43.47826086956522
684,8,3,11,62.18181818181818,228,3420,57,3000000000,52.63157894736842
1053,18,7,25,42.12,150.42857142857142,5265,87.75,7000000000,79.77207977207976
1094,18,3,21,52.095238095238095,364.6666666666667,5470,91.16666666666667,3000000000,32.90676416819012
1086,19,8,27,40.22222222222222,135.75,5430,90.5,8000000000,88.39779005524862
313,5,3,8,39.125,104.33333333333333,1565,26.083333333333332,3000000000,115.01597444089457
578,9,3,12,48.166666666666664,192.66666666666666,2890,48.166666666666664,3000000000,62.28373702422146
600,8,7,15,40,85.71428571428571,3000,50,7000000000,140
588,13,3,16,36.75,196,2940,49,3000000000,61.224489795918366
510,10,3,13,39.23076923076923,170,2550,42.5,3000000000,70.58823529411764
549,12,3,15,36.6,183,2745,45.75,3000000000,65.57377049180329
1265,22,3,25,50.6,421.6666666666667,6325,105.41666666666667,3000000000,28.458498023715414
372,6,3,9,41.333333333333336,124,1860,31,3000000000,96.77419354838709
621,9,3,12,51.75,207,3105,51.75,3000000000,57.971014492753625
1160,21,3,24,48.333333333333336,386.6666666666667,5800,96.66666666666667,3000000000,31.034482758620687
722,14,3,17,42.470588235294116,240.66666666666666,3610,60.166666666666664,3000000000,49.86149584487535
514,6,4,10,51.4,128.5,2570,42.833333333333336,4000000000,93.3852140077821
1041,8,8,16,65.0625,130.125,5205,86.75,8000000000,92.21902017291066
429,6,3,9,47.666666666666664,143,2145,35.75,3000000000,83.91608391608392
307,3,4,7,43.857142857142854,76.75,1535,25.583333333333332,4000000000,156.35179153094464
720,13,6,19,37.89473684210526,120,3600,60,6000000000,100
308,5,3,8,38.5,102.66666666666667,1540,25.666666666666668,3000000000,116.88311688311687
1218,21,8,29,42,152.25,6090,101.5,8000000000,78.81773399014779
653,13,3,16,40.8125,217.66666666666666,3265,54.416666666666664,3000000000,55.1301684532925
561,8,4,12,46.75,140.25,2805,46.75,4000000000,85.56149732620321
434,5,3,8,54.25,144.66666666666666,2170,36.166666666666664,3000000000,82.94930875576037
707,10,4,14,50.5,176.75,3535,58.916666666666664,4000000000,67.89250353606789
419,4,3,7,59.857142857142854,139.66666666666666,2095,34.916666666666664,3000000000,85.91885441527447
356,5,3,8,44.5,118.66666666666667,1780,29.666666666666668,3000000000,101.12359550561797
1048,12,9,21,49.904761904761905,116.44444444444444,5240,87.33333333333333,9000000000,103.05343511450381
394,5,3,8,49.25,131.33333333333334,1970,32.833333333333336,3000000000,91.3705583756345
524,8,3,11,47.63636363636363,174.66666666666666,2620,43.666666666666664,3000000000,68.70229007633587
633,11,3,14,45.214285714285715,211,3165,52.75,3000000000,56.87203791469194
439,11,3,14,31.357142857142858,146.33333333333334,2195,36.583333333333336,3000000000,82.00455580865604
235,3,3,6,39.166666666666664,78.33333333333333,1175,19.583333333333332,3000000000,153.19148936170214
561,9,4,13,43.15384615384615,140.25,2805,46.75,4000000000,85.56149732620321
592,10,4,14,42.285714285714285,148,2960,49.333333333333336,4000000000,81.08108108108108
554,11,3,14,39.57142857142857,184.66666666666666,2770,46.166666666666664,3000000000,64.98194945848375
767,12,3,15,51.13333333333333,255.66666666666666,3835,63.916666666666664,3000000000,46.9361147327249
520,9,5,14,37.142857142857146,104,2600,43.333333333333336,5000000000,115.38461538461537
366,7,3,10,36.6,122,1830,30.5,3000000000,98.36065573770492
691,8,5,13,53.15384615384615,138.2,3455,57.583333333333336,5000000000,86.83068017366135
666,6,3,9,74,222,3330,55.5,3000000000,54.05405405405405
372,4,5,9,41.333333333333336,74.4,1860,31,5000000000,161.29032258064518
862,11,5,16,53.875,172.4,4310,71.83333333333333,5000000000,69.60556844547564
511,5,3,8,63.875,170.33333333333334,2555,42.583333333333336,3000000000,70.45009784735812
1076,17,7,24,44.833333333333336,153.71428571428572,5380,89.66666666666667,7000000000,78.06691449814126
1130,19,3,22,51.36363636363637,376.6666666666667,5650,94.16666666666667,3000000000,31.858407079646017
612,8,7,15,40.8,87.42857142857143,3060,51,7000000000,137.2549019607843
722,8,6,14,51.57142857142857,120.33333333333333,3610,60.166666666666664,6000000000,99.7229916897507
568,7,5,12,47.333333333333336,113.6,2840,47.333333333333336,5000000000,105.6338028169014
553,9,3,12,46.083333333333336,184.33333333333334,2765,46.083333333333336,3000000000,65.09945750452079
642,15,3,18,35.666666666666664,214,3210,53.5,3000000000,56.074766355140184
467,9,5,14,33.357142857142854,93.4,2335,38.916666666666664,5000000000,128.47965738758032
562,14,3,17,33.05882352941177,187.33333333333334,2810,46.833333333333336,3000000000,64.05693950177935
648,8,3,11,58.90909090909091,216,3240,54,3000000000,55.55555555555555
551,14,3,17,32.411764705882355,183.66666666666666,2755,45.916666666666664,3000000000,65.33575317604357
592,15,3,18,32.888888888888886,197.33333333333334,2960,49.333333333333336,3000000000,60.81081081081081
388,5,3,8,48.5,129.33333333333334,1940,32.333333333333336,3000000000,92.78350515463917
346,6,3,9,38.44444444444444,115.33333333333333,1730,28.833333333333332,3000000000,104.04624277456647
523,9,3,12,43.583333333333336,174.33333333333334,2615,43.583333333333336,3000000000,68.83365200764818
743,6,6,12,61.916666666666664,123.83333333333333,3715,61.916666666666664,6000000000,96.90444145356662
541,6,4,10,54.1,135.25,2705,45.083333333333336,4000000000,88.724584103512
674,7,3,10,67.4,224.66666666666666,3370,56.166666666666664,3000000000,53.41246290801187
558,6,6,12,46.5,93,2790,46.5,6000000000,129.03225806451613
740,7,5,12,61.666666666666664,148,3700,61.666666666666664,5000000000,81.08108108108108
538,7,3,10,53.8,179.33333333333334,2690,44.833333333333336,3000000000,66.91449814126393
201,5,3,8,25.125,67,1005,16.75,3000000000,179.1044776119403
456,6,5,11,41.45454545454545,91.2,2280,38,5000000000,131.57894736842104
852,23,5,28,30.428571428571427,170.4,4260,71,5000000000,70.4225352112676
1128,14,3,17,66.3529411764706,376,5640,94,3000000000,31.914893617021278
608,6,7,13,46.76923076923077,86.85714285714286,3040,50.666666666666664,7000000000,138.15789473684214
895,9,12,21,42.61904761904762,74.58333333333333,4475,74.58333333333333,12000000000,160.89385474860336
371,6,3,9,41.22222222222222,123.66666666666667,1855,30.916666666666668,3000000000,97.03504043126685
631,8,3,11,57.36363636363637,210.33333333333334,3155,52.583333333333336,3000000000,57.05229793977813
412,6,7,13,31.692307692307693,58.857142857142854,2060,34.333333333333336,7000000000,203.88349514563106
453,9,3,12,37.75,151,2265,37.75,3000000000,79.47019867549669
482,8,3,11,43.81818181818182,160.66666666666666,2410,40.166666666666664,3000000000,74.68879668049793
1387,14,10,24,57.791666666666664,138.7,6935,115.58333333333333,10000000000,86.51766402307138
556,15,3,18,30.88888888888889,185.33333333333334,2780,46.333333333333336,3000000000,64.74820143884892
464,4,3,7,66.28571428571429,154.66666666666666,2320,38.666666666666664,3000000000,77.58620689655173
765,10,3,13,58.84615384615385,255,3825,63.75,3000000000,47.05882352941176
941,21,10,31,30.35483870967742,94.1,4705,78.41666666666667,10000000000,127.52391073326248
702,11,3,14,50.142857142857146,234,3510,58.5,3000000000,51.28205128205128
643,10,3,13,49.46153846153846,214.33333333333334,3215,53.583333333333336,3000000000,55.987558320373246
532,6,6,12,44.333333333333336,88.66666666666667,2660,44.333333333333336,6000000000,135.33834586466165
1046,19,6,25,41.84,174.33333333333334,5230,87.16666666666667,6000000000,68.83365200764818
888,8,7,15,59.2,126.85714285714286,4440,74,7000000000,94.5945945945946
612,9,3,12,51,204,3060,51,3000000000,58.8235294117647
583,7,3,10,58.3,194.33333333333334,2915,48.583333333333336,3000000000,61.74957118353345
1051,17,5,22,47.77272727272727,210.2,5255,87.58333333333333,5000000000,57.08848715509039
1204,12,3,15,80.26666666666667,401.3333333333333,6020,100.33333333333333,3000000000,29.900332225913623
899,9,3,12,74.91666666666667,299.6666666666667,4495,74.91666666666667,3000000000,40.04449388209121
1247,14,8,22,56.68181818181818,155.875,6235,103.91666666666667,8000000000,76.98476343223737
521,6,3,9,57.888888888888886,173.66666666666666,2605,43.416666666666664,3000000000,69.0978886756238
607,10,3,13,46.69230769230769,202.33333333333334,3035,50.583333333333336,3000000000,59.308072487644154
962,15,4,19,50.63157894736842,240.5,4810,80.16666666666667,4000000000,49.896049896049895
961,19,8,27,35.592592592592595,120.125,4805,80.08333333333333,8000000000,99.89594172736733
625,12,5,17,36.76470588235294,125,3125,52.083333333333336,5000000000,96
971,13,6,19,51.10526315789474,161.83333333333334,4855,80.91666666666667,6000000000,74.15036045314109
1362,14,3,17,80.11764705882354,454,6810,113.5,3000000000,26.43171806167401
452,6,3,9,50.22222222222222,150.66666666666666,2260,37.666666666666664,3000000000,79.64601769911505
1024,12,3,15,68.26666666666667,341.3333333333333,5120,85.33333333333333,3000000000,35.15625
784,4,7,11,71.27272727272727,112,3920,65.33333333333333,7000000000,107.14285714285715
589,7,6,13,45.30769230769231,98.16666666666667,2945,49.083333333333336,6000000000,122.24108658743633
1261,16,8,24,52.541666666666664,157.625,6305,105.08333333333333,8000000000,76.13005551149881
590,5,3,8,73.75,196.66666666666666,2950,49.166666666666664,3000000000,61.016949152542374
729,15,3,18,40.5,243,3645,60.75,3000000000,49.382716049382715
427,10,3,13,32.84615384615385,142.33333333333334,2135,35.583333333333336,3000000000,84.30913348946135
1227,13,6,19,64.57894736842105,204.5,6135,102.25,6000000000,58.67970660146699
372,5,3,8,46.5,124,1860,31,3000000000,96.77419354838709
638,14,3,17,37.529411764705884,212.66666666666666,3190,53.166666666666664,3000000000,56.426332288401255
732,8,8,16,45.75,91.5,3660,61,8000000000,131.14754098360658
559,11,7,18,31.055555555555557,79.85714285714286,2795,46.583333333333336,7000000000,150.26833631484794
854,16,5,21,40.666666666666664,170.8,4270,71.16666666666667,5000000000,70.25761124121779
203,3,3,6,33.833333333333336,67.66666666666667,1015,16.916666666666668,3000000000,177.33990147783248
1367,22,3,25,54.68,455.6666666666667,6835,113.91666666666667,3000000000,26.335040234089245
785,20,3,23,34.130434782608695,261.6666666666667,3925,65.41666666666667,3000000000,45.859872611464965
559,11,3,14,39.92857142857143,186.33333333333334,2795,46.583333333333336,3000000000,64.40071556350627
730,11,3,14,52.142857142857146,243.33333333333334,3650,60.833333333333336,3000000000,49.31506849315068
340,9,3,12,28.333333333333332,113.33333333333333,1700,28.333333333333332,3000000000,105.88235294117648
416,6,3,9,46.22222222222222,138.66666666666666,2080,34.666666666666664,3000000000,86.53846153846155
320,6,3,9,35.55555555555556,106.66666666666667,1600,26.666666666666668,3000000000,112.5
1041,17,5,22,47.31818181818182,208.2,5205,86.75,5000000000,57.636887608069166
831,12,6,18,46.166666666666664,138.5,4155,69.25,6000000000,86.64259927797835
720,12,7,19,37.89473684210526,102.85714285714286,3600,60,7000000000,116.66666666666667
497,9,3,12,41.416666666666664,165.66666666666666,2485,41.416666666666664,3000000000,72.43460764587526
376,8,3,11,34.18181818181818,125.33333333333333,1880,31.333333333333332,3000000000,95.74468085106383
534,6,3,9,59.333333333333336,178,2670,44.5,3000000000,67.41573033707864
946,14,8,22,43,118.25,4730,78.83333333333333,8000000000,101.4799154334038
376,6,4,10,37.6,94,1880,31.333333333333332,4000000000,127.65957446808511
721,10,4,14,51.5,180.25,3605,60.083333333333336,4000000000,66.57420249653259
617,5,3,8,77.125,205.66666666666666,3085,51.416666666666664,3000000000,58.346839546191255
1063,15,6,21,50.61904761904762,177.16666666666666,5315,88.58333333333333,6000000000,67.73283160865475
251,9,3,12,20.916666666666668,83.66666666666667,1255,20.916666666666668,3000000000,143.42629482071712
415,8,4,12,34.583333333333336,103.75,2075,34.583333333333336,4000000000,115.66265060240963
476,6,5,11,43.27272727272727,95.2,2380,39.666666666666664,5000000000,126.05042016806723
680,5,5,10,68,136,3400,56.666666666666664,5000000000,88.23529411764707
286,6,5,11,26,57.2,1430,23.833333333333332,5000000000,209.7902097902098
1008,12,3,15,67.2,336,5040,84,3000000000,35.714285714285715
1213,22,3,25,48.52,404.3333333333333,6065,101.08333333333333,3000000000,29.67848309975268
632,6,8,14,45.142857142857146,79,3160,52.666666666666664,8000000000,151.89873417721518
882,18,8,26,33.92307692307692,110.25,4410,73.5,8000000000,108.843537414966
1087,16,14,30,36.233333333333334,77.64285714285714,5435,90.58333333333333,14000000000,154.5538178472861
156,6,3,9,17.333333333333332,52,780,13,3000000000,230.76923076923077
544,14,3,17,32,181.33333333333334,2720,45.333333333333336,3000000000,66.17647058823529
1205,22,3,25,48.2,401.6666666666667,6025,100.41666666666667,3000000000,29.875518672199167
217,9,3,12,18.083333333333332,72.33333333333333,1085,18.083333333333332,3000000000,165.89861751152074
596,9,3,12,49.666666666666664,198.66666666666666,2980,49.666666666666664,3000000000,60.4026845637584
631,10,3,13,48.53846153846154,210.33333333333334,3155,52.583333333333336,3000000000,57.05229793977813
345,4,3,7,49.285714285714285,115,1725,28.75,3000000000,104.34782608695652
756,13,3,16,47.25,252,3780,63,3000000000,47.61904761904762
459,7,3,10,45.9,153,2295,38.25,3000000000,78.4313725490196
813,14,3,17,47.8235294117647,271,4065,67.75,3000000000,44.28044280442804
288,7,3,10,28.8,96,1440,24,3000000000,125
841,11,3,14,60.07142857142857,280.3333333333333,4205,70.08333333333333,3000000000,42.80618311533888
954,17,3,20,47.7,318,4770,79.5,3000000000,37.735849056603776
594,11,6,17,34.94117647058823,99,2970,49.5,6000000000,121.21212121212122
665,11,4,15,44.333333333333336,166.25,3325,55.416666666666664,4000000000,72.18045112781955
582,11,3,14,41.57142857142857,194,2910,48.5,3000000000,61.855670103092784
515,11,3,14,36.785714285714285,171.66666666666666,2575,42.916666666666664,3000000000,69.90291262135923
682,10,6,16,42.625,113.66666666666667,3410,56.833333333333336,6000000000,105.57184750733137
810,16,7,23,35.21739130434783,115.71428571428571,4050,67.5,7000000000,103.7037037037037
708,14,4,18,39.333333333333336,177,3540,59,4000000000,67.79661016949153
261,6,6,12,21.75,43.5,1305,21.75,6000000000,275.8620689655172
320,4,3,7,45.714285714285715,106.66666666666667,1600,26.666666666666668,3000000000,112.5
557,5,3,8,69.625,185.66666666666666,2785,46.416666666666664,3000000000,64.63195691202873
491,4,6,10,49.1,81.83333333333333,2455,40.916666666666664,6000000000,146.63951120162935
161,7,3,10,16.1,53.666666666666664,805,13.416666666666666,3000000000,223.60248447204972
636,22,8,30,21.2,79.5,3180,53,8000000000,150.9433962264151
996,15,4,19,52.421052631578945,249,4980,83,4000000000,48.192771084337345
530,11,3,14,37.857142857142854,176.66666666666666,2650,44.166666666666664,3000000000,67.9245283018868
563,10,3,13,43.30769230769231,187.66666666666666,2815,46.916666666666664,3000000000,63.94316163410302
485,5,3,8,60.625,161.66666666666666,2425,40.416666666666664,3000000000,74.22680412371135
803,14,9,23,34.91304347826087,89.22222222222223,4015,66.91666666666667,9000000000,134.4956413449564
527,8,3,11,47.90909090909091,175.66666666666666,2635,43.916666666666664,3000000000,68.3111954459203
665,15,3,18,36.94444444444444,221.66666666666666,3325,55.416666666666664,3000000000,54.13533834586466
654,14,3,17,38.470588235294116,218,3270,54.5,3000000000,55.04587155963302
1111,11,4,15,74.06666666666666,277.75,5555,92.58333333333333,4000000000,43.20432043204321
711,5,7,12,59.25,101.57142857142857,3555,59.25,7000000000,118.14345991561181
456,11,3,14,32.57142857142857,152,2280,38,3000000000,78.94736842105263
188,4,4,8,23.5,47,940,15.666666666666666,4000000000,255.31914893617022
1558,34,3,37,42.108108108108105,519.3333333333334,7790,129.83333333333334,3000000000,23.10654685494223
694,10,3,13,53.38461538461539,231.33333333333334,3470,57.833333333333336,3000000000,51.87319884726225
1627,16,7,23,70.73913043478261,232.42857142857142,8135,135.58333333333334,7000000000,51.62876459741856
356,7,4,11,32.36363636363637,89,1780,29.666666666666668,4000000000,134.83146067415728
1549,28,17,45,34.422222222222224,91.11764705882354,7745,129.08333333333334,17000000000,131.697869593286
522,8,3,11,47.45454545454545,174,2610,43.5,3000000000,68.9655172413793
538,9,5,14,38.42857142857143,107.6,2690,44.833333333333336,5000000000,111.52416356877322
656,12,3,15,43.733333333333334,218.66666666666666,3280,54.666666666666664,3000000000,54.8780487804878
326,8,3,11,29.636363636363637,108.66666666666667,1630,27.166666666666668,3000000000,110.42944785276073
628,11,3,14,44.857142857142854,209.33333333333334,3140,52.333333333333336,3000000000,57.324840764331206
210,3,5,8,26.25,42,1050,17.5,5000000000,285.7142857142857
497,7,3,10,49.7,165.66666666666666,2485,41.416666666666664,3000000000,72.43460764587526
466,7,3,10,46.6,155.33333333333334,2330,38.833333333333336,3000000000,77.25321888412017
727,8,5,13,55.92307692307692,145.4,3635,60.583333333333336,5000000000,82.53094910591471
404,7,3,10,40.4,134.66666666666666,2020,33.666666666666664,3000000000,89.10891089108911
430,8,4,12,35.833333333333336,107.5,2150,35.833333333333336,4000000000,111.62790697674417
512,4,4,8,64,128,2560,42.666666666666664,4000000000,93.75
755,12,3,15,50.333333333333336,251.66666666666666,3775,62.916666666666664,3000000000,47.682119205298015
535,10,5,15,35.666666666666664,107,2675,44.583333333333336,5000000000,112.14953271028037
415,7,3,10,41.5,138.33333333333334,2075,34.583333333333336,3000000000,86.74698795180721
851,9,3,12,70.91666666666667,283.6666666666667,4255,70.91666666666667,3000000000,42.30317273795535
681,13,4,17,40.05882352941177,170.25,3405,56.75,4000000000,70.48458149779735
595,12,3,15,39.666666666666664,198.33333333333334,2975,49.583333333333336,3000000000,60.50420168067227
840,13,6,19,44.21052631578947,140,4200,70,6000000000,85.71428571428572
637,10,7,17,37.470588235294116,91,3185,53.083333333333336,7000000000,131.86813186813185
735,8,3,11,66.81818181818181,245,3675,61.25,3000000000,48.9795918367347
883,15,9,24,36.791666666666664,98.11111111111111,4415,73.58333333333333,9000000000,122.31030577576445
1003,8,7,15,66.86666666666666,143.28571428571428,5015,83.58333333333333,7000000000,83.74875373878366
659,16,6,22,29.954545454545453,109.83333333333333,3295,54.916666666666664,6000000000,109.25644916540213
727,13,3,16,45.4375,242.33333333333334,3635,60.583333333333336,3000000000,49.51856946354883
631,6,3,9,70.11111111111111,210.33333333333334,3155,52.583333333333336,3000000000,57.05229793977813
1135,25,3,28,40.535714285714285,378.3333333333333,5675,94.58333333333333,3000000000,31.718061674008812
472,10,3,13,36.30769230769231,157.33333333333334,2360,39.333333333333336,3000000000,76.27118644067795
296,3,4,7,42.285714285714285,74,1480,24.666666666666668,4000000000,162.16216216216216
700,20,8,28,25,87.5,3500,58.333333333333336,8000000000,137.14285714285714
425,7,3,10,42.5,141.66666666666666,2125,35.416666666666664,3000000000,84.70588235294119
707,6,3,9,78.55555555555556,235.66666666666666,3535,58.916666666666664,3000000000,50.91937765205092
628,10,3,13,48.30769230769231,209.33333333333334,3140,52.333333333333336,3000000000,57.324840764331206
522,5,9,14,37.285714285714285,58,2610,43.5,9000000000,206.89655172413794
278,3,5,8,34.75,55.6,1390,23.166666666666668,5000000000,215.82733812949638
549,6,6,12,45.75,91.5,2745,45.75,6000000000,131.14754098360658
315,4,3,7,45,105,1575,26.25,3000000000,114.28571428571428
789,8,3,11,71.72727272727273,263,3945,65.75,3000000000,45.62737642585551
436,5,3,8,54.5,145.33333333333334,2180,36.333333333333336,3000000000,82.56880733944953
1198,16,7,23,52.08695652173913,171.14285714285714,5990,99.83333333333333,7000000000,70.11686143572621
509,8,5,13,39.15384615384615,101.8,2545,42.416666666666664,5000000000,117.87819253438116
1104,18,9,27,40.888888888888886,122.66666666666667,5520,92,9000000000,97.82608695652173
589,8,3,11,53.54545454545455,196.33333333333334,2945,49.083333333333336,3000000000,61.120543293718164
218,8,3,11,19.818181818181817,72.66666666666667,1090,18.166666666666668,3000000000,165.13761467889907
389,9,3,12,32.416666666666664,129.66666666666666,1945,32.416666666666664,3000000000,92.54498714652956
490,11,3,14,35,163.33333333333334,2450,40.833333333333336,3000000000,73.46938775510203
812,12,5,17,47.76470588235294,162.4,4060,67.66666666666667,5000000000,73.89162561576354
574,7,5,12,47.833333333333336,114.8,2870,47.833333333333336,5000000000,104.52961672473867
1402,13,3,16,87.625,467.3333333333333,7010,116.83333333333333,3000000000,25.67760342368046
824,5,3,8,103,274.6666666666667,4120,68.66666666666667,3000000000,43.68932038834951
395,7,3,10,39.5,131.66666666666666,1975,32.916666666666664,3000000000,91.13924050632912
693,13,4,17,40.76470588235294,173.25,3465,57.75,4000000000,69.26406926406926
601,8,3,11,54.63636363636363,200.33333333333334,3005,50.083333333333336,3000000000,59.90016638935108
696,9,3,12,58,232,3480,58,3000000000,51.724137931034484
689,4,3,7,98.42857142857143,229.66666666666666,3445,57.416666666666664,3000000000,52.249637155297535
420,9,3,12,35,140,2100,35,3000000000,85.71428571428572
579,6,3,9,64.33333333333333,193,2895,48.25,3000000000,62.17616580310881
340,6,3,9,37.77777777777778,113.33333333333333,1700,28.333333333333332,3000000000,105.88235294117648
770,10,6,16,48.125,128.33333333333334,3850,64.16666666666667,6000000000,93.5064935064935
1154,15,3,18,64.11111111111111,384.6666666666667,5770,96.16666666666667,3000000000,31.19584055459272
410,5,3,8,51.25,136.66666666666666,2050,34.166666666666664,3000000000,87.8048780487805
692,14,3,17,40.705882352941174,230.66666666666666,3460,57.666666666666664,3000000000,52.02312138728323
808,9,11,20,40.4,73.45454545454545,4040,67.33333333333333,11000000000,163.3663366336634
403,5,3,8,50.375,134.33333333333334,2015,33.583333333333336,3000000000,89.33002481389578
951,20,6,26,36.57692307692308,158.5,4755,79.25,6000000000,75.70977917981074
774,15,3,18,43,258,3870,64.5,3000000000,46.51162790697674
296,10,3,13,22.76923076923077,98.66666666666667,1480,24.666666666666668,3000000000,121.62162162162161
953,15,5,20,47.65,190.6,4765,79.41666666666667,5000000000,62.95907660020986
834,20,3,23,36.26086956521739,278,4170,69.5,3000000000,43.165467625899275
411,9,3,12,34.25,137,2055,34.25,3000000000,87.59124087591242
436,9,3,12,36.333333333333336,145.33333333333334,2180,36.333333333333336,3000000000,82.56880733944953
526,6,8,14,37.57142857142857,65.75,2630,43.833333333333336,8000000000,182.50950570342204
465,10,3,13,35.76923076923077,155,2325,38.75,3000000000,77.41935483870968
273,6,5,11,24.818181818181817,54.6,1365,22.75,5000000000,219.7802197802198
706,7,3,10,70.6,235.33333333333334,3530,58.833333333333336,3000000000,50.991501416430594
283,4,4,8,35.375,70.75,1415,23.583333333333332,4000000000,169.6113074204947
659,10,4,14,47.07142857142857,164.75,3295,54.916666666666664,4000000000,72.83763277693475
1058,14,8,22,48.09090909090909,132.25,5290,88.16666666666667,8000000000,90.73724007561437
557,15,3,18,30.944444444444443,185.66666666666666,2785,46.416666666666664,3000000000,64.63195691202873
714,7,4,11,64.9090909090909,178.5,3570,59.5,4000000000,67.22689075630252
742,11,3,14,53,247.33333333333334,3710,61.833333333333336,3000000000,48.517520215633425
352,9,5,14,25.142857142857142,70.4,1760,29.333333333333332,5000000000,170.45454545454547
379,10,3,13,29.153846153846153,126.33333333333333,1895,31.583333333333332,3000000000,94.9868073878628
625,7,9,16,39.0625,69.44444444444444,3125,52.083333333333336,9000000000,172.8
599,5,3,8,74.875,199.66666666666666,2995,49.916666666666664,3000000000,60.10016694490819
553,4,3,7,79,184.33333333333334,2765,46.083333333333336,3000000000,65.09945750452079
310,5,7,12,25.833333333333332,44.285714285714285,1550,25.833333333333332,7000000000,270.9677419354839
809,15,3,18,44.94444444444444,269.6666666666667,4045,67.41666666666667,3000000000,44.499381953028426
544,11,3,14,38.857142857142854,181.33333333333334,2720,45.333333333333336,3000000000,66.17647058823529
1071,18,5,23,46.56521739130435,214.2,5355,89.25,5000000000,56.022408963585434
554,13,3,16,34.625,184.66666666666666,2770,46.166666666666664,3000000000,64.98194945848375
457,7,3,10,45.7,152.33333333333334,2285,38.083333333333336,3000000000,78.77461706783369
372,6,5,11,33.81818181818182,74.4,1860,31,5000000000,161.29032258064518
946,11,8,19,49.78947368421053,118.25,4730,78.83333333333333,8000000000,101.4799154334038
1027,16,3,19,54.05263157894737,342.3333333333333,5135,85.58333333333333,3000000000,35.05355404089581
525,7,4,11,47.72727272727273,131.25,2625,43.75,4000000000,91.42857142857143
1744,28,3,31,56.25806451612903,581.3333333333334,8720,145.33333333333334,3000000000,20.642201834862384
461,4,3,7,65.85714285714286,153.66666666666666,2305,38.416666666666664,3000000000,78.09110629067246
803,16,5,21,38.23809523809524,160.6,4015,66.91666666666667,5000000000,74.719800747198
95,3,3,6,15.833333333333334,31.666666666666668,475,7.916666666666667,3000000000,378.94736842105266
979,12,8,20,48.95,122.375,4895,81.58333333333333,8000000000,98.05924412665985
619,8,4,12,51.583333333333336,154.75,3095,51.583333333333336,4000000000,77.54442649434571
506,5,3,8,63.25,168.66666666666666,2530,42.166666666666664,3000000000,71.14624505928855
491,7,7,14,35.07142857142857,70.14285714285714,2455,40.916666666666664,7000000000,171.07942973523424
1294,23,3,26,49.76923076923077,431.3333333333333,6470,107.83333333333333,3000000000,27.820710973724886
576,7,3,10,57.6,192,2880,48,3000000000,62.5
596,6,3,9,66.22222222222223,198.66666666666666,2980,49.666666666666664,3000000000,60.4026845637584
612,13,5,18,34,122.4,3060,51,5000000000,98.03921568627452
592,4,7,11,53.81818181818182,84.57142857142857,2960,49.333333333333336,7000000000,141.8918918918919
685,6,3,9,76.11111111111111,228.33333333333334,3425,57.083333333333336,3000000000,52.55474452554744
549,8,3,11,49.90909090909091,183,2745,45.75,3000000000,65.57377049180329
588,7,3,10,58.8,196,2940,49,3000000000,61.224489795918366
708,14,4,18,39.333333333333336,177,3540,59,4000000000,67.79661016949153
624,7,3,10,62.4,208,3120,52,3000000000,57.69230769230769
320,4,4,8,40,80,1600,26.666666666666668,4000000000,150
565,8,5,13,43.46153846153846,113,2825,47.083333333333336,5000000000,106.19469026548671
422,7,3,10,42.2,140.66666666666666,2110,35.166666666666664,3000000000,85.30805687203792
1108,5,4,9,123.11111111111111,277,5540,92.33333333333333,4000000000,43.321299638989174
395,7,3,10,39.5,131.66666666666666,1975,32.916666666666664,3000000000,91.13924050632912
540,11,3,14,38.57142857142857,180,2700,45,3000000000,66.66666666666666
602,6,3,9,66.88888888888889,200.66666666666666,3010,50.166666666666664,3000000000,59.800664451827245
962,19,3,22,43.72727272727273,320.6666666666667,4810,80.16666666666667,3000000000,37.42203742203742
1073,15,3,18,59.611111111111114,357.6666666666667,5365,89.41666666666667,3000000000,33.550792171481824
765,10,3,13,58.84615384615385,255,3825,63.75,3000000000,47.05882352941176
981,13,6,19,51.63157894736842,163.5,4905,81.75,6000000000,73.39449541284404
770,11,3,14,55,256.6666666666667,3850,64.16666666666667,3000000000,46.75324675324675
438,4,3,7,62.57142857142857,146,2190,36.5,3000000000,82.1917808219178
845,10,6,16,52.8125,140.83333333333334,4225,70.41666666666667,6000000000,85.20710059171597
564,8,3,11,51.27272727272727,188,2820,47,3000000000,63.829787234042556
745,9,5,14,53.214285714285715,149,3725,62.083333333333336,5000000000,80.53691275167786
564,10,3,13,43.38461538461539,188,2820,47,3000000000,63.829787234042556
1025,17,6,23,44.56521739130435,170.83333333333334,5125,85.41666666666667,6000000000,70.2439024390244
720,8,4,12,60,180,3600,60,4000000000,66.66666666666666
299,7,3,10,29.9,99.66666666666667,1495,24.916666666666668,3000000000,120.40133779264214
925,14,4,18,51.388888888888886,231.25,4625,77.08333333333333,4000000000,51.891891891891895
989,7,3,10,98.9,329.6666666666667,4945,82.41666666666667,3000000000,36.40040444893832
809,10,4,14,57.785714285714285,202.25,4045,67.41666666666667,4000000000,59.33250927070457
773,9,3,12,64.41666666666667,257.6666666666667,3865,64.41666666666667,3000000000,46.57179818887451
574,10,8,18,31.88888888888889,71.75,2870,47.833333333333336,8000000000,167.24738675958187
752,16,3,19,39.578947368421055,250.66666666666666,3760,62.666666666666664,3000000000,47.87234042553192
759,11,4,15,50.6,189.75,3795,63.25,4000000000,63.241106719367586
473,7,3,10,47.3,157.66666666666666,2365,39.416666666666664,3000000000,76.10993657505286
434,8,3,11,39.45454545454545,144.66666666666666,2170,36.166666666666664,3000000000,82.94930875576037
252,3,4,7,36,63,1260,21,4000000000,190.47619047619048
275,3,3,6,45.833333333333336,91.66666666666667,1375,22.916666666666668,3000000000,130.9090909090909
645,13,3,16,40.3125,215,3225,53.75,3000000000,55.81395348837209
821,8,6,14,58.642857142857146,136.83333333333334,4105,68.41666666666667,6000000000,87.69792935444579
294,8,3,11,26.727272727272727,98,1470,24.5,3000000000,122.44897959183673
548,5,6,11,49.81818181818182,91.33333333333333,2740,45.666666666666664,6000000000,131.38686131386862
506,7,3,10,50.6,168.66666666666666,2530,42.166666666666664,3000000000,71.14624505928855
263,3,3,6,43.833333333333336,87.66666666666667,1315,21.916666666666668,3000000000,136.88212927756652
905,21,3,24,37.708333333333336,301.6666666666667,4525,75.41666666666667,3000000000,39.77900552486188
415,8,3,11,37.72727272727273,138.33333333333334,2075,34.583333333333336,3000000000,86.74698795180721
443,14,4,18,24.61111111111111,110.75,2215,36.916666666666664,4000000000,108.35214446952597
717,5,7,12,59.75,102.42857142857143,3585,59.75,7000000000,117.15481171548117
260,7,3,10,26,86.66666666666667,1300,21.666666666666668,3000000000,138.46153846153845
589,8,3,11,53.54545454545455,196.33333333333334,2945,49.083333333333336,3000000000,61.120543293718164
828,9,3,12,69,276,4140,69,3000000000,43.47826086956522
454,5,3,8,56.75,151.33333333333334,2270,37.833333333333336,3000000000,79.29515418502203
1155,22,11,33,35,105,5775,96.25,11000000000,114.28571428571428
554,8,3,11,50.36363636363637,184.66666666666666,2770,46.166666666666664,3000000000,64.98194945848375
374,4,3,7,53.42857142857143,124.66666666666667,1870,31.166666666666668,3000000000,96.2566844919786
748,13,3,16,46.75,249.33333333333334,3740,62.333333333333336,3000000000,48.1283422459893
307,5,3,8,38.375,102.33333333333333,1535,25.583333333333332,3000000000,117.26384364820846
471,9,5,14,33.642857142857146,94.2,2355,39.25,5000000000,127.38853503184714
917,9,3,12,76.41666666666667,305.6666666666667,4585,76.41666666666667,3000000000,39.25845147219193
769,11,3,14,54.92857142857143,256.3333333333333,3845,64.08333333333333,3000000000,46.81404421326398
216,4,3,7,30.857142857142858,72,1080,18,3000000000,166.66666666666666
474,8,4,12,39.5,118.5,2370,39.5,4000000000,101.26582278481013
235,7,3,10,23.5,78.33333333333333,1175,19.583333333333332,3000000000,153.19148936170214
1037,13,3,16,64.8125,345.6666666666667,5185,86.41666666666667,3000000000,34.71552555448408
751,19,3,22,34.13636363636363,250.33333333333334,3755,62.583333333333336,3000000000,47.93608521970706
612,12,3,15,40.8,204,3060,51,3000000000,58.8235294117647
1169,13,8,21,55.666666666666664,146.125,5845,97.41666666666667,8000000000,82.12147134302823
499,9,4,13,38.38461538461539,124.75,2495,41.583333333333336,4000000000,96.19238476953907
402,8,3,11,36.54545454545455,134,2010,33.5,3000000000,89.55223880597015
527,10,3,13,40.53846153846154,175.66666666666666,2635,43.916666666666664,3000000000,68.3111954459203
641,13,3,16,40.0625,213.66666666666666,3205,53.416666666666664,3000000000,56.1622464898596
426,3,3,6,71,142,2130,35.5,3000000000,84.50704225352113
929,10,5,15,61.93333333333333,185.8,4645,77.41666666666667,5000000000,64.58557588805166
763,18,4,22,34.68181818181818,190.75,3815,63.583333333333336,4000000000,62.90956749672346
761,8,4,12,63.416666666666664,190.25,3805,63.416666666666664,4000000000,63.074901445466494
247,5,3,8,30.875,82.33333333333333,1235,20.583333333333332,3000000000,145.74898785425103
591,12,3,15,39.4,197,2955,49.25,3000000000,60.91370558375634
440,6,5,11,40,88,2200,36.666666666666664,5000000000,136.36363636363637
335,5,3,8,41.875,111.66666666666667,1675,27.916666666666668,3000000000,107.46268656716417
537,8,3,11,48.81818181818182,179,2685,44.75,3000000000,67.0391061452514
565,8,4,12,47.083333333333336,141.25,2825,47.083333333333336,4000000000,84.95575221238938
572,6,4,10,57.2,143,2860,47.666666666666664,4000000000,83.91608391608392
1088,19,3,22,49.45454545454545,362.6666666666667,5440,90.66666666666667,3000000000,33.088235294117645
771,15,5,20,38.55,154.2,3855,64.25,5000000000,77.82101167315174
175,4,3,7,25,58.333333333333336,875,14.583333333333334,3000000000,205.7142857142857
513,6,5,11,46.63636363636363,102.6,2565,42.75,5000000000,116.95906432748538
637,6,3,9,70.77777777777777,212.33333333333334,3185,53.083333333333336,3000000000,56.5149136577708
804,13,3,16,50.25,268,4020,67,3000000000,44.776119402985074
704,18,7,25,28.16,100.57142857142857,3520,58.666666666666664,7000000000,119.31818181818183
756,16,3,19,39.78947368421053,252,3780,63,3000000000,47.61904761904762
512,8,3,11,46.54545454545455,170.66666666666666,2560,42.666666666666664,3000000000,70.3125
677,14,3,17,39.8235294117647,225.66666666666666,3385,56.416666666666664,3000000000,53.17577548005909
316,4,3,7,45.142857142857146,105.33333333333333,1580,26.333333333333332,3000000000,113.9240506329114
459,3,6,9,51,76.5,2295,38.25,6000000000,156.8627450980392
224,6,3,9,24.88888888888889,74.66666666666667,1120,18.666666666666668,3000000000,160.7142857142857
733,10,3,13,56.38461538461539,244.33333333333334,3665,61.083333333333336,3000000000,49.113233287858115
418,7,4,11,38,104.5,2090,34.833333333333336,4000000000,114.83253588516745
820,6,8,14,58.57142857142857,102.5,4100,68.33333333333333,8000000000,117.07317073170732
799,15,4,19,42.05263157894737,199.75,3995,66.58333333333333,4000000000,60.075093867334175
809,9,6,15,53.93333333333333,134.83333333333334,4045,67.41666666666667,6000000000,88.99876390605685
820,16,3,19,43.1578947368421,273.3333333333333,4100,68.33333333333333,3000000000,43.90243902439025
360,4,5,9,40,72,1800,30,5000000000,166.66666666666666
1117,16,3,19,58.78947368421053,372.3333333333333,5585,93.08333333333333,3000000000,32.22918531781558
511,6,3,9,56.77777777777778,170.33333333333334,2555,42.583333333333336,3000000000,70.45009784735812
909,9,3,12,75.75,303,4545,75.75,3000000000,39.603960396039604
932,21,3,24,38.833333333333336,310.6666666666667,4660,77.66666666666667,3000000000,38.62660944206009
966,10,3,13,74.3076923076923,322,4830,80.5,3000000000,37.267080745341616
929,14,3,17,54.64705882352941,309.6666666666667,4645,77.41666666666667,3000000000,38.751345532830996
357,8,3,11,32.45454545454545,119,1785,29.75,3000000000,100.84033613445379
148,5,5,10,14.8,29.6,740,12.333333333333334,5000000000,405.4054054054054
829,12,3,15,55.266666666666666,276.3333333333333,4145,69.08333333333333,3000000000,43.42581423401689
917,18,3,21,43.666666666666664,305.6666666666667,4585,76.41666666666667,3000000000,39.25845147219193
447,5,3,8,55.875,149,2235,37.25,3000000000,80.53691275167786
652,13,5,18,36.22222222222222,130.4,3260,54.333333333333336,5000000000,92.02453987730061
1092,13,3,16,68.25,364,5460,91,3000000000,32.967032967032964
1080,17,5,22,49.09090909090909,216,5400,90,5000000000,55.55555555555555
714,11,4,15,47.6,178.5,3570,59.5,4000000000,67.22689075630252
630,6,3,9,70,210,3150,52.5,3000000000,57.14285714285714
1442,31,3,34,42.411764705882355,480.6666666666667,7210,120.16666666666667,3000000000,24.965325936199722
535,11,3,14,38.214285714285715,178.33333333333334,2675,44.583333333333336,3000000000,67.28971962616822
649,4,3,7,92.71428571428571,216.33333333333334,3245,54.083333333333336,3000000000,55.46995377503852
372,4,3,7,53.142857142857146,124,1860,31,3000000000,96.77419354838709
1009,11,3,14,72.07142857142857,336.3333333333333,5045,84.08333333333333,3000000000,35.6788899900892
589,5,4,9,65.44444444444444,147.25,2945,49.083333333333336,4000000000,81.49405772495756
888,6,3,9,98.66666666666667,296,4440,74,3000000000,40.54054054054054
374,10,5,15,24.933333333333334,74.8,1870,31.166666666666668,5000000000,160.427807486631
793,11,6,17,46.64705882352941,132.16666666666666,3965,66.08333333333333,6000000000,90.79445145018916
706,12,3,15,47.06666666666667,235.33333333333334,3530,58.833333333333336,3000000000,50.991501416430594
530,4,3,7,75.71428571428571,176.66666666666666,2650,44.166666666666664,3000000000,67.9245283018868
1103,15,10,25,44.12,110.3,5515,91.91666666666667,10000000000,108.79419764279237
330,7,3,10,33,110,1650,27.5,3000000000,109.0909090909091
559,12,5,17,32.88235294117647,111.8,2795,46.583333333333336,5000000000,107.3345259391771
491,7,3,10,49.1,163.66666666666666,2455,40.916666666666664,3000000000,73.31975560081467
642,7,3,10,64.2,214,3210,53.5,3000000000,56.074766355140184
387,4,3,7,55.285714285714285,129,1935,32.25,3000000000,93.02325581395348
370,4,3,7,52.857142857142854,123.33333333333333,1850,30.833333333333332,3000000000,97.2972972972973
549,7,3,10,54.9,183,2745,45.75,3000000000,65.57377049180329
466,8,5,13,35.84615384615385,93.2,2330,38.833333333333336,5000000000,128.75536480686694
771,18,3,21,36.714285714285715,257,3855,64.25,3000000000,46.69260700389105
313,5,5,10,31.3,62.6,1565,26.083333333333332,5000000000,191.6932907348243
246,5,3,8,30.75,82,1230,20.5,3000000000,146.34146341463415
917,22,3,25,36.68,305.6666666666667,4585,76.41666666666667,3000000000,39.25845147219193
422,9,3,12,35.166666666666664,140.66666666666666,2110,35.166666666666664,3000000000,85.30805687203792
952,9,8,17,56,119,4760,79.33333333333333,8000000000,100.84033613445379
722,10,6,16,45.125,120.33333333333333,3610,60.166666666666664,6000000000,99.7229916897507
375,6,5,11,34.09090909090909,75,1875,31.25,5000000000,160
1504,23,3,26,57.84615384615385,501.3333333333333,7520,125.33333333333333,3000000000,23.93617021276596
1275,20,7,27,47.22222222222222,182.14285714285714,6375,106.25,7000000000,65.88235294117648
848,8,4,12,70.66666666666667,212,4240,70.66666666666667,4000000000,56.60377358490565
1123,23,12,35,32.08571428571429,93.58333333333333,5615,93.58333333333333,12000000000,128.2279608192342
405,9,3,12,33.75,135,2025,33.75,3000000000,88.8888888888889
649,15,3,18,36.05555555555556,216.33333333333334,3245,54.083333333333336,3000000000,55.46995377503852
429,9,5,14,30.642857142857142,85.8,2145,35.75,5000000000,139.86013986013984
520,5,3,8,65,173.33333333333334,2600,43.333333333333336,3000000000,69.23076923076923
347,4,3,7,49.57142857142857,115.66666666666667,1735,28.916666666666668,3000000000,103.7463976945245
789,12,6,18,43.833333333333336,131.5,3945,65.75,6000000000,91.25475285171102
488,8,4,12,40.666666666666664,122,2440,40.666666666666664,4000000000,98.36065573770492
385,5,5,10,38.5,77,1925,32.083333333333336,5000000000,155.8441558441558
856,20,8,28,30.571428571428573,107,4280,71.33333333333333,8000000000,112.14953271028038
351,6,3,9,39,117,1755,29.25,3000000000,102.56410256410255
842,17,3,20,42.1,280.6666666666667,4210,70.16666666666667,3000000000,42.75534441805225
866,10,5,15,57.733333333333334,173.2,4330,72.16666666666667,5000000000,69.284064665127
386,5,5,10,38.6,77.2,1930,32.166666666666664,5000000000,155.44041450777203
606,10,4,14,43.285714285714285,151.5,3030,50.5,4000000000,79.20792079207921
761,6,3,9,84.55555555555556,253.66666666666666,3805,63.416666666666664,3000000000,47.306176084099874
526,9,5,14,37.57142857142857,105.2,2630,43.833333333333336,5000000000,114.06844106463878
998,17,7,24,41.583333333333336,142.57142857142858,4990,83.16666666666667,7000000000,84.16833667334669
368,5,4,9,40.888888888888886,92,1840,30.666666666666668,4000000000,130.43478260869563
496,5,3,8,62,165.33333333333334,2480,41.333333333333336,3000000000,72.58064516129032
836,13,13,26,32.15384615384615,64.3076923076923,4180,69.66666666666667,13000000000,186.60287081339712
564,6,7,13,43.38461538461539,80.57142857142857,2820,47,7000000000,148.93617021276597
782,12,5,17,46,156.4,3910,65.16666666666667,5000000000,76.72634271099743
429,4,4,8,53.625,107.25,2145,35.75,4000000000,111.8881118881119
415,3,3,6,69.16666666666667,138.33333333333334,2075,34.583333333333336,3000000000,86.74698795180721
707,11,3,14,50.5,235.66666666666666,3535,58.916666666666664,3000000000,50.91937765205092
328,3,3,6,54.666666666666664,109.33333333333333,1640,27.333333333333332,3000000000,109.7560975609756
465,5,3,8,58.125,155,2325,38.75,3000000000,77.41935483870968
620,10,4,14,44.285714285714285,155,3100,51.666666666666664,4000000000,77.41935483870968
649,8,10,18,36.05555555555556,64.9,3245,54.083333333333336,10000000000,184.89984591679507
622,5,3,8,77.75,207.33333333333334,3110,51.833333333333336,3000000000,57.877813504823145
932,7,5,12,77.66666666666667,186.4,4660,77.66666666666667,5000000000,64.37768240343347
1412,13,11,24,58.833333333333336,128.36363636363637,7060,117.66666666666667,11000000000,93.48441926345609
349,8,3,11,31.727272727272727,116.33333333333333,1745,29.083333333333332,3000000000,103.1518624641834
686,7,3,10,68.6,228.66666666666666,3430,57.166666666666664,3000000000,52.478134110787174
510,8,3,11,46.36363636363637,170,2550,42.5,3000000000,70.58823529411764
356,3,5,8,44.5,71.2,1780,29.666666666666668,5000000000,168.53932584269663
511,10,5,15,34.06666666666667,102.2,2555,42.583333333333336,5000000000,117.41682974559686
419,9,4,13,32.23076923076923,104.75,2095,34.916666666666664,4000000000,114.55847255369929
621,13,3,16,38.8125,207,3105,51.75,3000000000,57.971014492753625
426,7,3,10,42.6,142,2130,35.5,3000000000,84.50704225352113
642,6,3,9,71.33333333333333,214,3210,53.5,3000000000,56.074766355140184
705,17,4,21,33.57142857142857,176.25,3525,58.75,4000000000,68.08510638297872
981,8,4,12,81.75,245.25,4905,81.75,4000000000,48.92966360856269
569,8,4,12,47.416666666666664,142.25,2845,47.416666666666664,4000000000,84.3585237258348
1316,25,3,28,47,438.6666666666667,6580,109.66666666666667,3000000000,27.35562310030395
694,6,3,9,77.11111111111111,231.33333333333334,3470,57.833333333333336,3000000000,51.87319884726225
697,11,8,19,36.68421052631579,87.125,3485,58.083333333333336,8000000000,137.73314203730274
593,9,4,13,45.61538461538461,148.25,2965,49.416666666666664,4000000000,80.94435075885329
1054,20,3,23,45.82608695652174,351.3333333333333,5270,87.83333333333333,3000000000,34.15559772296015
638,15,4,19,33.578947368421055,159.5,3190,53.166666666666664,4000000000,75.23510971786834
561,11,3,14,40.07142857142857,187,2805,46.75,3000000000,64.171122994652407
871,20,3,23,37.869565217391305,290.3333333333333,4355,72.58333333333333,3000000000,41.33180252583238
597,12,4,16,37.3125,149.25,2985,49.75,4000000000,80.40201005025126
732,9,7,16,45.75,104.57142857142857,3660,61,7000000000,114.75409836065575
679,5,6,11,61.72727272727273,113.16666666666667,3395,56.583333333333336,6000000000,106.03829160530192
1061,10,8,18,58.94444444444444,132.625,5305,88.41666666666667,8000000000,90.48067860508954
950,12,8,20,47.5,118.75,4750,79.16666666666667,8000000000,101.05263157894737
448,9,3,12,37.333333333333336,149.33333333333334,2240,37.333333333333336,3000000000,80.35714285714285
609,13,3,16,38.0625,203,3045,50.75,3000000000,59.11330049261083
311,4,3,7,44.42857142857143,103.66666666666667,1555,25.916666666666668,3000000000,115.75562700964629
713,13,3,16,44.5625,237.66666666666666,3565,59.416666666666664,3000000000,50.490883590462836
759,13,3,16,47.4375,253,3795,63.25,3000000000,47.430830039525695
499,8,3,11,45.36363636363637,166.33333333333334,2495,41.583333333333336,3000000000,72.14428857715431
327,6,3,9,36.333333333333336,109,1635,27.25,3000000000,110.09174311926604
1020,20,3,23,44.34782608695652,340,5100,85,3000000000,35.29411764705882
487,13,3,16,30.4375,162.33333333333334,2435,40.583333333333336,3000000000,73.92197125256672
933,9,6,15,62.2,155.5,4665,77.75,6000000000,77.17041800643086
241,5,3,8,30.125,80.33333333333333,1205,20.083333333333332,3000000000,149.37759336099586
792,12,3,15,52.8,264,3960,66,3000000000,45.45454545454545
974,21,3,24,40.583333333333336,324.6666666666667,4870,81.16666666666667,3000000000,36.96098562628336
190,4,3,7,27.142857142857142,63.333333333333336,950,15.833333333333334,3000000000,189.47368421052633
829,16,3,19,43.63157894736842,276.3333333333333,4145,69.08333333333333,3000000000,43.42581423401689
569,7,4,11,51.72727272727273,142.25,2845,47.416666666666664,4000000000,84.3585237258348
895,17,8,25,35.8,111.875,4475,74.58333333333333,8000000000,107.26256983240225
1027,11,6,17,60.411764705882355,171.16666666666666,5135,85.58333333333333,6000000000,70.10710808179162
270,5,4,9,30,67.5,1350,22.5,4000000000,177.7777777777778
565,9,3,12,47.083333333333336,188.33333333333334,2825,47.083333333333336,3000000000,63.716814159292035
1213,19,3,22,55.13636363636363,404.3333333333333,6065,101.08333333333333,3000000000,29.67848309975268
403,5,3,8,50.375,134.33333333333334,2015,33.583333333333336,3000000000,89.33002481389578
833,16,3,19,43.8421052631579,277.6666666666667,4165,69.41666666666667,3000000000,43.2172869147659
1502,24,12,36,41.72222222222222,125.16666666666667,7510,125.16666666666667,12000000000,95.87217043941412
875,11,8,19,46.05263157894737,109.375,4375,72.91666666666667,8000000000,109.71428571428571
1141,24,3,27,42.25925925925926,380.3333333333333,5705,95.08333333333333,3000000000,31.551270815074496
734,10,8,18,40.77777777777778,91.75,3670,61.166666666666664,8000000000,130.79019073569484
337,5,3,8,42.125,112.33333333333333,1685,28.083333333333332,3000000000,106.82492581602374
505,9,5,14,36.07142857142857,101,2525,42.083333333333336,5000000000,118.8118811881188
388,7,3,10,38.8,129.33333333333334,1940,32.333333333333336,3000000000,92.78350515463917
804,12,4,16,50.25,201,4020,67,4000000000,59.701492537313435
612,13,6,19,32.21052631578947,102,3060,51,6000000000,117.6470588235294
506,6,4,10,50.6,126.5,2530,42.166666666666664,4000000000,94.86166007905139
345,6,3,9,38.333333333333336,115,1725,28.75,3000000000,104.34782608695652
406,5,4,9,45.111111111111114,101.5,2030,33.833333333333336,4000000000,118.22660098522167
1084,18,3,21,51.61904761904762,361.3333333333333,5420,90.33333333333333,3000000000,33.210332103321036
517,7,3,10,51.7,172.33333333333334,2585,43.083333333333336,3000000000,69.63249516441006
670,12,3,15,44.666666666666664,223.33333333333334,3350,55.833333333333336,3000000000,53.731343283582085
222,4,3,7,31.714285714285715,74,1110,18.5,3000000000,162.16216216216216
662,9,3,12,55.166666666666664,220.66666666666666,3310,55.166666666666664,3000000000,54.38066465256797
483,13,3,16,30.1875,161,2415,40.25,3000000000,74.53416149068323
389,6,4,10,38.9,97.25,1945,32.416666666666664,4000000000,123.39331619537276
531,9,3,12,44.25,177,2655,44.25,3000000000,67.79661016949153
716,14,3,17,42.11764705882353,238.66666666666666,3580,59.666666666666664,3000000000,50.27932960893855
704,13,3,16,44,234.66666666666666,3520,58.666666666666664,3000000000,51.13636363636364
429,8,4,12,35.75,107.25,2145,35.75,4000000000,111.8881118881119
425,7,4,11,38.63636363636363,106.25,2125,35.416666666666664,4000000000,112.94117647058823
505,11,3,14,36.07142857142857,168.33333333333334,2525,42.083333333333336,3000000000,71.28712871287128
605,8,8,16,37.8125,75.625,3025,50.416666666666664,8000000000,158.67768595041323
385,9,3,12,32.083333333333336,128.33333333333334,1925,32.083333333333336,3000000000,93.5064935064935
665,14,4,18,36.94444444444444,166.25,3325,55.416666666666664,4000000000,72.18045112781955
545,8,3,11,49.54545454545455,181.66666666666666,2725,45.416666666666664,3000000000,66.05504587155963
630,8,4,12,52.5,157.5,3150,52.5,4000000000,76.19047619047619
524,6,7,13,40.30769230769231,74.85714285714286,2620,43.666666666666664,7000000000,160.3053435114504
534,11,5,16,33.375,106.8,2670,44.5,5000000000,112.35955056179775
401,6,3,9,44.55555555555556,133.66666666666666,2005,33.416666666666664,3000000000,89.77556109725687
1173,17,7,24,48.875,167.57142857142858,5865,97.75,7000000000,71.61125319693095
588,8,5,13,45.23076923076923,117.6,2940,49,5000000000,102.0408163265306
741,14,5,19,39,148.2,3705,61.75,5000000000,80.97165991902834
512,12,3,15,34.13333333333333,170.66666666666666,2560,42.666666666666664,3000000000,70.3125
430,5,3,8,53.75,143.33333333333334,2150,35.833333333333336,3000000000,83.72093023255813
578,6,8,14,41.285714285714285,72.25,2890,48.166666666666664,8000000000,166.0899653979239
610,11,3,14,43.57142857142857,203.33333333333334,3050,50.833333333333336,3000000000,59.01639344262294
527,8,5,13,40.53846153846154,105.4,2635,43.916666666666664,5000000000,113.85199240986718
438,6,3,9,48.666666666666664,146,2190,36.5,3000000000,82.1917808219178
762,14,4,18,42.333333333333336,190.5,3810,63.5,4000000000,62.99212598425197
962,9,3,12,80.16666666666667,320.6666666666667,4810,80.16666666666667,3000000000,37.42203742203742
973,20,9,29,33.55172413793103,108.11111111111111,4865,81.08333333333333,9000000000,110.99691675231243
732,17,3,20,36.6,244,3660,61,3000000000,49.18032786885246
377,6,5,11,34.27272727272727,75.4,1885,31.416666666666668,5000000000,159.15119363395226
687,10,4,14,49.07142857142857,171.75,3435,57.25,4000000000,69.86899563318777
709,9,3,12,59.083333333333336,236.33333333333334,3545,59.083333333333336,3000000000,50.77574047954865
324,5,3,8,40.5,108,1620,27,3000000000,111.1111111111111
261,4,3,7,37.285714285714285,87,1305,21.75,3000000000,137.9310344827586
791,13,3,16,49.4375,263.6666666666667,3955,65.91666666666667,3000000000,45.51201011378002
408,5,3,8,51,136,2040,34,3000000000,88.23529411764706
692,7,3,10,69.2,230.66666666666666,3460,57.666666666666664,3000000000,52.02312138728323
1064,20,3,23,46.26086956521739,354.6666666666667,5320,88.66666666666667,3000000000,33.83458646616541
474,4,3,7,67.71428571428571,158,2370,39.5,3000000000,75.94936708860759
259,5,3,8,32.375,86.33333333333333,1295,21.583333333333332,3000000000,138.996138996139
289,3,4,7,41.285714285714285,72.25,1445,24.083333333333332,4000000000,166.0899653979239
776,8,5,13,59.69230769230769,155.2,3880,64.66666666666667,5000000000,77.31958762886597
682,10,3,13,52.46153846153846,227.33333333333334,3410,56.833333333333336,3000000000,52.785923753665685
977,16,5,21,46.523809523809526,195.4,4885,81.41666666666667,5000000000,61.41248720573183
574,9,3,12,47.833333333333336,191.33333333333334,2870,47.833333333333336,3000000000,62.7177700348432
608,10,5,15,40.53333333333333,121.6,3040,50.666666666666664,5000000000,98.6842105263158
448,4,3,7,64,149.33333333333334,2240,37.333333333333336,3000000000,80.35714285714285
434,7,3,10,43.4,144.66666666666666,2170,36.166666666666664,3000000000,82.94930875576037
628,13,3,16,39.25,209.33333333333334,3140,52.333333333333336,3000000000,57.324840764331206
640,15,5,20,32,128,3200,53.333333333333336,5000000000,93.75
630,11,3,14,45,210,3150,52.5,3000000000,57.14285714285714
389,7,3,10,38.9,129.66666666666666,1945,32.416666666666664,3000000000,92.54498714652956
784,11,3,14,56,261.3333333333333,3920,65.33333333333333,3000000000,45.91836734693878
1040,21,12,33,31.515151515151516,86.66666666666667,5200,86.66666666666667,12000000000,138.46153846153845
326,8,3,11,29.636363636363637,108.66666666666667,1630,27.166666666666668,3000000000,110.42944785276073
1029,15,5,20,51.45,205.8,5145,85.75,5000000000,58.309037900874635
673,10,3,13,51.76923076923077,224.33333333333334,3365,56.083333333333336,3000000000,53.49182763744428
512,9,3,12,42.666666666666664,170.66666666666666,2560,42.666666666666664,3000000000,70.3125
797,12,3,15,53.13333333333333,265.6666666666667,3985,66.41666666666667,3000000000,45.1693851944793
903,20,5,25,36.12,180.6,4515,75.25,5000000000,66.44518272425249
425,9,3,12,35.416666666666664,141.66666666666666,2125,35.416666666666664,3000000000,84.70588235294119
590,11,4,15,39.333333333333336,147.5,2950,49.166666666666664,4000000000,81.35593220338984
441,6,4,10,44.1,110.25,2205,36.75,4000000000,108.843537414966
477,7,4,11,43.36363636363637,119.25,2385,39.75,4000000000,100.62893081761007
1330,22,3,25,53.2,443.3333333333333,6650,110.83333333333333,3000000000,27.06766917293233
931,8,6,14,66.5,155.16666666666666,4655,77.58333333333333,6000000000,77.33619763694952
560,10,5,15,37.333333333333336,112,2800,46.666666666666664,5000000000,107.14285714285715
497,5,4,9,55.22222222222222,124.25,2485,41.416666666666664,4000000000,96.57947686116701
351,4,3,7,50.142857142857146,117,1755,29.25,3000000000,102.56410256410255
1334,23,10,33,40.42424242424242,133.4,6670,111.16666666666667,10000000000,89.95502248875562
589,7,7,14,42.07142857142857,84.14285714285714,2945,49.083333333333336,7000000000,142.61460101867573
400,6,3,9,44.44444444444444,133.33333333333334,2000,33.333333333333336,3000000000,90
406,5,3,8,50.75,135.33333333333334,2030,33.833333333333336,3000000000,88.66995073891624
936,13,4,17,55.05882352941177,234,4680,78,4000000000,51.28205128205128
496,12,5,17,29.176470588235293,99.2,2480,41.333333333333336,5000000000,120.96774193548386
707,14,3,17,41.588235294117645,235.66666666666666,3535,58.916666666666664,3000000000,50.91937765205092
678,13,3,16,42.375,226,3390,56.5,3000000000,53.097345132743364
692,16,6,22,31.454545454545453,115.33333333333333,3460,57.666666666666664,6000000000,104.04624277456647
824,14,4,18,45.77777777777778,206,4120,68.66666666666667,4000000000,58.252427184466015
985,17,7,24,41.041666666666664,140.71428571428572,4925,82.08333333333333,7000000000,85.2791878172589
501,8,5,13,38.53846153846154,100.2,2505,41.75,5000000000,119.76047904191616
564,8,7,15,37.6,80.57142857142857,2820,47,7000000000,148.93617021276597
511,10,3,13,39.30769230769231,170.33333333333334,2555,42.583333333333336,3000000000,70.45009784735812
372,4,3,7,53.142857142857146,124,1860,31,3000000000,96.77419354838709
388,7,6,13,29.846153846153847,64.66666666666667,1940,32.333333333333336,6000000000,185.56701030927834
213,4,3,7,30.428571428571427,71,1065,17.75,3000000000,169.01408450704227
491,4,6,10,49.1,81.83333333333333,2455,40.916666666666664,6000000000,146.63951120162935
1674,18,8,26,64.38461538461539,209.25,8370,139.5,8000000000,57.34767025089606
264,7,4,11,24,66,1320,22,4000000000,181.8181818181818
1261,22,5,27,46.7037037037037,252.2,6305,105.08333333333333,5000000000,47.58128469468676
566,6,4,10,56.6,141.5,2830,47.166666666666664,4000000000,84.80565371024736
264,7,3,10,26.4,88,1320,22,3000000000,136.36363636363637
192,5,3,8,24,64,960,16,3000000000,187.5
345,8,3,11,31.363636363636363,115,1725,28.75,3000000000,104.34782608695652
389,6,3,9,43.22222222222222,129.66666666666666,1945,32.416666666666664,3000000000,92.54498714652956
1370,15,9,24,57.083333333333336,152.22222222222223,6850,114.16666666666667,9000000000,78.83211678832117
991,17,3,20,49.55,330.3333333333333,4955,82.58333333333333,3000000000,36.326942482341074
693,12,3,15,46.2,231,3465,57.75,3000000000,51.94805194805195
303,4,3,7,43.285714285714285,101,1515,25.25,3000000000,118.81188118811882
857,14,3,17,50.411764705882355,285.6666666666667,4285,71.41666666666667,3000000000,42.00700116686114
910,8,10,18,50.55555555555556,91,4550,75.83333333333333,10000000000,131.86813186813188
518,10,3,13,39.84615384615385,172.66666666666666,2590,43.166666666666664,3000000000,69.4980694980695
879,22,3,25,35.16,293,4395,73.25,3000000000,40.955631399317404
328,6,4,10,32.8,82,1640,27.333333333333332,4000000000,146.34146341463415
672,16,9,25,26.88,74.66666666666667,3360,56,9000000000,160.7142857142857
500,6,3,9,55.55555555555556,166.66666666666666,2500,41.666666666666664,3000000000,72
576,12,3,15,38.4,192,2880,48,3000000000,62.5
415,7,3,10,41.5,138.33333333333334,2075,34.583333333333336,3000000000,86.74698795180721
421,6,6,12,35.083333333333336,70.16666666666667,2105,35.083333333333336,6000000000,171.021377672209
519,7,4,11,47.18181818181818,129.75,2595,43.25,4000000000,92.48554913294798
660,6,12,18,36.666666666666664,55,3300,55,12000000000,218.1818181818182
1055,11,6,17,62.05882352941177,175.83333333333334,5275,87.91666666666667,6000000000,68.24644549763033
471,9,3,12,39.25,157,2355,39.25,3000000000,76.43312101910828
1159,15,13,28,41.392857142857146,89.15384615384616,5795,96.58333333333333,13000000000,134.59879206212253
660,9,3,12,55,220,3300,55,3000000000,54.54545454545455
717,10,9,19,37.73684210526316,79.66666666666667,3585,59.75,9000000000,150.62761506276152
715,14,3,17,42.05882352941177,238.33333333333334,3575,59.583333333333336,3000000000,50.34965034965035
735,12,3,15,49,245,3675,61.25,3000000000,48.9795918367347
524,7,8,15,34.93333333333333,65.5,2620,43.666666666666664,8000000000,183.206106870229
1398,19,14,33,42.36363636363637,99.85714285714286,6990,116.5,14000000000,120.17167381974248
515,9,3,12,42.916666666666664,171.66666666666666,2575,42.916666666666664,3000000000,69.90291262135923
581,10,3,13,44.69230769230769,193.66666666666666,2905,48.416666666666664,3000000000,61.96213425129088
578,7,3,10,57.8,192.66666666666666,2890,48.166666666666664,3000000000,62.28373702422146
657,10,3,13,50.53846153846154,219,3285,54.75,3000000000,54.79452054794521
441,6,3,9,49,147,2205,36.75,3000000000,81.63265306122449
667,12,4,16,41.6875,166.75,3335,55.583333333333336,4000000000,71.9640179910045
610,9,5,14,43.57142857142857,122,3050,50.833333333333336,5000000000,98.36065573770492
839,14,7,21,39.95238095238095,119.85714285714286,4195,69.91666666666667,7000000000,100.11918951132299
644,7,3,10,64.4,214.66666666666666,3220,53.666666666666664,3000000000,55.90062111801243
496,4,5,9,55.111111111111114,99.2,2480,41.333333333333336,5000000000,120.96774193548386
514,16,6,22,23.363636363636363,85.66666666666667,2570,42.833333333333336,6000000000,140.07782101167317
760,14,3,17,44.705882352941174,253.33333333333334,3800,63.333333333333336,3000000000,47.36842105263158
794,15,4,19,41.78947368421053,198.5,3970,66.16666666666667,4000000000,60.45340050377833
862,15,3,18,47.888888888888886,287.3333333333333,4310,71.83333333333333,3000000000,41.76334106728539
235,7,4,11,21.363636363636363,58.75,1175,19.583333333333332,4000000000,204.2553191489362
217,8,3,11,19.727272727272727,72.33333333333333,1085,18.083333333333332,3000000000,165.89861751152074
507,6,4,10,50.7,126.75,2535,42.25,4000000000,94.67455621301775
398,7,3,10,39.8,132.66666666666666,1990,33.166666666666664,3000000000,90.45226130653266
447,4,5,9,49.666666666666664,89.4,2235,37.25,5000000000,134.2281879194631
385,7,7,14,27.5,55,1925,32.083333333333336,7000000000,218.18181818181816
599,12,3,15,39.93333333333333,199.66666666666666,2995,49.916666666666664,3000000000,60.10016694490819
505,9,3,12,42.083333333333336,168.33333333333334,2525,42.083333333333336,3000000000,71.28712871287128
631,6,4,10,63.1,157.75,3155,52.583333333333336,4000000000,76.06973058637084
659,13,3,16,41.1875,219.66666666666666,3295,54.916666666666664,3000000000,54.628224582701066
702,15,9,24,29.25,78,3510,58.5,9000000000,153.84615384615387
695,12,3,15,46.333333333333336,231.66666666666666,3475,57.916666666666664,3000000000,51.79856115107914
557,5,5,10,55.7,111.4,2785,46.416666666666664,5000000000,107.71992818671454
700,14,5,19,36.8421052631579,140,3500,58.333333333333336,5000000000,85.71428571428572
641,9,4,13,49.30769230769231,160.25,3205,53.416666666666664,4000000000,74.88299531981279
369,7,3,10,36.9,123,1845,30.75,3000000000,97.5609756097561
453,10,3,13,34.84615384615385,151,2265,37.75,3000000000,79.47019867549669
1181,13,7,20,59.05,168.71428571428572,5905,98.41666666666667,7000000000,71.12616426756985
1021,21,3,24,42.541666666666664,340.3333333333333,5105,85.08333333333333,3000000000,35.259549461312446
271,4,3,7,38.714285714285715,90.33333333333333,1355,22.583333333333332,3000000000,132.84132841328415
739,4,6,10,73.9,123.16666666666667,3695,61.583333333333336,6000000000,97.42895805142084
252,6,3,9,28,84,1260,21,3000000000,142.85714285714286
848,17,7,24,35.333333333333336,121.14285714285714,4240,70.66666666666667,7000000000,99.0566037735849
553,8,4,12,46.083333333333336,138.25,2765,46.083333333333336,4000000000,86.79927667269439
631,14,4,18,35.05555555555556,157.75,3155,52.583333333333336,4000000000,76.06973058637084
584,6,6,12,48.666666666666664,97.33333333333333,2920,48.666666666666664,6000000000,123.28767123287672
312,4,3,7,44.57142857142857,104,1560,26,3000000000,115.38461538461539
1004,15,3,18,55.77777777777778,334.6666666666667,5020,83.66666666666667,3000000000,35.85657370517928
640,11,3,14,45.714285714285715,213.33333333333334,3200,53.333333333333336,3000000000,56.25
308,3,4,7,44,77,1540,25.666666666666668,4000000000,155.84415584415584
254,7,3,10,25.4,84.66666666666667,1270,21.166666666666668,3000000000,141.7322834645669
1048,15,3,18,58.22222222222222,349.3333333333333,5240,87.33333333333333,3000000000,34.351145038167935
756,15,3,18,42,252,3780,63,3000000000,47.61904761904762
204,5,3,8,25.5,68,1020,17,3000000000,176.47058823529412
574,8,3,11,52.18181818181818,191.33333333333334,2870,47.833333333333336,3000000000,62.7177700348432
456,9,3,12,38,152,2280,38,3000000000,78.94736842105263
552,13,4,17,32.470588235294116,138,2760,46,4000000000,86.95652173913044
411,4,5,9,45.666666666666664,82.2,2055,34.25,5000000000,145.98540145985402
577,9,7,16,36.0625,82.42857142857143,2885,48.083333333333336,7000000000,145.580589254766
637,10,5,15,42.46666666666667,127.4,3185,53.083333333333336,5000000000,94.19152276295132
674,13,6,19,35.473684210526315,112.33333333333333,3370,56.166666666666664,6000000000,106.82492581602374
1446,24,3,27,53.55555555555556,482,7230,120.5,3000000000,24.896265560165975
514,7,5,12,42.833333333333336,102.8,2570,42.833333333333336,5000000000,116.73151750972762
848,12,5,17,49.88235294117647,169.6,4240,70.66666666666667,5000000000,70.75471698113208
599,10,3,13,46.07692307692308,199.66666666666666,2995,49.916666666666664,3000000000,60.10016694490819
242,3,4,7,34.57142857142857,60.5,1210,20.166666666666668,4000000000,198.3471074380165
456,4,7,11,41.45454545454545,65.14285714285714,2280,38,7000000000,184.21052631578945
559,10,4,14,39.92857142857143,139.75,2795,46.583333333333336,4000000000,85.86762075134168
464,9,3,12,38.666666666666664,154.66666666666666,2320,38.666666666666664,3000000000,77.58620689655173
745,8,3,11,67.72727272727273,248.33333333333334,3725,62.083333333333336,3000000000,48.32214765100671
342,3,3,6,57,114,1710,28.5,3000000000,105.26315789473684
949,13,6,19,49.94736842105263,158.16666666666666,4745,79.08333333333333,6000000000,75.86933614330874
1033,15,7,22,46.95454545454545,147.57142857142858,5165,86.08333333333333,7000000000,81.31655372700871
546,15,5,20,27.3,109.2,2730,45.5,5000000000,109.8901098901099
699,12,3,15,46.6,233,3495,58.25,3000000000,51.50214592274678
788,13,8,21,37.523809523809526,98.5,3940,65.66666666666667,8000000000,121.82741116751268
663,10,3,13,51,221,3315,55.25,3000000000,54.29864253393665
529,10,3,13,40.69230769230769,176.33333333333334,2645,44.083333333333336,3000000000,68.05293005671076
503,5,4,9,55.888888888888886,125.75,2515,41.916666666666664,4000000000,95.42743538767395
1148,18,3,21,54.666666666666664,382.6666666666667,5740,95.66666666666667,3000000000,31.3588850174216
415,4,4,8,51.875,103.75,2075,34.583333333333336,4000000000,115.66265060240963
441,3,3,6,73.5,147,2205,36.75,3000000000,81.63265306122449
619,10,3,13,47.61538461538461,206.33333333333334,3095,51.583333333333336,3000000000,58.158319870759286
485,6,4,10,48.5,121.25,2425,40.416666666666664,4000000000,98.96907216494846
367,7,6,13,28.23076923076923,61.166666666666664,1835,30.583333333333332,6000000000,196.18528610354224
1272,20,12,32,39.75,106,6360,106,12000000000,113.20754716981132
529,8,7,15,35.266666666666666,75.57142857142857,2645,44.083333333333336,7000000000,158.79017013232513
620,4,7,11,56.36363636363637,88.57142857142857,3100,51.666666666666664,7000000000,135.48387096774195
724,12,3,15,48.266666666666666,241.33333333333334,3620,60.333333333333336,3000000000,49.72375690607735
676,10,3,13,52,225.33333333333334,3380,56.333333333333336,3000000000,53.25443786982248
616,10,3,13,47.38461538461539,205.33333333333334,3080,51.333333333333336,3000000000,58.441558441558435
774,13,7,20,38.7,110.57142857142857,3870,64.5,7000000000,108.52713178294573
406,10,3,13,31.23076923076923,135.33333333333334,2030,33.833333333333336,3000000000,88.66995073891624
287,5,5,10,28.7,57.4,1435,23.916666666666668,5000000000,209.05923344947735
550,15,4,19,28.94736842105263,137.5,2750,45.833333333333336,4000000000,87.27272727272727
816,17,3,20,40.8,272,4080,68,3000000000,44.11764705882353
843,11,3,14,60.214285714285715,281,4215,70.25,3000000000,42.704626334519574
253,3,3,6,42.166666666666664,84.33333333333333,1265,21.083333333333332,3000000000,142.2924901185771
504,8,3,11,45.81818181818182,168,2520,42,3000000000,71.42857142857143
937,14,3,17,55.11764705882353,312.3333333333333,4685,78.08333333333333,3000000000,38.4204909284952
1485,25,8,33,45,185.625,7425,123.75,8000000000,64.64646464646465
1091,9,12,21,51.95238095238095,90.91666666666667,5455,90.91666666666667,12000000000,131.98900091659027
772,12,4,16,48.25,193,3860,64.33333333333333,4000000000,62.17616580310881
464,11,3,14,33.142857142857146,154.66666666666666,2320,38.666666666666664,3000000000,77.58620689655173
782,11,3,14,55.857142857142854,260.6666666666667,3910,65.16666666666667,3000000000,46.03580562659846
588,9,8,17,34.588235294117645,73.5,2940,49,8000000000,163.26530612244898
773,14,3,17,45.470588235294116,257.6666666666667,3865,64.41666666666667,3000000000,46.57179818887451
916,16,8,24,38.166666666666664,114.5,4580,76.33333333333333,8000000000,104.80349344978167
416,8,3,11,37.81818181818182,138.66666666666666,2080,34.666666666666664,3000000000,86.53846153846155
773,9,3,12,64.41666666666667,257.6666666666667,3865,64.41666666666667,3000000000,46.57179818887451
730,15,3,18,40.55555555555556,243.33333333333334,3650,60.833333333333336,3000000000,49.31506849315068
438,10,5,15,29.2,87.6,2190,36.5,5000000000,136.986301369863
809,23,3,26,31.115384615384617,269.6666666666667,4045,67.41666666666667,3000000000,44.499381953028426
632,9,3,12,52.666666666666664,210.66666666666666,3160,52.666666666666664,3000000000,56.9620253164557
930,18,3,21,44.285714285714285,310,4650,77.5,3000000000,38.70967741935484
547,8,3,11,49.72727272727273,182.33333333333334,2735,45.583333333333336,3000000000,65.81352833638024
484,6,3,9,53.77777777777778,161.33333333333334,2420,40.333333333333336,3000000000,74.3801652892562
751,7,6,13,57.76923076923077,125.16666666666667,3755,62.583333333333336,6000000000,95.87217043941412
1160,20,5,25,46.4,232,5800,96.66666666666667,5000000000,51.724137931034484
830,15,7,22,37.72727272727273,118.57142857142857,4150,69.16666666666667,7000000000,101.20481927710843
351,4,3,7,50.142857142857146,117,1755,29.25,3000000000,102.56410256410255
611,17,7,24,25.458333333333332,87.28571428571429,3055,50.916666666666664,7000000000,137.4795417348609
661,9,7,16,41.3125,94.42857142857143,3305,55.083333333333336,7000000000,127.08018154311648
813,20,3,23,35.34782608695652,271,4065,67.75,3000000000,44.28044280442804
336,6,6,12,28,56,1680,28,6000000000,214.2857142857143
811,12,6,18,45.05555555555556,135.16666666666666,4055,67.58333333333333,6000000000,88.77928483353884
337,7,3,10,33.7,112.33333333333333,1685,28.083333333333332,3000000000,106.82492581602374
187,5,3,8,23.375,62.333333333333336,935,15.583333333333334,3000000000,192.5133689839572
755,6,6,12,62.916666666666664,125.83333333333333,3775,62.916666666666664,6000000000,95.36423841059603
636,5,6,11,57.81818181818182,106,3180,53,6000000000,113.20754716981132
370,7,3,10,37,123.33333333333333,1850,30.833333333333332,3000000000,97.2972972972973
755,13,3,16,47.1875,251.66666666666666,3775,62.916666666666664,3000000000,47.682119205298015
627,11,3,14,44.785714285714285,209,3135,52.25,3000000000,57.41626794258373
771,11,4,15,51.4,192.75,3855,64.25,4000000000,62.2568093385214
696,12,3,15,46.4,232,3480,58,3000000000,51.724137931034484
1786,33,3,36,49.611111111111114,595.3333333333334,8930,148.83333333333334,3000000000,20.15677491601344
904,11,3,14,64.57142857142857,301.3333333333333,4520,75.33333333333333,3000000000,39.823008849557525
358,10,4,14,25.571428571428573,89.5,1790,29.833333333333332,4000000000,134.0782122905028
561,10,3,13,43.15384615384615,187,2805,46.75,3000000000,64.171122994652407
610,9,5,14,43.57142857142857,122,3050,50.833333333333336,5000000000,98.36065573770492
1281,18,7,25,51.24,183,6405,106.75,7000000000,65.57377049180329
727,9,7,16,45.4375,103.85714285714286,3635,60.583333333333336,7000000000,115.5433287482806
242,4,3,7,34.57142857142857,80.66666666666667,1210,20.166666666666668,3000000000,148.7603305785124
768,13,3,16,48,256,3840,64,3000000000,46.875
752,17,3,20,37.6,250.66666666666666,3760,62.666666666666664,3000000000,47.87234042553192
717,21,3,24,29.875,239,3585,59.75,3000000000,50.2092050209205
695,9,8,17,40.88235294117647,86.875,3475,57.916666666666664,8000000000,138.12949640287772
129,3,3,6,21.5,43,645,10.75,3000000000,279.06976744186045
1271,14,3,17,74.76470588235294,423.6666666666667,6355,105.91666666666667,3000000000,28.324154209284025
715,15,7,22,32.5,102.14285714285714,3575,59.583333333333336,7000000000,117.48251748251748
247,4,5,9,27.444444444444443,49.4,1235,20.583333333333332,5000000000,242.91497975708504
994,8,7,15,66.26666666666667,142,4970,82.83333333333333,7000000000,84.50704225352113
557,12,3,15,37.13333333333333,185.66666666666666,2785,46.416666666666664,3000000000,64.63195691202873
465,8,5,13,35.76923076923077,93,2325,38.75,5000000000,129.03225806451613
694,8,3,11,63.09090909090909,231.33333333333334,3470,57.833333333333336,3000000000,51.87319884726225
703,13,3,16,43.9375,234.33333333333334,3515,58.583333333333336,3000000000,51.209103840682786
585,11,4,15,39,146.25,2925,48.75,4000000000,82.05128205128204
692,15,3,18,38.44444444444444,230.66666666666666,3460,57.666666666666664,3000000000,52.02312138728323
348,6,3,9,38.666666666666664,116,1740,29,3000000000,103.44827586206897
750,12,3,15,50,250,3750,62.5,3000000000,48
565,8,4,12,47.083333333333336,141.25,2825,47.083333333333336,4000000000,84.95575221238938
535,8,4,12,44.583333333333336,133.75,2675,44.583333333333336,4000000000,89.7196261682243
617,8,7,15,41.13333333333333,88.14285714285714,3085,51.416666666666664,7000000000,136.1426256077796
379,5,5,10,37.9,75.8,1895,31.583333333333332,5000000000,158.311345646438
691,6,5,11,62.81818181818182,138.2,3455,57.583333333333336,5000000000,86.83068017366135
512,6,7,13,39.38461538461539,73.14285714285714,2560,42.666666666666664,7000000000,164.0625
306,6,3,9,34,102,1530,25.5,3000000000,117.6470588235294
375,6,3,9,41.666666666666664,125,1875,31.25,3000000000,96
719,15,5,20,35.95,143.8,3595,59.916666666666664,5000000000,83.44923504867873
642,19,5,24,26.75,128.4,3210,53.5,5000000000,93.45794392523365
1082,11,4,15,72.13333333333334,270.5,5410,90.16666666666667,4000000000,44.362292051756
704,16,6,22,32,117.33333333333333,3520,58.666666666666664,6000000000,102.27272727272728
514,5,3,8,64.25,171.33333333333334,2570,42.833333333333336,3000000000,70.03891050583658
587,9,4,13,45.15384615384615,146.75,2935,48.916666666666664,4000000000,81.77172061328791
961,17,8,25,38.44,120.125,4805,80.08333333333333,8000000000,99.89594172736733
280,4,3,7,40,93.33333333333333,1400,23.333333333333332,3000000000,128.57142857142858
267,4,3,7,38.142857142857146,89,1335,22.25,3000000000,134.83146067415728
945,20,3,23,41.08695652173913,315,4725,78.75,3000000000,38.095238095238095
712,7,5,12,59.333333333333336,142.4,3560,59.333333333333336,5000000000,84.26966292134831
438,7,4,11,39.81818181818182,109.5,2190,36.5,4000000000,109.58904109589042
1207,14,11,25,48.28,109.72727272727273,6035,100.58333333333333,11000000000,109.36205468102736
298,7,3,10,29.8,99.33333333333333,1490,24.833333333333332,3000000000,120.8053691275168
673,11,3,14,48.07142857142857,224.33333333333334,3365,56.083333333333336,3000000000,53.49182763744428
720,12,4,16,45,180,3600,60,4000000000,66.66666666666666
683,15,3,18,37.94444444444444,227.66666666666666,3415,56.916666666666664,3000000000,52.7086383601757
832,12,5,17,48.94117647058823,166.4,4160,69.33333333333333,5000000000,72.11538461538463
656,10,3,13,50.46153846153846,218.66666666666666,3280,54.666666666666664,3000000000,54.8780487804878
924,12,6,18,51.333333333333336,154,4620,77,6000000000,77.92207792207792
833,9,3,12,69.41666666666667,277.6666666666667,4165,69.41666666666667,3000000000,43.2172869147659
677,7,6,13,52.07692307692308,112.83333333333333,3385,56.416666666666664,6000000000,106.35155096011817
349,4,3,7,49.857142857142854,116.33333333333333,1745,29.083333333333332,3000000000,103.1518624641834
404,6,3,9,44.888888888888886,134.66666666666666,2020,33.666666666666664,3000000000,89.10891089108911
961,16,3,19,50.578947368421055,320.3333333333333,4805,80.08333333333333,3000000000,37.46097814776275
675,12,6,18,37.5,112.5,3375,56.25,6000000000,106.66666666666667
561,10,7,17,33,80.14285714285714,2805,46.75,7000000000,149.73262032085563
752,6,5,11,68.36363636363636,150.4,3760,62.666666666666664,5000000000,79.7872340425532
1012,12,8,20,50.6,126.5,5060,84.33333333333333,8000000000,94.86166007905139
985,13,7,20,49.25,140.71428571428572,4925,82.08333333333333,7000000000,85.2791878172589
271,3,3,6,45.166666666666664,90.33333333333333,1355,22.583333333333332,3000000000,132.84132841328415
455,7,4,11,41.36363636363637,113.75,2275,37.916666666666664,4000000000,105.49450549450549
134,4,3,7,19.142857142857142,44.666666666666664,670,11.166666666666666,3000000000,268.65671641791045
280,4,3,7,40,93.33333333333333,1400,23.333333333333332,3000000000,128.57142857142858
768,11,3,14,54.857142857142854,256,3840,64,3000000000,46.875
531,12,3,15,35.4,177,2655,44.25,3000000000,67.79661016949153
1212,18,3,21,57.714285714285715,404,6060,101,3000000000,29.702970297029704
1072,12,3,15,71.46666666666667,357.3333333333333,5360,89.33333333333333,3000000000,33.582089552238806
244,3,3,6,40.666666666666664,81.33333333333333,1220,20.333333333333332,3000000000,147.5409836065574
655,12,3,15,43.666666666666664,218.33333333333334,3275,54.583333333333336,3000000000,54.9618320610687
679,7,5,12,56.583333333333336,135.8,3395,56.583333333333336,5000000000,88.36524300441826
364,5,3,8,45.5,121.33333333333333,1820,30.333333333333332,3000000000,98.9010989010989
778,9,3,12,64.83333333333333,259.3333333333333,3890,64.83333333333333,3000000000,46.27249357326478
242,4,3,7,34.57142857142857,80.66666666666667,1210,20.166666666666668,3000000000,148.7603305785124
554,7,3,10,55.4,184.66666666666666,2770,46.166666666666664,3000000000,64.98194945848375
274,5,3,8,34.25,91.33333333333333,1370,22.833333333333332,3000000000,131.38686131386862
291,8,3,11,26.454545454545453,97,1455,24.25,3000000000,123.71134020618557
1613,21,3,24,67.20833333333333,537.6666666666666,8065,134.41666666666666,3000000000,22.31866088034718
522,7,4,11,47.45454545454545,130.5,2610,43.5,4000000000,91.95402298850576
632,7,3,10,63.2,210.66666666666666,3160,52.666666666666664,3000000000,56.9620253164557
430,8,3,11,39.09090909090909,143.33333333333334,2150,35.833333333333336,3000000000,83.72093023255813
503,3,3,6,83.83333333333333,167.66666666666666,2515,41.916666666666664,3000000000,71.57057654075547
412,10,3,13,31.692307692307693,137.33333333333334,2060,34.333333333333336,3000000000,87.37864077669902
672,8,4,12,56,168,3360,56,4000000000,71.42857142857143
241,3,3,6,40.166666666666664,80.33333333333333,1205,20.083333333333332,3000000000,149.37759336099586
563,6,3,9,62.55555555555556,187.66666666666666,2815,46.916666666666664,3000000000,63.94316163410302
530,6,4,10,53,132.5,2650,44.166666666666664,4000000000,90.56603773584906
507,6,3,9,56.333333333333336,169,2535,42.25,3000000000,71.0059171597633
787,10,6,16,49.1875,131.16666666666666,3935,65.58333333333333,6000000000,91.4866581956798
580,13,3,16,36.25,193.33333333333334,2900,48.333333333333336,3000000000,62.068965517241374
616,9,3,12,51.333333333333336,205.33333333333334,3080,51.333333333333336,3000000000,58.441558441558435
191,5,3,8,23.875,63.666666666666664,955,15.916666666666666,3000000000,188.48167539267016
442,6,3,9,49.111111111111114,147.33333333333334,2210,36.833333333333336,3000000000,81.44796380090497
819,9,6,15,54.6,136.5,4095,68.25,6000000000,87.91208791208791
533,8,3,11,48.45454545454545,177.66666666666666,2665,44.416666666666664,3000000000,67.5422138836773
887,13,4,17,52.1764705882353,221.75,4435,73.91666666666667,4000000000,54.11499436302142
374,4,3,7,53.42857142857143,124.66666666666667,1870,31.166666666666668,3000000000,96.2566844919786
426,3,3,6,71,142,2130,35.5,3000000000,84.50704225352113
765,9,7,16,47.8125,109.28571428571429,3825,63.75,7000000000,109.80392156862744
846,9,5,14,60.42857142857143,169.2,4230,70.5,5000000000,70.92198581560284
637,10,3,13,49,212.33333333333334,3185,53.083333333333336,3000000000,56.5149136577708
845,9,6,15,56.333333333333336,140.83333333333334,4225,70.41666666666667,6000000000,85.20710059171597
622,7,5,12,51.833333333333336,124.4,3110,51.833333333333336,5000000000,96.46302250803858
518,10,3,13,39.84615384615385,172.66666666666666,2590,43.166666666666664,3000000000,69.4980694980695
679,3,6,9,75.44444444444444,113.16666666666667,3395,56.583333333333336,6000000000,106.03829160530192
749,10,5,15,49.93333333333333,149.8,3745,62.416666666666664,5000000000,80.10680907877169
632,6,4,10,63.2,158,3160,52.666666666666664,4000000000,75.94936708860759
435,5,6,11,39.54545454545455,72.5,2175,36.25,6000000000,165.51724137931035
435,8,5,13,33.46153846153846,87,2175,36.25,5000000000,137.9310344827586
716,8,7,15,47.733333333333334,102.28571428571429,3580,59.666666666666664,7000000000,117.31843575418995
1082,13,6,19,56.94736842105263,180.33333333333334,5410,90.16666666666667,6000000000,66.54343807763401
717,5,5,10,71.7,143.4,3585,59.75,5000000000,83.68200836820084
620,4,8,12,51.666666666666664,77.5,3100,51.666666666666664,8000000000,154.83870967741936
594,11,3,14,42.42857142857143,198,2970,49.5,3000000000,60.60606060606061
571,10,5,15,38.06666666666667,114.2,2855,47.583333333333336,5000000000,105.07880910683012
363,3,3,6,60.5,121,1815,30.25,3000000000,99.17355371900827
1031,17,5,22,46.86363636363637,206.2,5155,85.91666666666667,5000000000,58.195926285160034
380,6,3,9,42.22222222222222,126.66666666666667,1900,31.666666666666668,3000000000,94.73684210526316
762,6,4,10,76.2,190.5,3810,63.5,4000000000,62.99212598425197
596,10,4,14,42.57142857142857,149,2980,49.666666666666664,4000000000,80.53691275167786
403,5,3,8,50.375,134.33333333333334,2015,33.583333333333336,3000000000,89.33002481389578
538,10,3,13,41.38461538461539,179.33333333333334,2690,44.833333333333336,3000000000,66.91449814126393
449,6,3,9,49.888888888888886,149.66666666666666,2245,37.416666666666664,3000000000,80.1781737193764
689,8,6,14,49.214285714285715,114.83333333333333,3445,57.416666666666664,6000000000,104.49927431059507
729,18,3,21,34.714285714285715,243,3645,60.75,3000000000,49.382716049382715
725,23,5,28,25.892857142857142,145,3625,60.416666666666664,5000000000,82.75862068965517
862,13,3,16,53.875,287.3333333333333,4310,71.83333333333333,3000000000,41.76334106728539
631,10,3,13,48.53846153846154,210.33333333333334,3155,52.583333333333336,3000000000,57.05229793977813
625,16,3,19,32.89473684210526,208.33333333333334,3125,52.083333333333336,3000000000,57.6
504,8,6,14,36,84,2520,42,6000000000,142.85714285714286
718,9,8,17,42.23529411764706,89.75,3590,59.833333333333336,8000000000,133.70473537604457
542,12,4,16,33.875,135.5,2710,45.166666666666664,4000000000,88.5608856088561
764,12,3,15,50.93333333333333,254.66666666666666,3820,63.666666666666664,3000000000,47.12041884816754
843,11,4,15,56.2,210.75,4215,70.25,4000000000,56.93950177935943
172,5,3,8,21.5,57.333333333333336,860,14.333333333333334,3000000000,209.30232558139534
1007,17,3,20,50.35,335.6666666666667,5035,83.91666666666667,3000000000,35.749751737835155
692,7,3,10,69.2,230.66666666666666,3460,57.666666666666664,3000000000,52.02312138728323
717,8,3,11,65.18181818181819,239,3585,59.75,3000000000,50.2092050209205
792,12,3,15,52.8,264,3960,66,3000000000,45.45454545454545
797,8,9,17,46.88235294117647,88.55555555555556,3985,66.41666666666667,9000000000,135.50815558343788
609,7,5,12,50.75,121.8,3045,50.75,5000000000,98.52216748768473
749,5,3,8,93.625,249.66666666666666,3745,62.416666666666664,3000000000,48.06408544726302
681,14,3,17,40.05882352941177,227,3405,56.75,3000000000,52.86343612334802
443,9,3,12,36.916666666666664,147.66666666666666,2215,36.916666666666664,3000000000,81.26410835214448
475,8,3,11,43.18181818181818,158.33333333333334,2375,39.583333333333336,3000000000,75.78947368421052
326,6,3,9,36.22222222222222,108.66666666666667,1630,27.166666666666668,3000000000,110.42944785276073
450,10,3,13,34.61538461538461,150,2250,37.5,3000000000,80
314,5,3,8,39.25,104.66666666666667,1570,26.166666666666668,3000000000,114.64968152866241
636,9,3,12,53,212,3180,53,3000000000,56.60377358490566
712,11,3,14,50.857142857142854,237.33333333333334,3560,59.333333333333336,3000000000,50.561797752808985
830,15,9,24,34.583333333333336,92.22222222222223,4150,69.16666666666667,9000000000,130.12048192771084
117,3,3,6,19.5,39,585,9.75,3000000000,307.69230769230774
571,14,3,17,33.588235294117645,190.33333333333334,2855,47.583333333333336,3000000000,63.047285464098074
795,16,5,21,37.857142857142854,159,3975,66.25,5000000000,75.47169811320755
518,4,4,8,64.75,129.5,2590,43.166666666666664,4000000000,92.66409266409268
478,7,3,10,47.8,159.33333333333334,2390,39.833333333333336,3000000000,75.31380753138075
286,5,3,8,35.75,95.33333333333333,1430,23.833333333333332,3000000000,125.87412587412588
796,15,3,18,44.22222222222222,265.3333333333333,3980,66.33333333333333,3000000000,45.22613065326633
346,7,4,11,31.454545454545453,86.5,1730,28.833333333333332,4000000000,138.72832369942196
1855,15,15,30,61.833333333333336,123.66666666666667,9275,154.58333333333334,15000000000,97.03504043126685
329,3,3,6,54.833333333333336,109.66666666666667,1645,27.416666666666668,3000000000,109.4224924012158
344,7,3,10,34.4,114.66666666666667,1720,28.666666666666668,3000000000,104.65116279069767
572,11,5,16,35.75,114.4,2860,47.666666666666664,5000000000,104.8951048951049
483,6,3,9,53.666666666666664,161,2415,40.25,3000000000,74.53416149068323
611,11,8,19,32.1578947368421,76.375,3055,50.916666666666664,8000000000,157.11947626841243
675,12,11,23,29.347826086956523,61.36363636363637,3375,56.25,11000000000,195.55555555555554
219,3,3,6,36.5,73,1095,18.25,3000000000,164.3835616438356
636,6,3,9,70.66666666666667,212,3180,53,3000000000,56.60377358490566
546,6,3,9,60.666666666666664,182,2730,45.5,3000000000,65.93406593406593
410,8,3,11,37.27272727272727,136.66666666666666,2050,34.166666666666664,3000000000,87.8048780487805
475,6,5,11,43.18181818181818,95,2375,39.583333333333336,5000000000,126.3157894736842
354,7,3,10,35.4,118,1770,29.5,3000000000,101.69491525423729
514,9,3,12,42.833333333333336,171.33333333333334,2570,42.833333333333336,3000000000,70.03891050583658
860,12,4,16,53.75,215,4300,71.66666666666667,4000000000,55.813953488372086
269,4,3,7,38.42857142857143,89.66666666666667,1345,22.416666666666668,3000000000,133.82899628252787
714,7,3,10,71.4,238,3570,59.5,3000000000,50.420168067226896
820,21,3,24,34.166666666666664,273.3333333333333,4100,68.33333333333333,3000000000,43.90243902439025
531,11,7,18,29.5,75.85714285714286,2655,44.25,7000000000,158.19209039548022
468,8,3,11,42.54545454545455,156,2340,39,3000000000,76.92307692307693
766,14,9,23,33.30434782608695,85.11111111111111,3830,63.833333333333336,9000000000,140.99216710182768
827,13,9,22,37.59090909090909,91.88888888888889,4135,68.91666666666667,9000000000,130.5925030229746
961,16,3,19,50.578947368421055,320.3333333333333,4805,80.08333333333333,3000000000,37.46097814776275
830,11,3,14,59.285714285714285,276.6666666666667,4150,69.16666666666667,3000000000,43.37349397590361
672,9,3,12,56,224,3360,56,3000000000,53.57142857142858
411,6,3,9,45.666666666666664,137,2055,34.25,3000000000,87.59124087591242
451,3,5,8,56.375,90.2,2255,37.583333333333336,5000000000,133.03769401330376
709,14,3,17,41.705882352941174,236.33333333333334,3545,59.083333333333336,3000000000,50.77574047954865
346,9,3,12,28.833333333333332,115.33333333333333,1730,28.833333333333332,3000000000,104.04624277456647
571,6,5,11,51.90909090909091,114.2,2855,47.583333333333336,5000000000,105.07880910683012
950,14,3,17,55.88235294117647,316.6666666666667,4750,79.16666666666667,3000000000,37.89473684210526
275,5,3,8,34.375,91.66666666666667,1375,22.916666666666668,3000000000,130.9090909090909
875,16,3,19,46.05263157894737,291.6666666666667,4375,72.91666666666667,3000000000,41.14285714285714
255,8,3,11,23.181818181818183,85,1275,21.25,3000000000,141.17647058823528
792,11,8,19,41.68421052631579,99,3960,66,8000000000,121.21212121212122
687,7,5,12,57.25,137.4,3435,57.25,5000000000,87.33624454148472
248,5,4,9,27.555555555555557,62,1240,20.666666666666668,4000000000,193.54838709677418
508,5,4,9,56.44444444444444,127,2540,42.333333333333336,4000000000,94.48818897637796
335,3,3,6,55.833333333333336,111.66666666666667,1675,27.916666666666668,3000000000,107.46268656716417
666,8,3,11,60.54545454545455,222,3330,55.5,3000000000,54.05405405405405
324,7,3,10,32.4,108,1620,27,3000000000,111.1111111111111
263,5,3,8,32.875,87.66666666666667,1315,21.916666666666668,3000000000,136.88212927756652
721,7,5,12,60.083333333333336,144.2,3605,60.083333333333336,5000000000,83.21775312066575
781,11,6,17,45.94117647058823,130.16666666666666,3905,65.08333333333333,6000000000,92.18950064020488
814,12,4,16,50.875,203.5,4070,67.83333333333333,4000000000,58.968058968058976
850,14,4,18,47.22222222222222,212.5,4250,70.83333333333333,4000000000,56.470588235294116
336,8,4,12,28,84,1680,28,4000000000,142.85714285714286
462,13,3,16,28.875,154,2310,38.5,3000000000,77.92207792207792
822,10,6,16,51.375,137,4110,68.5,6000000000,87.59124087591242
706,9,3,12,58.833333333333336,235.33333333333334,3530,58.833333333333336,3000000000,50.991501416430594
610,11,6,17,35.88235294117647,101.66666666666667,3050,50.833333333333336,6000000000,118.03278688524588
403,11,3,14,28.785714285714285,134.33333333333334,2015,33.583333333333336,3000000000,89.33002481389578
1057,8,9,17,62.1764705882353,117.44444444444444,5285,88.08333333333333,9000000000,102.1759697256386
591,12,3,15,39.4,197,2955,49.25,3000000000,60.91370558375634
1030,17,4,21,49.04761904761905,257.5,5150,85.83333333333333,4000000000,46.601941747572816
486,6,3,9,54,162,2430,40.5,3000000000,74.07407407407408
717,14,4,18,39.833333333333336,179.25,3585,59.75,4000000000,66.94560669456067
493,8,4,12,41.083333333333336,123.25,2465,41.083333333333336,4000000000,97.3630831643002
262,4,3,7,37.42857142857143,87.33333333333333,1310,21.833333333333332,3000000000,137.40458015267174
311,8,6,14,22.214285714285715,51.833333333333336,1555,25.916666666666668,6000000000,231.51125401929258
804,12,4,16,50.25,201,4020,67,4000000000,59.701492537313435
1038,13,6,19,54.63157894736842,173,5190,86.5,6000000000,69.36416184971098
590,11,3,14,42.142857142857146,196.66666666666666,2950,49.166666666666664,3000000000,61.016949152542374
620,7,8,15,41.333333333333336,77.5,3100,51.666666666666664,8000000000,154.83870967741936
476,8,3,11,43.27272727272727,158.66666666666666,2380,39.666666666666664,3000000000,75.63025210084035
566,4,3,7,80.85714285714286,188.66666666666666,2830,47.166666666666664,3000000000,63.60424028268552
257,4,5,9,28.555555555555557,51.4,1285,21.416666666666668,5000000000,233.46303501945525
792,11,7,18,44,113.14285714285714,3960,66,7000000000,106.06060606060606
676,9,3,12,56.333333333333336,225.33333333333334,3380,56.333333333333336,3000000000,53.25443786982248
461,7,3,10,46.1,153.66666666666666,2305,38.416666666666664,3000000000,78.09110629067246
1459,29,8,37,39.432432432432435,182.375,7295,121.58333333333333,8000000000,65.79849211788897
668,8,5,13,51.38461538461539,133.6,3340,55.666666666666664,5000000000,89.82035928143713
759,13,5,18,42.166666666666664,151.8,3795,63.25,5000000000,79.05138339920948
248,4,3,7,35.42857142857143,82.66666666666667,1240,20.666666666666668,3000000000,145.16129032258064
329,9,3,12,27.416666666666668,109.66666666666667,1645,27.416666666666668,3000000000,109.4224924012158
528,11,3,14,37.714285714285715,176,2640,44,3000000000,68.18181818181819
418,5,4,9,46.44444444444444,104.5,2090,34.833333333333336,4000000000,114.83253588516745
896,11,8,19,47.1578947368421,112,4480,74.66666666666667,8000000000,107.14285714285714
211,4,3,7,30.142857142857142,70.33333333333333,1055,17.583333333333332,3000000000,170.61611374407585
636,6,3,9,70.66666666666667,212,3180,53,3000000000,56.60377358490566
544,9,3,12,45.333333333333336,181.33333333333334,2720,45.333333333333336,3000000000,66.17647058823529
492,12,3,15,32.8,164,2460,41,3000000000,73.17073170731707
1637,25,3,28,58.464285714285715,545.6666666666666,8185,136.41666666666666,3000000000,21.991447770311545
884,16,3,19,46.526315789473685,294.6666666666667,4420,73.66666666666667,3000000000,40.723981900452486
436,10,3,13,33.53846153846154,145.33333333333334,2180,36.333333333333336,3000000000,82.56880733944953
711,14,3,17,41.8235294117647,237,3555,59.25,3000000000,50.63291139240506
1267,22,3,25,50.68,422.3333333333333,6335,105.58333333333333,3000000000,28.413575374901342
957,22,3,25,38.28,319,4785,79.75,3000000000,37.61755485893417
1057,19,7,26,40.65384615384615,151,5285,88.08333333333333,7000000000,79.4701986754967
335,7,3,10,33.5,111.66666666666667,1675,27.916666666666668,3000000000,107.46268656716417
550,9,5,14,39.285714285714285,110,2750,45.833333333333336,5000000000,109.09090909090908
493,7,4,11,44.81818181818182,123.25,2465,41.083333333333336,4000000000,97.3630831643002
548,12,3,15,36.53333333333333,182.66666666666666,2740,45.666666666666664,3000000000,65.69343065693431
881,9,4,13,67.76923076923077,220.25,4405,73.41666666666667,4000000000,54.483541430192965
480,5,4,9,53.333333333333336,120,2400,40,4000000000,100
773,10,3,13,59.46153846153846,257.6666666666667,3865,64.41666666666667,3000000000,46.57179818887451
469,4,3,7,67,156.33333333333334,2345,39.083333333333336,3000000000,76.75906183368869
788,16,3,19,41.473684210526315,262.6666666666667,3940,65.66666666666667,3000000000,45.68527918781725
700,6,3,9,77.77777777777777,233.33333333333334,3500,58.333333333333336,3000000000,51.42857142857142
393,5,3,8,49.125,131,1965,32.75,3000000000,91.6030534351145
1428,28,3,31,46.064516129032256,476,7140,119,3000000000,25.210084033613448
411,6,3,9,45.666666666666664,137,2055,34.25,3000000000,87.59124087591242
418,7,4,11,38,104.5,2090,34.833333333333336,4000000000,114.83253588516745
1031,21,6,27,38.18518518518518,171.83333333333334,5155,85.91666666666667,6000000000,69.83511154219204
609,8,3,11,55.36363636363637,203,3045,50.75,3000000000,59.11330049261083
364,7,3,10,36.4,121.33333333333333,1820,30.333333333333332,3000000000,98.9010989010989
396,6,5,11,36,79.2,1980,33,5000000000,151.5151515151515
427,11,3,14,30.5,142.33333333333334,2135,35.583333333333336,3000000000,84.30913348946135
705,12,3,15,47,235,3525,58.75,3000000000,51.06382978723405
474,6,3,9,52.666666666666664,158,2370,39.5,3000000000,75.94936708860759
538,9,8,17,31.647058823529413,67.25,2690,44.833333333333336,8000000000,178.43866171003717
301,8,5,13,23.153846153846153,60.2,1505,25.083333333333332,5000000000,199.33554817275748
530,5,3,8,66.25,176.66666666666666,2650,44.166666666666664,3000000000,67.9245283018868
881,15,3,18,48.94444444444444,293.6666666666667,4405,73.41666666666667,3000000000,40.86265607264472
532,12,3,15,35.46666666666667,177.33333333333334,2660,44.333333333333336,3000000000,67.66917293233082
1126,15,3,18,62.55555555555556,375.3333333333333,5630,93.83333333333333,3000000000,31.97158081705151
838,19,3,22,38.09090909090909,279.3333333333333,4190,69.83333333333333,3000000000,42.95942720763723
1698,29,11,40,42.45,154.36363636363637,8490,141.5,11000000000,77.73851590106007
641,10,4,14,45.785714285714285,160.25,3205,53.416666666666664,4000000000,74.88299531981279
516,7,3,10,51.6,172,2580,43,3000000000,69.76744186046511
362,4,3,7,51.714285714285715,120.66666666666667,1810,30.166666666666668,3000000000,99.4475138121547
389,6,3,9,43.22222222222222,129.66666666666666,1945,32.416666666666664,3000000000,92.54498714652956
641,10,3,13,49.30769230769231,213.66666666666666,3205,53.416666666666664,3000000000,56.1622464898596
389,8,4,12,32.416666666666664,97.25,1945,32.416666666666664,4000000000,123.39331619537276
296,6,4,10,29.6,74,1480,24.666666666666668,4000000000,162.16216216216216
456,14,3,17,26.823529411764707,152,2280,38,3000000000,78.94736842105263
671,13,4,17,39.470588235294116,167.75,3355,55.916666666666664,4000000000,71.53502235469449
518,7,5,12,43.166666666666664,103.6,2590,43.166666666666664,5000000000,115.83011583011584
570,11,4,15,38,142.5,2850,47.5,4000000000,84.21052631578948
1377,15,11,26,52.96153846153846,125.18181818181819,6885,114.75,11000000000,95.86056644880173
1290,17,6,23,56.08695652173913,215,6450,107.5,6000000000,55.81395348837209
1232,19,11,30,41.06666666666667,112,6160,102.66666666666667,11000000000,107.14285714285714
684,6,5,11,62.18181818181818,136.8,3420,57,5000000000,87.71929824561404
1108,20,3,23,48.17391304347826,369.3333333333333,5540,92.33333333333333,3000000000,32.49097472924188
313,6,4,10,31.3,78.25,1565,26.083333333333332,4000000000,153.3546325878594
562,10,4,14,40.142857142857146,140.5,2810,46.833333333333336,4000000000,85.40925266903915
442,5,5,10,44.2,88.4,2210,36.833333333333336,5000000000,135.7466063348416
183,6,3,9,20.333333333333332,61,915,15.25,3000000000,196.72131147540983
414,7,5,12,34.5,82.8,2070,34.5,5000000000,144.92753623188406
698,12,3,15,46.53333333333333,232.66666666666666,3490,58.166666666666664,3000000000,51.5759312320917
577,13,3,16,36.0625,192.33333333333334,2885,48.083333333333336,3000000000,62.39168110918544
258,4,3,7,36.857142857142854,86,1290,21.5,3000000000,139.53488372093022
331,7,3,10,33.1,110.33333333333333,1655,27.583333333333332,3000000000,108.76132930513594
240,3,5,8,30,48,1200,20,5000000000,250
359,5,3,8,44.875,119.66666666666667,1795,29.916666666666668,3000000000,100.27855153203343
504,10,3,13,38.76923076923077,168,2520,42,3000000000,71.42857142857143
613,18,6,24,25.541666666666668,102.16666666666667,3065,51.083333333333336,6000000000,117.45513866231647
566,8,6,14,40.42857142857143,94.33333333333333,2830,47.166666666666664,6000000000,127.20848056537103
1101,17,3,20,55.05,367,5505,91.75,3000000000,32.69754768392371
777,6,6,12,64.75,129.5,3885,64.75,6000000000,92.66409266409266
593,5,3,8,74.125,197.66666666666666,2965,49.416666666666664,3000000000,60.708263069139974
429,9,3,12,35.75,143,2145,35.75,3000000000,83.91608391608392
974,13,4,17,57.294117647058826,243.5,4870,81.16666666666667,4000000000,49.281314168377826
646,8,7,15,43.06666666666667,92.28571428571429,3230,53.833333333333336,7000000000,130.03095975232196
164,3,3,6,27.333333333333332,54.666666666666664,820,13.666666666666666,3000000000,219.5121951219512
863,12,3,15,57.53333333333333,287.6666666666667,4315,71.91666666666667,3000000000,41.71494785631517
1134,16,8,24,47.25,141.75,5670,94.5,8000000000,84.65608465608466
1199,15,8,23,52.130434782608695,149.875,5995,99.91666666666667,8000000000,80.06672226855713
556,10,3,13,42.76923076923077,185.33333333333334,2780,46.333333333333336,3000000000,64.74820143884892
319,5,3,8,39.875,106.33333333333333,1595,26.583333333333332,3000000000,112.85266457680251
736,20,3,23,32,245.33333333333334,3680,61.333333333333336,3000000000,48.91304347826087
741,7,3,10,74.1,247,3705,61.75,3000000000,48.582995951417004
439,11,3,14,31.357142857142858,146.33333333333334,2195,36.583333333333336,3000000000,82.00455580865604
824,13,4,17,48.470588235294116,206,4120,68.66666666666667,4000000000,58.252427184466015
674,8,5,13,51.84615384615385,134.8,3370,56.166666666666664,5000000000,89.02077151335313
767,12,5,17,45.11764705882353,153.4,3835,63.916666666666664,5000000000,78.22685788787484
685,9,3,12,57.083333333333336,228.33333333333334,3425,57.083333333333336,3000000000,52.55474452554744
138,4,3,7,19.714285714285715,46,690,11.5,3000000000,260.8695652173913
489,5,5,10,48.9,97.8,2445,40.75,5000000000,122.69938650306747
344,7,6,13,26.46153846153846,57.333333333333336,1720,28.666666666666668,6000000000,209.30232558139534
669,11,6,17,39.35294117647059,111.5,3345,55.75,6000000000,107.62331838565022
394,8,3,11,35.81818181818182,131.33333333333334,1970,32.833333333333336,3000000000,91.3705583756345
836,10,3,13,64.3076923076923,278.6666666666667,4180,69.66666666666667,3000000000,43.0622009569378
195,5,4,9,21.666666666666668,48.75,975,16.25,4000000000,246.15384615384613
740,10,3,13,56.92307692307692,246.66666666666666,3700,61.666666666666664,3000000000,48.64864864864865
900,14,8,22,40.90909090909091,112.5,4500,75,8000000000,106.66666666666667
877,11,3,14,62.642857142857146,292.3333333333333,4385,73.08333333333333,3000000000,41.049030786773095
649,16,3,19,34.1578947368421,216.33333333333334,3245,54.083333333333336,3000000000,55.46995377503852
588,12,3,15,39.2,196,2940,49,3000000000,61.224489795918366
507,8,3,11,46.09090909090909,169,2535,42.25,3000000000,71.0059171597633
912,9,7,16,57,130.28571428571428,4560,76,7000000000,92.10526315789473
612,9,3,12,51,204,3060,51,3000000000,58.8235294117647
296,6,3,9,32.888888888888886,98.66666666666667,1480,24.666666666666668,3000000000,121.62162162162161
839,12,7,19,44.1578947368421,119.85714285714286,4195,69.91666666666667,7000000000,100.11918951132299
840,12,3,15,56,280,4200,70,3000000000,42.85714285714286
595,9,3,12,49.583333333333336,198.33333333333334,2975,49.583333333333336,3000000000,60.50420168067227
588,9,3,12,49,196,2940,49,3000000000,61.224489795918366
466,6,11,17,27.41176470588235,42.36363636363637,2330,38.833333333333336,11000000000,283.26180257510725
589,8,3,11,53.54545454545455,196.33333333333334,2945,49.083333333333336,3000000000,61.120543293718164
821,13,3,16,51.3125,273.6666666666667,4105,68.41666666666667,3000000000,43.848964677222895
930,7,8,15,62,116.25,4650,77.5,8000000000,103.22580645161291
616,8,4,12,51.333333333333336,154,3080,51.333333333333336,4000000000,77.92207792207792
1418,24,3,27,52.51851851851852,472.6666666666667,7090,118.16666666666667,3000000000,25.387870239774326
716,16,6,22,32.54545454545455,119.33333333333333,3580,59.666666666666664,6000000000,100.5586592178771
1141,19,7,26,43.88461538461539,163,5705,95.08333333333333,7000000000,73.61963190184049
590,6,3,9,65.55555555555556,196.66666666666666,2950,49.166666666666664,3000000000,61.016949152542374
489,8,3,11,44.45454545454545,163,2445,40.75,3000000000,73.61963190184049
999,18,3,21,47.57142857142857,333,4995,83.25,3000000000,36.03603603603604
620,11,5,16,38.75,124,3100,51.666666666666664,5000000000,96.77419354838709
1076,13,5,18,59.77777777777778,215.2,5380,89.66666666666667,5000000000,55.76208178438661
482,11,7,18,26.77777777777778,68.85714285714286,2410,40.166666666666664,7000000000,174.27385892116183
441,4,5,9,49,88.2,2205,36.75,5000000000,136.05442176870747
850,11,8,19,44.73684210526316,106.25,4250,70.83333333333333,8000000000,112.94117647058823
438,8,3,11,39.81818181818182,146,2190,36.5,3000000000,82.1917808219178
608,8,4,12,50.666666666666664,152,3040,50.666666666666664,4000000000,78.94736842105263
935,18,8,26,35.96153846153846,116.875,4675,77.91666666666667,8000000000,102.67379679144383
760,16,3,19,40,253.33333333333334,3800,63.333333333333336,3000000000,47.36842105263158
765,15,3,18,42.5,255,3825,63.75,3000000000,47.05882352941176
279,10,4,14,19.928571428571427,69.75,1395,23.25,4000000000,172.04301075268816
644,13,3,16,40.25,214.66666666666666,3220,53.666666666666664,3000000000,55.90062111801243
808,20,4,24,33.666666666666664,202,4040,67.33333333333333,4000000000,59.40594059405941
537,8,5,13,41.30769230769231,107.4,2685,44.75,5000000000,111.73184357541899
414,7,6,13,31.846153846153847,69,2070,34.5,6000000000,173.91304347826087
839,14,3,17,49.35294117647059,279.6666666666667,4195,69.91666666666667,3000000000,42.908224076281286
1148,16,4,20,57.4,287,5740,95.66666666666667,4000000000,41.81184668989547
571,4,3,7,81.57142857142857,190.33333333333334,2855,47.583333333333336,3000000000,63.047285464098074
452,7,3,10,45.2,150.66666666666666,2260,37.666666666666664,3000000000,79.64601769911505
589,14,3,17,34.64705882352941,196.33333333333334,2945,49.083333333333336,3000000000,61.120543293718164
1192,21,3,24,49.666666666666664,397.3333333333333,5960,99.33333333333333,3000000000,30.2013422818792
1438,19,3,22,65.36363636363636,479.3333333333333,7190,119.83333333333333,3000000000,25.03477051460362
462,5,3,8,57.75,154,2310,38.5,3000000000,77.92207792207792
523,3,3,6,87.16666666666667,174.33333333333334,2615,43.583333333333336,3000000000,68.83365200764818
1028,18,3,21,48.95238095238095,342.6666666666667,5140,85.66666666666667,3000000000,35.01945525291829
1036,16,3,19,54.526315789473685,345.3333333333333,5180,86.33333333333333,3000000000,34.74903474903475
309,4,3,7,44.142857142857146,103,1545,25.75,3000000000,116.50485436893204
375,5,3,8,46.875,125,1875,31.25,3000000000,96
604,8,3,11,54.90909090909091,201.33333333333334,3020,50.333333333333336,3000000000,59.602649006622514
127,4,3,7,18.142857142857142,42.333333333333336,635,10.583333333333334,3000000000,283.4645669291338
324,8,4,12,27,81,1620,27,4000000000,148.14814814814815
568,14,3,17,33.411764705882355,189.33333333333334,2840,47.333333333333336,3000000000,63.38028169014084
585,6,10,16,36.5625,58.5,2925,48.75,10000000000,205.1282051282051
1424,12,8,20,71.2,178,7120,118.66666666666667,8000000000,67.41573033707864
1085,23,6,29,37.41379310344828,180.83333333333334,5425,90.41666666666667,6000000000,66.35944700460828
349,9,5,14,24.928571428571427,69.8,1745,29.083333333333332,5000000000,171.91977077363896
601,5,3,8,75.125,200.33333333333334,3005,50.083333333333336,3000000000,59.90016638935108
436,3,4,7,62.285714285714285,109,2180,36.333333333333336,4000000000,110.09174311926604
725,9,3,12,60.416666666666664,241.66666666666666,3625,60.416666666666664,3000000000,49.6551724137931
1025,14,6,20,51.25,170.83333333333334,5125,85.41666666666667,6000000000,70.2439024390244
1047,16,7,23,45.52173913043478,149.57142857142858,5235,87.25,7000000000,80.22922636103152
693,7,6,13,53.30769230769231,115.5,3465,57.75,6000000000,103.8961038961039
667,5,3,8,83.375,222.33333333333334,3335,55.583333333333336,3000000000,53.973013493253376
462,7,3,10,46.2,154,2310,38.5,3000000000,77.92207792207792
1048,13,6,19,55.1578947368421,174.66666666666666,5240,87.33333333333333,6000000000,68.70229007633587
821,11,3,14,58.642857142857146,273.6666666666667,4105,68.41666666666667,3000000000,43.848964677222895
833,10,3,13,64.07692307692308,277.6666666666667,4165,69.41666666666667,3000000000,43.2172869147659
730,12,5,17,42.94117647058823,146,3650,60.833333333333336,5000000000,82.1917808219178
589,7,9,16,36.8125,65.44444444444444,2945,49.083333333333336,9000000000,183.36162988115447
383,7,3,10,38.3,127.66666666666667,1915,31.916666666666668,3000000000,93.99477806788512
530,5,3,8,66.25,176.66666666666666,2650,44.166666666666664,3000000000,67.9245283018868
556,13,3,16,34.75,185.33333333333334,2780,46.333333333333336,3000000000,64.74820143884892
678,10,3,13,52.15384615384615,226,3390,56.5,3000000000,53.097345132743364
423,3,5,8,52.875,84.6,2115,35.25,5000000000,141.84397163120568
1255,20,3,23,54.56521739130435,418.3333333333333,6275,104.58333333333333,3000000000,28.68525896414343
511,8,3,11,46.45454545454545,170.33333333333334,2555,42.583333333333336,3000000000,70.45009784735812
368,11,3,14,26.285714285714285,122.66666666666667,1840,30.666666666666668,3000000000,97.82608695652173
209,3,3,6,34.833333333333336,69.66666666666667,1045,17.416666666666668,3000000000,172.2488038277512
702,9,3,12,58.5,234,3510,58.5,3000000000,51.28205128205128
617,6,3,9,68.55555555555556,205.66666666666666,3085,51.416666666666664,3000000000,58.346839546191255
735,14,5,19,38.68421052631579,147,3675,61.25,5000000000,81.63265306122449
676,18,4,22,30.727272727272727,169,3380,56.333333333333336,4000000000,71.0059171597633
620,9,5,14,44.285714285714285,124,3100,51.666666666666664,5000000000,96.77419354838709
599,9,6,15,39.93333333333333,99.83333333333333,2995,49.916666666666664,6000000000,120.20033388981638
560,9,5,14,40,112,2800,46.666666666666664,5000000000,107.14285714285715
586,16,5,21,27.904761904761905,117.2,2930,48.833333333333336,5000000000,102.3890784982935
1299,21,8,29,44.793103448275865,162.375,6495,108.25,8000000000,73.90300230946882
787,16,3,19,41.421052631578945,262.3333333333333,3935,65.58333333333333,3000000000,45.7433290978399
337,7,3,10,33.7,112.33333333333333,1685,28.083333333333332,3000000000,106.82492581602374
1262,25,11,36,35.05555555555556,114.72727272727273,6310,105.16666666666667,11000000000,104.5958795562599
922,7,5,12,76.83333333333333,184.4,4610,76.83333333333333,5000000000,65.07592190889372
714,16,3,19,37.578947368421055,238,3570,59.5,3000000000,50.420168067226896
1285,22,9,31,41.45161290322581,142.77777777777777,6425,107.08333333333333,9000000000,84.04669260700389
451,8,3,11,41,150.33333333333334,2255,37.583333333333336,3000000000,79.82261640798227
555,5,7,12,46.25,79.28571428571429,2775,46.25,7000000000,151.35135135135135
1049,23,3,26,40.34615384615385,349.6666666666667,5245,87.41666666666667,3000000000,34.31839847473785
635,5,3,8,79.375,211.66666666666666,3175,52.916666666666664,3000000000,56.69291338582677
575,7,7,14,41.07142857142857,82.14285714285714,2875,47.916666666666664,7000000000,146.08695652173913
959,15,8,23,41.69565217391305,119.875,4795,79.91666666666667,8000000000,100.10427528675703
683,14,6,20,34.15,113.83333333333333,3415,56.916666666666664,6000000000,105.4172767203514
670,7,4,11,60.90909090909091,167.5,3350,55.833333333333336,4000000000,71.64179104477611
926,12,3,15,61.733333333333334,308.6666666666667,4630,77.16666666666667,3000000000,38.8768898488121
388,8,4,12,32.333333333333336,97,1940,32.333333333333336,4000000000,123.71134020618557
584,8,4,12,48.666666666666664,146,2920,48.666666666666664,4000000000,82.19178082191782
885,17,6,23,38.47826086956522,147.5,4425,73.75,6000000000,81.35593220338983
747,9,3,12,62.25,249,3735,62.25,3000000000,48.192771084337345
312,5,3,8,39,104,1560,26,3000000000,115.38461538461539
636,9,3,12,53,212,3180,53,3000000000,56.60377358490566
514,11,3,14,36.714285714285715,171.33333333333334,2570,42.833333333333336,3000000000,70.03891050583658
515,5,3,8,64.375,171.66666666666666,2575,42.916666666666664,3000000000,69.90291262135923
452,10,3,13,34.76923076923077,150.66666666666666,2260,37.666666666666664,3000000000,79.64601769911505
683,14,5,19,35.94736842105263,136.6,3415,56.916666666666664,5000000000,87.84773060029283
977,13,3,16,61.0625,325.6666666666667,4885,81.41666666666667,3000000000,36.8474923234391
540,7,4,11,49.09090909090909,135,2700,45,4000000000,88.8888888888889
880,13,3,16,55,293.3333333333333,4400,73.33333333333333,3000000000,40.909090909090914
545,13,5,18,30.27777777777778,109,2725,45.416666666666664,5000000000,110.09174311926607
362,4,3,7,51.714285714285715,120.66666666666667,1810,30.166666666666668,3000000000,99.4475138121547
724,10,6,16,45.25,120.66666666666667,3620,60.333333333333336,6000000000,99.4475138121547
433,8,3,11,39.36363636363637,144.33333333333334,2165,36.083333333333336,3000000000,83.14087759815241
680,8,5,13,52.30769230769231,136,3400,56.666666666666664,5000000000,88.23529411764707
705,11,3,14,50.357142857142854,235,3525,58.75,3000000000,51.06382978723405
310,5,3,8,38.75,103.33333333333333,1550,25.833333333333332,3000000000,116.12903225806453
383,5,3,8,47.875,127.66666666666667,1915,31.916666666666668,3000000000,93.99477806788512
822,8,3,11,74.72727272727273,274,4110,68.5,3000000000,43.79562043795621
1197,16,3,19,63,399,5985,99.75,3000000000,30.075187969924812
735,12,3,15,49,245,3675,61.25,3000000000,48.9795918367347
750,13,3,16,46.875,250,3750,62.5,3000000000,48
521,10,3,13,40.07692307692308,173.66666666666666,2605,43.416666666666664,3000000000,69.0978886756238
701,10,6,16,43.8125,116.83333333333333,3505,58.416666666666664,6000000000,102.71041369472184
839,14,4,18,46.611111111111114,209.75,4195,69.91666666666667,4000000000,57.21096543504171
412,6,4,10,41.2,103,2060,34.333333333333336,4000000000,116.50485436893203
611,14,3,17,35.94117647058823,203.66666666666666,3055,50.916666666666664,3000000000,58.91980360065467
957,15,3,18,53.166666666666664,319,4785,79.75,3000000000,37.61755485893417
723,10,5,15,48.2,144.6,3615,60.25,5000000000,82.9875518672199
180,3,3,6,30,60,900,15,3000000000,200
1047,18,3,21,49.857142857142854,349,5235,87.25,3000000000,34.383954154727796
516,13,3,16,32.25,172,2580,43,3000000000,69.76744186046511
449,12,4,16,28.0625,112.25,2245,37.416666666666664,4000000000,106.9042316258352
1006,16,8,24,41.916666666666664,125.75,5030,83.83333333333333,8000000000,95.42743538767395
542,3,8,11,49.27272727272727,67.75,2710,45.166666666666664,8000000000,177.1217712177122
624,9,3,12,52,208,3120,52,3000000000,57.69230769230769
511,7,3,10,51.1,170.33333333333334,2555,42.583333333333336,3000000000,70.45009784735812
730,14,4,18,40.55555555555556,182.5,3650,60.833333333333336,4000000000,65.75342465753424
1060,20,11,31,34.193548387096776,96.36363636363636,5300,88.33333333333333,11000000000,124.52830188679246
401,11,3,14,28.642857142857142,133.66666666666666,2005,33.416666666666664,3000000000,89.77556109725687
573,9,3,12,47.75,191,2865,47.75,3000000000,62.82722513089005
914,12,3,15,60.93333333333333,304.6666666666667,4570,76.16666666666667,3000000000,39.387308533916844
267,7,3,10,26.7,89,1335,22.25,3000000000,134.83146067415728
580,13,5,18,32.22222222222222,116,2900,48.333333333333336,5000000000,103.44827586206897
754,15,3,18,41.888888888888886,251.33333333333334,3770,62.833333333333336,3000000000,47.745358090185675
379,7,5,12,31.583333333333332,75.8,1895,31.583333333333332,5000000000,158.311345646438
592,7,4,11,53.81818181818182,148,2960,49.333333333333336,4000000000,81.08108108108108
1366,21,7,28,48.785714285714285,195.14285714285714,6830,113.83333333333333,7000000000,61.493411420204986
568,5,4,9,63.111111111111114,142,2840,47.333333333333336,4000000000,84.50704225352113
715,9,7,16,44.6875,102.14285714285714,3575,59.583333333333336,7000000000,117.48251748251748
609,9,6,15,40.6,101.5,3045,50.75,6000000000,118.22660098522167
709,6,3,9,78.77777777777777,236.33333333333334,3545,59.083333333333336,3000000000,50.77574047954865
450,4,3,7,64.28571428571429,150,2250,37.5,3000000000,80
415,7,4,11,37.72727272727273,103.75,2075,34.583333333333336,4000000000,115.66265060240963
503,7,5,12,41.916666666666664,100.6,2515,41.916666666666664,5000000000,119.28429423459245
533,10,3,13,41,177.66666666666666,2665,44.416666666666664,3000000000,67.5422138836773
533,10,7,17,31.352941176470587,76.14285714285714,2665,44.416666666666664,7000000000,157.59849906191369
979,26,7,33,29.666666666666668,139.85714285714286,4895,81.58333333333333,7000000000,85.80183861082739
646,8,3,11,58.72727272727273,215.33333333333334,3230,53.833333333333336,3000000000,55.72755417956656
515,9,3,12,42.916666666666664,171.66666666666666,2575,42.916666666666664,3000000000,69.90291262135923
551,5,4,9,61.22222222222222,137.75,2755,45.916666666666664,4000000000,87.11433756805808
1299,17,10,27,48.111111111111114,129.9,6495,108.25,10000000000,92.37875288683603
569,11,3,14,40.642857142857146,189.66666666666666,2845,47.416666666666664,3000000000,63.26889279437611
542,12,4,16,33.875,135.5,2710,45.166666666666664,4000000000,88.5608856088561
459,8,3,11,41.72727272727273,153,2295,38.25,3000000000,78.4313725490196
423,9,3,12,35.25,141,2115,35.25,3000000000,85.1063829787234
391,6,5,11,35.54545454545455,78.2,1955,32.583333333333336,5000000000,153.45268542199486
640,8,3,11,58.18181818181818,213.33333333333334,3200,53.333333333333336,3000000000,56.25
257,3,3,6,42.833333333333336,85.66666666666667,1285,21.416666666666668,3000000000,140.07782101167317
543,8,3,11,49.36363636363637,181,2715,45.25,3000000000,66.29834254143647
980,14,3,17,57.64705882352941,326.6666666666667,4900,81.66666666666667,3000000000,36.73469387755102
708,10,6,16,44.25,118,3540,59,6000000000,101.69491525423729
652,9,3,12,54.333333333333336,217.33333333333334,3260,54.333333333333336,3000000000,55.214723926380366
581,7,4,11,52.81818181818182,145.25,2905,48.416666666666664,4000000000,82.61617900172118
558,10,3,13,42.92307692307692,186,2790,46.5,3000000000,64.51612903225806
780,10,3,13,60,260,3900,65,3000000000,46.15384615384615
558,10,3,13,42.92307692307692,186,2790,46.5,3000000000,64.51612903225806
359,10,3,13,27.615384615384617,119.66666666666667,1795,29.916666666666668,3000000000,100.27855153203343
528,13,3,16,33,176,2640,44,3000000000,68.18181818181819
586,11,9,20,29.3,65.11111111111111,2930,48.833333333333336,9000000000,184.3003412969283
547,6,3,9,60.77777777777778,182.33333333333334,2735,45.583333333333336,3000000000,65.81352833638024
1175,20,10,30,39.166666666666664,117.5,5875,97.91666666666667,10000000000,102.12765957446808
807,8,5,13,62.07692307692308,161.4,4035,67.25,5000000000,74.34944237918216
416,5,5,10,41.6,83.2,2080,34.666666666666664,5000000000,144.23076923076925
674,6,3,9,74.88888888888889,224.66666666666666,3370,56.166666666666664,3000000000,53.41246290801187
415,7,3,10,41.5,138.33333333333334,2075,34.583333333333336,3000000000,86.74698795180721
615,8,3,11,55.90909090909091,205,3075,51.25,3000000000,58.53658536585366
328,6,3,9,36.44444444444444,109.33333333333333,1640,27.333333333333332,3000000000,109.7560975609756
764,9,7,16,47.75,109.14285714285714,3820,63.666666666666664,7000000000,109.94764397905759
536,6,4,10,53.6,134,2680,44.666666666666664,4000000000,89.55223880597015
720,13,3,16,45,240,3600,60,3000000000,50
895,11,6,17,52.64705882352941,149.16666666666666,4475,74.58333333333333,6000000000,80.44692737430168
298,5,3,8,37.25,99.33333333333333,1490,24.833333333333332,3000000000,120.8053691275168
698,7,4,11,63.45454545454545,174.5,3490,58.166666666666664,4000000000,68.76790830945559
665,8,3,11,60.45454545454545,221.66666666666666,3325,55.416666666666664,3000000000,54.13533834586466
829,7,3,10,82.9,276.3333333333333,4145,69.08333333333333,3000000000,43.42581423401689
592,6,3,9,65.77777777777777,197.33333333333334,2960,49.333333333333336,3000000000,60.81081081081081
472,14,4,18,26.22222222222222,118,2360,39.333333333333336,4000000000,101.69491525423727
415,7,3,10,41.5,138.33333333333334,2075,34.583333333333336,3000000000,86.74698795180721
958,23,3,26,36.84615384615385,319.3333333333333,4790,79.83333333333333,3000000000,37.57828810020877
434,11,3,14,31,144.66666666666666,2170,36.166666666666664,3000000000,82.94930875576037
606,7,9,16,37.875,67.33333333333333,3030,50.5,9000000000,178.21782178217822
572,5,6,11,52,95.33333333333333,2860,47.666666666666664,6000000000,125.87412587412588
464,5,5,10,46.4,92.8,2320,38.666666666666664,5000000000,129.31034482758622
750,16,8,24,31.25,93.75,3750,62.5,8000000000,128
717,10,3,13,55.15384615384615,239,3585,59.75,3000000000,50.2092050209205
1106,17,9,26,42.53846153846154,122.88888888888889,5530,92.16666666666667,9000000000,97.64918625678119
885,13,3,16,55.3125,295,4425,73.75,3000000000,40.67796610169491
381,6,4,10,38.1,95.25,1905,31.75,4000000000,125.98425196850394
430,5,5,10,43,86,2150,35.833333333333336,5000000000,139.53488372093022
877,10,9,19,46.1578947368421,97.44444444444444,4385,73.08333333333333,9000000000,123.14709236031928
600,16,3,19,31.57894736842105,200,3000,50,3000000000,60
527,7,4,11,47.90909090909091,131.75,2635,43.916666666666664,4000000000,91.08159392789375
677,20,3,23,29.434782608695652,225.66666666666666,3385,56.416666666666664,3000000000,53.17577548005909
386,6,4,10,38.6,96.5,1930,32.166666666666664,4000000000,124.35233160621762
820,10,12,22,37.27272727272727,68.33333333333333,4100,68.33333333333333,12000000000,175.609756097561
702,12,4,16,43.875,175.5,3510,58.5,4000000000,68.37606837606839
298,3,4,7,42.57142857142857,74.5,1490,24.833333333333332,4000000000,161.07382550335572
442,6,4,10,44.2,110.5,2210,36.833333333333336,4000000000,108.5972850678733
618,6,3,9,68.66666666666667,206,3090,51.5,3000000000,58.25242718446602
528,5,3,8,66,176,2640,44,3000000000,68.18181818181819
640,10,4,14,45.714285714285715,160,3200,53.333333333333336,4000000000,75
337,5,3,8,42.125,112.33333333333333,1685,28.083333333333332,3000000000,106.82492581602374
425,8,3,11,38.63636363636363,141.66666666666666,2125,35.416666666666664,3000000000,84.70588235294119
1165,9,9,18,64.72222222222223,129.44444444444446,5825,97.08333333333333,9000000000,92.70386266094421
455,6,3,9,50.55555555555556,151.66666666666666,2275,37.916666666666664,3000000000,79.12087912087912
697,9,3,12,58.083333333333336,232.33333333333334,3485,58.083333333333336,3000000000,51.649928263988514
780,11,3,14,55.714285714285715,260,3900,65,3000000000,46.15384615384615
431,6,3,9,47.888888888888886,143.66666666666666,2155,35.916666666666664,3000000000,83.52668213457078
774,6,6,12,64.5,129,3870,64.5,6000000000,93.02325581395348
491,12,3,15,32.733333333333334,163.66666666666666,2455,40.916666666666664,3000000000,73.31975560081467
542,12,5,17,31.88235294117647,108.4,2710,45.166666666666664,5000000000,110.70110701107012
279,5,3,8,34.875,93,1395,23.25,3000000000,129.03225806451613
991,12,11,23,43.08695652173913,90.0909090909091,4955,82.58333333333333,11000000000,133.19878910191727
304,3,3,6,50.666666666666664,101.33333333333333,1520,25.333333333333332,3000000000,118.42105263157895
1027,17,10,27,38.03703703703704,102.7,5135,85.58333333333333,10000000000,116.84518013631939
416,6,4,10,41.6,104,2080,34.666666666666664,4000000000,115.38461538461539
642,6,6,12,53.5,107,3210,53.5,6000000000,112.14953271028037
420,8,3,11,38.18181818181818,140,2100,35,3000000000,85.71428571428572
486,4,3,7,69.42857142857143,162,2430,40.5,3000000000,74.07407407407408
472,8,3,11,42.90909090909091,157.33333333333334,2360,39.333333333333336,3000000000,76.27118644067795
963,16,8,24,40.125,120.375,4815,80.25,8000000000,99.68847352024922
705,7,7,14,50.357142857142854,100.71428571428571,3525,58.75,7000000000,119.14893617021276
437,10,3,13,33.61538461538461,145.66666666666666,2185,36.416666666666664,3000000000,82.37986270022884
642,10,3,13,49.38461538461539,214,3210,53.5,3000000000,56.074766355140184
789,11,3,14,56.357142857142854,263,3945,65.75,3000000000,45.62737642585551
418,13,3,16,26.125,139.33333333333334,2090,34.833333333333336,3000000000,86.1244019138756
312,4,4,8,39,78,1560,26,4000000000,153.84615384615387
682,11,3,14,48.714285714285715,227.33333333333334,3410,56.833333333333336,3000000000,52.785923753665685
919,15,8,23,39.95652173913044,114.875,4595,76.58333333333333,8000000000,104.4613710554951
560,10,3,13,43.07692307692308,186.66666666666666,2800,46.666666666666664,3000000000,64.28571428571429
211,4,3,7,30.142857142857142,70.33333333333333,1055,17.583333333333332,3000000000,170.61611374407585
825,9,3,12,68.75,275,4125,68.75,3000000000,43.63636363636363
486,8,3,11,44.18181818181818,162,2430,40.5,3000000000,74.07407407407408
549,4,3,7,78.42857142857143,183,2745,45.75,3000000000,65.57377049180329
425,4,3,7,60.714285714285715,141.66666666666666,2125,35.416666666666664,3000000000,84.70588235294119
1130,14,3,17,66.47058823529412,376.6666666666667,5650,94.16666666666667,3000000000,31.858407079646017
375,7,3,10,37.5,125,1875,31.25,3000000000,96
376,4,4,8,47,94,1880,31.333333333333332,4000000000,127.65957446808511
464,11,3,14,33.142857142857146,154.66666666666666,2320,38.666666666666664,3000000000,77.58620689655173
1032,20,4,24,43,258,5160,86,4000000000,46.51162790697674
249,8,3,11,22.636363636363637,83,1245,20.75,3000000000,144.57831325301206
553,9,3,12,46.083333333333336,184.33333333333334,2765,46.083333333333336,3000000000,65.09945750452079
717,13,3,16,44.8125,239,3585,59.75,3000000000,50.2092050209205
838,18,3,21,39.904761904761905,279.3333333333333,4190,69.83333333333333,3000000000,42.95942720763723
432,14,3,17,25.41176470588235,144,2160,36,3000000000,83.33333333333333
271,3,6,9,30.11111111111111,45.166666666666664,1355,22.583333333333332,6000000000,265.6826568265683
780,15,7,22,35.45454545454545,111.42857142857143,3900,65,7000000000,107.6923076923077
822,11,3,14,58.714285714285715,274,4110,68.5,3000000000,43.79562043795621
1202,15,5,20,60.1,240.4,6010,100.16666666666667,5000000000,49.91680532445923
1378,22,3,25,55.12,459.3333333333333,6890,114.83333333333333,3000000000,26.124818577648767
634,9,3,12,52.833333333333336,211.33333333333334,3170,52.833333333333336,3000000000,56.78233438485804
635,10,4,14,45.357142857142854,158.75,3175,52.916666666666664,4000000000,75.59055118110237
976,12,3,15,65.06666666666666,325.3333333333333,4880,81.33333333333333,3000000000,36.88524590163935
831,10,10,20,41.55,83.1,4155,69.25,10000000000,144.4043321299639
562,7,3,10,56.2,187.33333333333334,2810,46.833333333333336,3000000000,64.05693950177935
621,6,3,9,69,207,3105,51.75,3000000000,57.971014492753625
332,5,3,8,41.5,110.66666666666667,1660,27.666666666666668,3000000000,108.43373493975903
376,9,3,12,31.333333333333332,125.33333333333333,1880,31.333333333333332,3000000000,95.74468085106383
471,5,3,8,58.875,157,2355,39.25,3000000000,76.43312101910828
1227,9,6,15,81.8,204.5,6135,102.25,6000000000,58.67970660146699
730,10,5,15,48.666666666666664,146,3650,60.833333333333336,5000000000,82.1917808219178
642,10,3,13,49.38461538461539,214,3210,53.5,3000000000,56.074766355140184
802,14,5,19,42.21052631578947,160.4,4010,66.83333333333333,5000000000,74.81296758104739
601,13,3,16,37.5625,200.33333333333334,3005,50.083333333333336,3000000000,59.90016638935108
803,13,3,16,50.1875,267.6666666666667,4015,66.91666666666667,3000000000,44.8318804483188
183,3,3,6,30.5,61,915,15.25,3000000000,196.72131147540983
578,9,5,14,41.285714285714285,115.6,2890,48.166666666666664,5000000000,103.80622837370242
378,4,3,7,54,126,1890,31.5,3000000000,95.23809523809524
827,6,3,9,91.88888888888889,275.6666666666667,4135,68.91666666666667,3000000000,43.53083434099153
1127,11,12,23,49,93.91666666666667,5635,93.91666666666667,12000000000,127.77284826974267
322,10,3,13,24.76923076923077,107.33333333333333,1610,26.833333333333332,3000000000,111.80124223602486
829,13,10,23,36.04347826086956,82.9,4145,69.08333333333333,10000000000,144.75271411338963
379,5,6,11,34.45454545454545,63.166666666666664,1895,31.583333333333332,6000000000,189.9736147757256
816,14,3,17,48,272,4080,68,3000000000,44.11764705882353
844,22,3,25,33.76,281.3333333333333,4220,70.33333333333333,3000000000,42.65402843601896
674,8,3,11,61.27272727272727,224.66666666666666,3370,56.166666666666664,3000000000,53.41246290801187
388,5,3,8,48.5,129.33333333333334,1940,32.333333333333336,3000000000,92.78350515463917
359,8,3,11,32.63636363636363,119.66666666666667,1795,29.916666666666668,3000000000,100.27855153203343
239,4,5,9,26.555555555555557,47.8,1195,19.916666666666668,5000000000,251.04602510460248
694,8,3,11,63.09090909090909,231.33333333333334,3470,57.833333333333336,3000000000,51.87319884726225
162,5,3,8,20.25,54,810,13.5,3000000000,222.2222222222222
653,8,3,11,59.36363636363637,217.66666666666666,3265,54.416666666666664,3000000000,55.1301684532925
418,5,3,8,52.25,139.33333333333334,2090,34.833333333333336,3000000000,86.1244019138756
908,13,3,16,56.75,302.6666666666667,4540,75.66666666666667,3000000000,39.647577092511014
277,4,3,7,39.57142857142857,92.33333333333333,1385,23.083333333333332,3000000000,129.9638989169675
606,8,4,12,50.5,151.5,3030,50.5,4000000000,79.20792079207921
536,5,5,10,53.6,107.2,2680,44.666666666666664,5000000000,111.9402985074627
563,13,3,16,35.1875,187.66666666666666,2815,46.916666666666664,3000000000,63.94316163410302
1336,15,12,27,49.48148148148148,111.33333333333333,6680,111.33333333333333,12000000000,107.78443113772455
358,6,3,9,39.77777777777778,119.33333333333333,1790,29.833333333333332,3000000000,100.5586592178771
267,6,4,10,26.7,66.75,1335,22.25,4000000000,179.7752808988764
907,11,3,14,64.78571428571429,302.3333333333333,4535,75.58333333333333,3000000000,39.69128996692393
801,10,5,15,53.4,160.2,4005,66.75,5000000000,74.90636704119851
855,9,9,18,47.5,95,4275,71.25,9000000000,126.3157894736842
236,5,3,8,29.5,78.66666666666667,1180,19.666666666666668,3000000000,152.5423728813559
377,5,3,8,47.125,125.66666666666667,1885,31.416666666666668,3000000000,95.49071618037135
748,7,3,10,74.8,249.33333333333334,3740,62.333333333333336,3000000000,48.1283422459893
384,4,3,7,54.857142857142854,128,1920,32,3000000000,93.75
1051,25,6,31,33.903225806451616,175.16666666666666,5255,87.58333333333333,6000000000,68.50618458610847
515,7,3,10,51.5,171.66666666666666,2575,42.916666666666664,3000000000,69.90291262135923
394,4,5,9,43.77777777777778,78.8,1970,32.833333333333336,5000000000,152.28426395939084
423,6,3,9,47,141,2115,35.25,3000000000,85.1063829787234
569,6,6,12,47.416666666666664,94.83333333333333,2845,47.416666666666664,6000000000,126.53778558875221
851,18,4,22,38.68181818181818,212.75,4255,70.91666666666667,4000000000,56.404230317273786
661,11,3,14,47.214285714285715,220.33333333333334,3305,55.083333333333336,3000000000,54.462934947049924
689,7,4,11,62.63636363636363,172.25,3445,57.416666666666664,4000000000,69.66618287373005
710,11,3,14,50.714285714285715,236.66666666666666,3550,59.166666666666664,3000000000,50.70422535211268
812,15,4,19,42.73684210526316,203,4060,67.66666666666667,4000000000,59.11330049261083
817,14,6,20,40.85,136.16666666666666,4085,68.08333333333333,6000000000,88.12729498164016
582,10,4,14,41.57142857142857,145.5,2910,48.5,4000000000,82.47422680412372
578,8,4,12,48.166666666666664,144.5,2890,48.166666666666664,4000000000,83.04498269896195
248,3,3,6,41.333333333333336,82.66666666666667,1240,20.666666666666668,3000000000,145.16129032258064
207,5,3,8,25.875,69,1035,17.25,3000000000,173.91304347826087
438,7,4,11,39.81818181818182,109.5,2190,36.5,4000000000,109.58904109589042
464,6,3,9,51.55555555555556,154.66666666666666,2320,38.666666666666664,3000000000,77.58620689655173
394,10,3,13,30.307692307692307,131.33333333333334,1970,32.833333333333336,3000000000,91.3705583756345
538,11,4,15,35.86666666666667,134.5,2690,44.833333333333336,4000000000,89.21933085501858
955,15,6,21,45.476190476190474,159.16666666666666,4775,79.58333333333333,6000000000,75.39267015706807
717,15,5,20,35.85,143.4,3585,59.75,5000000000,83.68200836820084
640,9,3,12,53.333333333333336,213.33333333333334,3200,53.333333333333336,3000000000,56.25
713,14,3,17,41.94117647058823,237.66666666666666,3565,59.416666666666664,3000000000,50.490883590462836
1122,20,6,26,43.15384615384615,187,5610,93.5,6000000000,64.171122994652407
975,11,3,14,69.64285714285714,325,4875,81.25,3000000000,36.92307692307692
353,4,3,7,50.42857142857143,117.66666666666667,1765,29.416666666666668,3000000000,101.98300283286119
722,9,5,14,51.57142857142857,144.4,3610,60.166666666666664,5000000000,83.10249307479225
210,5,3,8,26.25,70,1050,17.5,3000000000,171.42857142857144
1197,18,12,30,39.9,99.75,5985,99.75,12000000000,120.30075187969925
586,14,8,22,26.636363636363637,73.25,2930,48.833333333333336,8000000000,163.82252559726962
879,20,8,28,31.392857142857142,109.875,4395,73.25,8000000000,109.2150170648464
492,9,3,12,41,164,2460,41,3000000000,73.17073170731707
658,14,9,23,28.608695652173914,73.11111111111111,3290,54.833333333333336,9000000000,164.1337386018237
442,7,3,10,44.2,147.33333333333334,2210,36.833333333333336,3000000000,81.44796380090497
996,10,5,15,66.4,199.2,4980,83,5000000000,60.24096385542168
811,10,3,13,62.38461538461539,270.3333333333333,4055,67.58333333333333,3000000000,44.38964241676942
675,7,3,10,67.5,225,3375,56.25,3000000000,53.333333333333336
829,18,5,23,36.04347826086956,165.8,4145,69.08333333333333,5000000000,72.37635705669481
745,8,4,12,62.083333333333336,186.25,3725,62.083333333333336,4000000000,64.42953020134227
590,11,3,14,42.142857142857146,196.66666666666666,2950,49.166666666666664,3000000000,61.016949152542374
296,7,3,10,29.6,98.66666666666667,1480,24.666666666666668,3000000000,121.62162162162161
233,8,3,11,21.181818181818183,77.66666666666667,1165,19.416666666666668,3000000000,154.50643776824035
223,3,3,6,37.166666666666664,74.33333333333333,1115,18.583333333333332,3000000000,161.43497757847535
855,9,7,16,53.4375,122.14285714285714,4275,71.25,7000000000,98.24561403508773
465,9,3,12,38.75,155,2325,38.75,3000000000,77.41935483870968
432,5,4,9,48,108,2160,36,4000000000,111.1111111111111
533,7,3,10,53.3,177.66666666666666,2665,44.416666666666664,3000000000,67.5422138836773
484,5,3,8,60.5,161.33333333333334,2420,40.333333333333336,3000000000,74.3801652892562
661,12,3,15,44.06666666666667,220.33333333333334,3305,55.083333333333336,3000000000,54.462934947049924
1013,15,3,18,56.27777777777778,337.6666666666667,5065,84.41666666666667,3000000000,35.53800592300098
810,19,4,23,35.21739130434783,202.5,4050,67.5,4000000000,59.25925925925926
1141,14,11,25,45.64,103.72727272727273,5705,95.08333333333333,11000000000,115.6879929886065
589,8,3,11,53.54545454545455,196.33333333333334,2945,49.083333333333336,3000000000,61.120543293718164
648,7,4,11,58.90909090909091,162,3240,54,4000000000,74.07407407407408
345,6,3,9,38.333333333333336,115,1725,28.75,3000000000,104.34782608695652
1304,23,3,26,50.15384615384615,434.6666666666667,6520,108.66666666666667,3000000000,27.607361963190183
592,7,4,11,53.81818181818182,148,2960,49.333333333333336,4000000000,81.08108108108108
743,11,3,14,53.07142857142857,247.66666666666666,3715,61.916666666666664,3000000000,48.45222072678331
291,4,3,7,41.57142857142857,97,1455,24.25,3000000000,123.71134020618557
408,3,5,8,51,81.6,2040,34,5000000000,147.05882352941177
196,4,3,7,28,65.33333333333333,980,16.333333333333332,3000000000,183.67346938775512
260,6,3,9,28.88888888888889,86.66666666666667,1300,21.666666666666668,3000000000,138.46153846153845
572,12,3,15,38.13333333333333,190.66666666666666,2860,47.666666666666664,3000000000,62.93706293706294
464,10,4,14,33.142857142857146,116,2320,38.666666666666664,4000000000,103.44827586206897
419,4,3,7,59.857142857142854,139.66666666666666,2095,34.916666666666664,3000000000,85.91885441527447
558,6,6,12,46.5,93,2790,46.5,6000000000,129.03225806451613
759,10,3,13,58.38461538461539,253,3795,63.25,3000000000,47.430830039525695
209,4,4,8,26.125,52.25,1045,17.416666666666668,4000000000,229.6650717703349
847,12,3,15,56.46666666666667,282.3333333333333,4235,70.58333333333333,3000000000,42.502951593860686
314,7,3,10,31.4,104.66666666666667,1570,26.166666666666668,3000000000,114.64968152866241
979,7,9,16,61.1875,108.77777777777777,4895,81.58333333333333,9000000000,110.31664964249234
283,3,3,6,47.166666666666664,94.33333333333333,1415,23.583333333333332,3000000000,127.20848056537103
477,5,3,8,59.625,159,2385,39.75,3000000000,75.47169811320755
897,7,3,10,89.7,299,4485,74.75,3000000000,40.13377926421405
752,9,5,14,53.714285714285715,150.4,3760,62.666666666666664,5000000000,79.7872340425532
449,7,3,10,44.9,149.66666666666666,2245,37.416666666666664,3000000000,80.1781737193764
836,12,3,15,55.733333333333334,278.6666666666667,4180,69.66666666666667,3000000000,43.0622009569378
1336,28,3,31,43.096774193548384,445.3333333333333,6680,111.33333333333333,3000000000,26.94610778443114
161,3,3,6,26.833333333333332,53.666666666666664,805,13.416666666666666,3000000000,223.60248447204972
277,6,3,9,30.77777777777778,92.33333333333333,1385,23.083333333333332,3000000000,129.9638989169675
627,6,6,12,52.25,104.5,3135,52.25,6000000000,114.83253588516746
660,12,3,15,44,220,3300,55,3000000000,54.54545454545455
642,15,3,18,35.666666666666664,214,3210,53.5,3000000000,56.074766355140184
678,11,3,14,48.42857142857143,226,3390,56.5,3000000000,53.097345132743364
621,10,3,13,47.76923076923077,207,3105,51.75,3000000000,57.971014492753625
601,10,4,14,42.92857142857143,150.25,3005,50.083333333333336,4000000000,79.86688851913478
298,3,3,6,49.666666666666664,99.33333333333333,1490,24.833333333333332,3000000000,120.8053691275168
593,10,3,13,45.61538461538461,197.66666666666666,2965,49.416666666666664,3000000000,60.708263069139974
399,6,3,9,44.333333333333336,133,1995,33.25,3000000000,90.22556390977444
1057,12,6,18,58.72222222222222,176.16666666666666,5285,88.08333333333333,6000000000,68.11731315042573
601,4,5,9,66.77777777777777,120.2,3005,50.083333333333336,5000000000,99.83361064891847
596,12,3,15,39.733333333333334,198.66666666666666,2980,49.666666666666664,3000000000,60.4026845637584
730,18,6,24,30.416666666666668,121.66666666666667,3650,60.833333333333336,6000000000,98.63013698630137
855,9,7,16,53.4375,122.14285714285714,4275,71.25,7000000000,98.24561403508773
456,6,3,9,50.666666666666664,152,2280,38,3000000000,78.94736842105263
333,6,5,11,30.272727272727273,66.6,1665,27.75,5000000000,180.1801801801802
1036,13,4,17,60.94117647058823,259,5180,86.33333333333333,4000000000,46.33204633204634
331,8,3,11,30.09090909090909,110.33333333333333,1655,27.583333333333332,3000000000,108.76132930513594
485,7,3,10,48.5,161.66666666666666,2425,40.416666666666664,3000000000,74.22680412371135
373,5,3,8,46.625,124.33333333333333,1865,31.083333333333332,3000000000,96.514745308311
888,14,3,17,52.23529411764706,296,4440,74,3000000000,40.54054054054054
277,6,3,9,30.77777777777778,92.33333333333333,1385,23.083333333333332,3000000000,129.9638989169675
1181,20,3,23,51.34782608695652,393.6666666666667,5905,98.41666666666667,3000000000,30.482641828958506
1183,20,10,30,39.43333333333333,118.3,5915,98.58333333333333,10000000000,101.43702451394759
739,11,4,15,49.266666666666666,184.75,3695,61.583333333333336,4000000000,64.95263870094722
282,4,3,7,40.285714285714285,94,1410,23.5,3000000000,127.65957446808511
560,8,5,13,43.07692307692308,112,2800,46.666666666666664,5000000000,107.14285714285715
1017,13,3,16,63.5625,339,5085,84.75,3000000000,35.39823008849557
798,12,3,15,53.2,266,3990,66.5,3000000000,45.11278195488722
375,9,4,13,28.846153846153847,93.75,1875,31.25,4000000000,128
759,12,4,16,47.4375,189.75,3795,63.25,4000000000,63.241106719367586
459,6,4,10,45.9,114.75,2295,38.25,4000000000,104.57516339869282
494,6,4,10,49.4,123.5,2470,41.166666666666664,4000000000,97.16599190283401
853,10,6,16,53.3125,142.16666666666666,4265,71.08333333333333,6000000000,84.40797186400938
1002,14,3,17,58.94117647058823,334,5010,83.5,3000000000,35.928143712574844
730,6,3,9,81.11111111111111,243.33333333333334,3650,60.833333333333336,3000000000,49.31506849315068
861,15,6,21,41,143.5,4305,71.75,6000000000,83.62369337979095
1093,17,3,20,54.65,364.3333333333333,5465,91.08333333333333,3000000000,32.93687099725526
316,11,3,14,22.571428571428573,105.33333333333333,1580,26.333333333333332,3000000000,113.9240506329114
491,5,3,8,61.375,163.66666666666666,2455,40.916666666666664,3000000000,73.31975560081467
1184,8,8,16,74,148,5920,98.66666666666667,8000000000,81.08108108108108
268,8,3,11,24.363636363636363,89.33333333333333,1340,22.333333333333332,3000000000,134.32835820895522
578,8,4,12,48.166666666666664,144.5,2890,48.166666666666664,4000000000,83.04498269896195
153,3,3,6,25.5,51,765,12.75,3000000000,235.2941176470588
1228,22,4,26,47.23076923076923,307,6140,102.33333333333333,4000000000,39.08794788273616
665,11,3,14,47.5,221.66666666666666,3325,55.416666666666664,3000000000,54.13533834586466
425,6,3,9,47.22222222222222,141.66666666666666,2125,35.416666666666664,3000000000,84.70588235294119
396,5,4,9,44,99,1980,33,4000000000,121.21212121212122
562,7,3,10,56.2,187.33333333333334,2810,46.833333333333336,3000000000,64.05693950177935
464,6,3,9,51.55555555555556,154.66666666666666,2320,38.666666666666664,3000000000,77.58620689655173
994,15,6,21,47.333333333333336,165.66666666666666,4970,82.83333333333333,6000000000,72.43460764587526
700,8,3,11,63.63636363636363,233.33333333333334,3500,58.333333333333336,3000000000,51.42857142857142
765,13,3,16,47.8125,255,3825,63.75,3000000000,47.05882352941176
509,12,5,17,29.941176470588236,101.8,2545,42.416666666666664,5000000000,117.87819253438116
1008,13,6,19,53.05263157894737,168,5040,84,6000000000,71.42857142857143
754,13,5,18,41.888888888888886,150.8,3770,62.833333333333336,5000000000,79.57559681697613
1137,15,11,26,43.73076923076923,103.36363636363636,5685,94.75,11000000000,116.09498680738785
725,5,3,8,90.625,241.66666666666666,3625,60.416666666666664,3000000000,49.6551724137931
400,4,4,8,50,100,2000,33.333333333333336,4000000000,119.99999999999999
842,11,3,14,60.142857142857146,280.6666666666667,4210,70.16666666666667,3000000000,42.75534441805225
1063,16,5,21,50.61904761904762,212.6,5315,88.58333333333333,5000000000,56.44402634054563
519,10,3,13,39.92307692307692,173,2595,43.25,3000000000,69.36416184971098
890,18,3,21,42.38095238095238,296.6666666666667,4450,74.16666666666667,3000000000,40.44943820224719
562,13,3,16,35.125,187.33333333333334,2810,46.833333333333336,3000000000,64.05693950177935
620,12,3,15,41.333333333333336,206.66666666666666,3100,51.666666666666664,3000000000,58.06451612903226
702,12,3,15,46.8,234,3510,58.5,3000000000,51.28205128205128
554,6,4,10,55.4,138.5,2770,46.166666666666664,4000000000,86.64259927797835
675,13,6,19,35.526315789473685,112.5,3375,56.25,6000000000,106.66666666666667
1567,27,11,38,41.23684210526316,142.45454545454547,7835,130.58333333333334,11000000000,84.23739629865985
334,6,3,9,37.111111111111114,111.33333333333333,1670,27.833333333333332,3000000000,107.78443113772455
297,4,3,7,42.42857142857143,99,1485,24.75,3000000000,121.21212121212122
821,12,3,15,54.733333333333334,273.6666666666667,4105,68.41666666666667,3000000000,43.848964677222895
333,4,5,9,37,66.6,1665,27.75,5000000000,180.1801801801802
703,13,3,16,43.9375,234.33333333333334,3515,58.583333333333336,3000000000,51.209103840682786
747,8,3,11,67.9090909090909,249,3735,62.25,3000000000,48.192771084337345
370,4,3,7,52.857142857142854,123.33333333333333,1850,30.833333333333332,3000000000,97.2972972972973
1017,17,8,25,40.68,127.125,5085,84.75,8000000000,94.3952802359882
370,8,3,11,33.63636363636363,123.33333333333333,1850,30.833333333333332,3000000000,97.2972972972973
681,10,7,17,40.05882352941177,97.28571428571429,3405,56.75,7000000000,123.34801762114537
631,11,4,15,42.06666666666667,157.75,3155,52.583333333333336,4000000000,76.06973058637084
474,12,3,15,31.6,158,2370,39.5,3000000000,75.94936708860759
376,7,4,11,34.18181818181818,94,1880,31.333333333333332,4000000000,127.65957446808511
165,4,3,7,23.571428571428573,55,825,13.75,3000000000,218.1818181818182
1758,21,14,35,50.22857142857143,125.57142857142857,8790,146.5,14000000000,95.56313993174061
1059,19,6,25,42.36,176.5,5295,88.25,6000000000,67.98866855524079
634,13,5,18,35.22222222222222,126.8,3170,52.833333333333336,5000000000,94.6372239747634
389,3,7,10,38.9,55.57142857142857,1945,32.416666666666664,7000000000,215.93830334190233
601,10,4,14,42.92857142857143,150.25,3005,50.083333333333336,4000000000,79.86688851913478
448,5,3,8,56,149.33333333333334,2240,37.333333333333336,3000000000,80.35714285714285
554,12,3,15,36.93333333333333,184.66666666666666,2770,46.166666666666664,3000000000,64.98194945848375
451,8,3,11,41,150.33333333333334,2255,37.583333333333336,3000000000,79.82261640798227
531,5,3,8,66.375,177,2655,44.25,3000000000,67.79661016949153
740,11,3,14,52.857142857142854,246.66666666666666,3700,61.666666666666664,3000000000,48.64864864864865
648,8,5,13,49.84615384615385,129.6,3240,54,5000000000,92.5925925925926
646,10,5,15,43.06666666666667,129.2,3230,53.833333333333336,5000000000,92.87925696594428
387,5,3,8,48.375,129,1935,32.25,3000000000,93.02325581395348
432,5,3,8,54,144,2160,36,3000000000,83.33333333333333
693,15,3,18,38.5,231,3465,57.75,3000000000,51.94805194805195
566,7,5,12,47.166666666666664,113.2,2830,47.166666666666664,5000000000,106.00706713780919
429,5,4,9,47.666666666666664,107.25,2145,35.75,4000000000,111.8881118881119
756,14,3,17,44.470588235294116,252,3780,63,3000000000,47.61904761904762
831,11,5,16,51.9375,166.2,4155,69.25,5000000000,72.20216606498195
1108,21,3,24,46.166666666666664,369.3333333333333,5540,92.33333333333333,3000000000,32.49097472924188
1255,21,3,24,52.291666666666664,418.3333333333333,6275,104.58333333333333,3000000000,28.68525896414343
421,9,4,13,32.38461538461539,105.25,2105,35.083333333333336,4000000000,114.01425178147268
883,14,3,17,51.94117647058823,294.3333333333333,4415,73.58333333333333,3000000000,40.770101925254814
751,20,8,28,26.821428571428573,93.875,3755,62.583333333333336,8000000000,127.82956058588547
474,5,3,8,59.25,158,2370,39.5,3000000000,75.94936708860759
701,7,8,15,46.733333333333334,87.625,3505,58.416666666666664,8000000000,136.9472182596291
563,5,3,8,70.375,187.66666666666666,2815,46.916666666666664,3000000000,63.94316163410302
709,10,6,16,44.3125,118.16666666666667,3545,59.083333333333336,6000000000,101.5514809590973
588,11,4,15,39.2,147,2940,49,4000000000,81.63265306122449
781,11,4,15,52.06666666666667,195.25,3905,65.08333333333333,4000000000,61.45966709346992
513,7,3,10,51.3,171,2565,42.75,3000000000,70.17543859649123
1059,19,3,22,48.13636363636363,353,5295,88.25,3000000000,33.994334277620396
566,6,3,9,62.888888888888886,188.66666666666666,2830,47.166666666666664,3000000000,63.60424028268552
438,4,7,11,39.81818181818182,62.57142857142857,2190,36.5,7000000000,191.7808219178082
766,15,4,19,40.31578947368421,191.5,3830,63.833333333333336,4000000000,62.66318537859008
259,3,3,6,43.166666666666664,86.33333333333333,1295,21.583333333333332,3000000000,138.996138996139
598,11,3,14,42.714285714285715,199.33333333333334,2990,49.833333333333336,3000000000,60.20066889632107
402,3,4,7,57.42857142857143,100.5,2010,33.5,4000000000,119.40298507462687
424,10,3,13,32.61538461538461,141.33333333333334,2120,35.333333333333336,3000000000,84.90566037735849
371,6,3,9,41.22222222222222,123.66666666666667,1855,30.916666666666668,3000000000,97.03504043126685
438,5,3,8,54.75,146,2190,36.5,3000000000,82.1917808219178
655,8,3,11,59.54545454545455,218.33333333333334,3275,54.583333333333336,3000000000,54.9618320610687
380,8,4,12,31.666666666666668,95,1900,31.666666666666668,4000000000,126.3157894736842
626,5,4,9,69.55555555555556,156.5,3130,52.166666666666664,4000000000,76.6773162939297
1173,9,3,12,97.75,391,5865,97.75,3000000000,30.690537084398976
648,17,3,20,32.4,216,3240,54,3000000000,55.55555555555555
523,8,3,11,47.54545454545455,174.33333333333334,2615,43.583333333333336,3000000000,68.83365200764818
175,6,3,9,19.444444444444443,58.333333333333336,875,14.583333333333334,3000000000,205.7142857142857
836,23,7,30,27.866666666666667,119.42857142857143,4180,69.66666666666667,7000000000,100.47846889952153
962,12,7,19,50.63157894736842,137.42857142857142,4810,80.16666666666667,7000000000,87.31808731808731
831,15,8,23,36.130434782608695,103.875,4155,69.25,8000000000,115.52346570397111
1023,8,8,16,63.9375,127.875,5115,85.25,8000000000,93.841642228739
1404,13,8,21,66.85714285714286,175.5,7020,117,8000000000,68.37606837606839
844,11,6,17,49.64705882352941,140.66666666666666,4220,70.33333333333333,6000000000,85.30805687203792
259,8,3,11,23.545454545454547,86.33333333333333,1295,21.583333333333332,3000000000,138.996138996139
368,5,3,8,46,122.66666666666667,1840,30.666666666666668,3000000000,97.82608695652173
360,5,3,8,45,120,1800,30,3000000000,100
534,8,3,11,48.54545454545455,178,2670,44.5,3000000000,67.41573033707864
447,10,7,17,26.294117647058822,63.857142857142854,2235,37.25,7000000000,187.91946308724832
544,8,3,11,49.45454545454545,181.33333333333334,2720,45.333333333333336,3000000000,66.17647058823529
500,13,3,16,31.25,166.66666666666666,2500,41.666666666666664,3000000000,72
935,16,4,20,46.75,233.75,4675,77.91666666666667,4000000000,51.33689839572192
791,13,7,20,39.55,113,3955,65.91666666666667,7000000000,106.19469026548671
833,12,3,15,55.53333333333333,277.6666666666667,4165,69.41666666666667,3000000000,43.2172869147659
422,10,3,13,32.46153846153846,140.66666666666666,2110,35.166666666666664,3000000000,85.30805687203792
454,11,3,14,32.42857142857143,151.33333333333334,2270,37.833333333333336,3000000000,79.29515418502203
598,18,3,21,28.476190476190474,199.33333333333334,2990,49.833333333333336,3000000000,60.20066889632107
230,4,3,7,32.857142857142854,76.66666666666667,1150,19.166666666666668,3000000000,156.52173913043478
571,5,3,8,71.375,190.33333333333334,2855,47.583333333333336,3000000000,63.047285464098074
1103,12,8,20,55.15,137.875,5515,91.91666666666667,8000000000,87.0353581142339
313,3,3,6,52.166666666666664,104.33333333333333,1565,26.083333333333332,3000000000,115.01597444089457
668,6,5,11,60.72727272727273,133.6,3340,55.666666666666664,5000000000,89.82035928143713
380,8,3,11,34.54545454545455,126.66666666666667,1900,31.666666666666668,3000000000,94.73684210526316
356,6,3,9,39.55555555555556,118.66666666666667,1780,29.666666666666668,3000000000,101.12359550561797
669,18,7,25,26.76,95.57142857142857,3345,55.75,7000000000,125.56053811659193
547,8,4,12,45.583333333333336,136.75,2735,45.583333333333336,4000000000,87.75137111517367
849,7,10,17,49.94117647058823,84.9,4245,70.75,10000000000,141.3427561837456
323,7,3,10,32.3,107.66666666666667,1615,26.916666666666668,3000000000,111.45510835913312
1110,12,5,17,65.29411764705883,222,5550,92.5,5000000000,54.05405405405405
1891,27,3,30,63.03333333333333,630.3333333333334,9455,157.58333333333334,3000000000,19.037546271813856
302,4,3,7,43.142857142857146,100.66666666666667,1510,25.166666666666668,3000000000,119.20529801324503
303,6,3,9,33.666666666666664,101,1515,25.25,3000000000,118.81188118811882
370,5,3,8,46.25,123.33333333333333,1850,30.833333333333332,3000000000,97.2972972972973
575,10,3,13,44.23076923076923,191.66666666666666,2875,47.916666666666664,3000000000,62.608695652173914
1108,21,3,24,46.166666666666664,369.3333333333333,5540,92.33333333333333,3000000000,32.49097472924188
519,12,5,17,30.529411764705884,103.8,2595,43.25,5000000000,115.60693641618498
685,9,6,15,45.666666666666664,114.16666666666667,3425,57.083333333333336,6000000000,105.10948905109488
711,12,6,18,39.5,118.5,3555,59.25,6000000000,101.26582278481013
747,18,3,21,35.57142857142857,249,3735,62.25,3000000000,48.192771084337345
373,6,3,9,41.44444444444444,124.33333333333333,1865,31.083333333333332,3000000000,96.514745308311
202,4,3,7,28.857142857142858,67.33333333333333,1010,16.833333333333332,3000000000,178.21782178217822
477,9,4,13,36.69230769230769,119.25,2385,39.75,4000000000,100.62893081761007
479,6,3,9,53.22222222222222,159.66666666666666,2395,39.916666666666664,3000000000,75.15657620041755
1246,23,7,30,41.53333333333333,178,6230,103.83333333333333,7000000000,67.41573033707866
390,5,3,8,48.75,130,1950,32.5,3000000000,92.3076923076923
319,8,3,11,29,106.33333333333333,1595,26.583333333333332,3000000000,112.85266457680251
786,12,3,15,52.4,262,3930,65.5,3000000000,45.80152671755725
445,8,3,11,40.45454545454545,148.33333333333334,2225,37.083333333333336,3000000000,80.89887640449437
496,5,6,11,45.09090909090909,82.66666666666667,2480,41.333333333333336,6000000000,145.16129032258064
357,5,3,8,44.625,119,1785,29.75,3000000000,100.84033613445379
589,10,4,14,42.07142857142857,147.25,2945,49.083333333333336,4000000000,81.49405772495756
688,11,6,17,40.470588235294116,114.66666666666667,3440,57.333333333333336,6000000000,104.65116279069767
674,15,3,18,37.44444444444444,224.66666666666666,3370,56.166666666666664,3000000000,53.41246290801187
513,11,3,14,36.642857142857146,171,2565,42.75,3000000000,70.17543859649123
575,3,5,8,71.875,115,2875,47.916666666666664,5000000000,104.34782608695653
586,8,4,12,48.833333333333336,146.5,2930,48.833333333333336,4000000000,81.91126279863481
522,9,3,12,43.5,174,2610,43.5,3000000000,68.9655172413793
497,7,3,10,49.7,165.66666666666666,2485,41.416666666666664,3000000000,72.43460764587526
908,3,5,8,113.5,181.6,4540,75.66666666666667,5000000000,66.07929515418502
197,5,3,8,24.625,65.66666666666667,985,16.416666666666668,3000000000,182.741116751269
667,10,3,13,51.30769230769231,222.33333333333334,3335,55.583333333333336,3000000000,53.973013493253376
750,19,3,22,34.09090909090909,250,3750,62.5,3000000000,48
659,5,3,8,82.375,219.66666666666666,3295,54.916666666666664,3000000000,54.628224582701066
441,8,3,11,40.09090909090909,147,2205,36.75,3000000000,81.63265306122449
501,11,3,14,35.785714285714285,167,2505,41.75,3000000000,71.85628742514969
718,19,5,24,29.916666666666668,143.6,3590,59.833333333333336,5000000000,83.56545961002784
440,7,3,10,44,146.66666666666666,2200,36.666666666666664,3000000000,81.81818181818183
480,6,3,9,53.333333333333336,160,2400,40,3000000000,75
768,11,3,14,54.857142857142854,256,3840,64,3000000000,46.875
224,5,4,9,24.88888888888889,56,1120,18.666666666666668,4000000000,214.28571428571428
516,5,3,8,64.5,172,2580,43,3000000000,69.76744186046511
805,13,6,19,42.36842105263158,134.16666666666666,4025,67.08333333333333,6000000000,89.44099378881988
584,8,8,16,36.5,73,2920,48.666666666666664,8000000000,164.38356164383563
681,11,6,17,40.05882352941177,113.5,3405,56.75,6000000000,105.72687224669605
645,7,7,14,46.07142857142857,92.14285714285714,3225,53.75,7000000000,130.2325581395349
1560,23,7,30,52,222.85714285714286,7800,130,7000000000,53.84615384615385
872,14,3,17,51.294117647058826,290.6666666666667,4360,72.66666666666667,3000000000,41.28440366972477
388,8,3,11,35.27272727272727,129.33333333333334,1940,32.333333333333336,3000000000,92.78350515463917
383,8,3,11,34.81818181818182,127.66666666666667,1915,31.916666666666668,3000000000,93.99477806788512
903,22,10,32,28.21875,90.3,4515,75.25,10000000000,132.89036544850498
781,9,6,15,52.06666666666667,130.16666666666666,3905,65.08333333333333,6000000000,92.18950064020488
320,5,3,8,40,106.66666666666667,1600,26.666666666666668,3000000000,112.5
638,9,5,14,45.57142857142857,127.6,3190,53.166666666666664,5000000000,94.04388714733543
874,11,8,19,46,109.25,4370,72.83333333333333,8000000000,109.83981693363846
937,8,3,11,85.18181818181819,312.3333333333333,4685,78.08333333333333,3000000000,38.4204909284952
517,8,6,14,36.92857142857143,86.16666666666667,2585,43.083333333333336,6000000000,139.26499032882012
1061,16,8,24,44.208333333333336,132.625,5305,88.41666666666667,8000000000,90.48067860508954
483,5,3,8,60.375,161,2415,40.25,3000000000,74.53416149068323
543,4,3,7,77.57142857142857,181,2715,45.25,3000000000,66.29834254143647
360,5,3,8,45,120,1800,30,3000000000,100
542,9,3,12,45.166666666666664,180.66666666666666,2710,45.166666666666664,3000000000,66.42066420664207
527,10,3,13,40.53846153846154,175.66666666666666,2635,43.916666666666664,3000000000,68.3111954459203
563,8,3,11,51.18181818181818,187.66666666666666,2815,46.916666666666664,3000000000,63.94316163410302
233,3,3,6,38.833333333333336,77.66666666666667,1165,19.416666666666668,3000000000,154.50643776824035
755,13,3,16,47.1875,251.66666666666666,3775,62.916666666666664,3000000000,47.682119205298015
468,5,3,8,58.5,156,2340,39,3000000000,76.92307692307693
627,7,5,12,52.25,125.4,3135,52.25,5000000000,95.69377990430621
752,8,3,11,68.36363636363636,250.66666666666666,3760,62.666666666666664,3000000000,47.87234042553192
651,12,3,15,43.4,217,3255,54.25,3000000000,55.29953917050691
486,7,3,10,48.6,162,2430,40.5,3000000000,74.07407407407408
640,8,3,11,58.18181818181818,213.33333333333334,3200,53.333333333333336,3000000000,56.25
730,12,7,19,38.421052631578945,104.28571428571429,3650,60.833333333333336,7000000000,115.06849315068493
407,8,3,11,37,135.66666666666666,2035,33.916666666666664,3000000000,88.45208845208846
547,10,3,13,42.07692307692308,182.33333333333334,2735,45.583333333333336,3000000000,65.81352833638024
670,10,9,19,35.26315789473684,74.44444444444444,3350,55.833333333333336,9000000000,161.19402985074626
1127,22,7,29,38.86206896551724,161,5635,93.91666666666667,7000000000,74.53416149068323
686,9,4,13,52.76923076923077,171.5,3430,57.166666666666664,4000000000,69.97084548104957
874,15,3,18,48.55555555555556,291.3333333333333,4370,72.83333333333333,3000000000,41.18993135011442
313,5,3,8,39.125,104.33333333333333,1565,26.083333333333332,3000000000,115.01597444089457
636,7,3,10,63.6,212,3180,53,3000000000,56.60377358490566
345,8,4,12,28.75,86.25,1725,28.75,4000000000,139.1304347826087
780,11,3,14,55.714285714285715,260,3900,65,3000000000,46.15384615384615
454,8,5,13,34.92307692307692,90.8,2270,37.833333333333336,5000000000,132.15859030837004
482,12,3,15,32.13333333333333,160.66666666666666,2410,40.166666666666664,3000000000,74.68879668049793
525,8,10,18,29.166666666666668,52.5,2625,43.75,10000000000,228.57142857142856
471,15,4,19,24.789473684210527,117.75,2355,39.25,4000000000,101.91082802547771
176,4,3,7,25.142857142857142,58.666666666666664,880,14.666666666666666,3000000000,204.54545454545456
371,9,4,13,28.53846153846154,92.75,1855,30.916666666666668,4000000000,129.3800539083558
492,6,4,10,49.2,123,2460,41,4000000000,97.5609756097561
554,4,5,9,61.55555555555556,110.8,2770,46.166666666666664,5000000000,108.30324909747294
818,8,8,16,51.125,102.25,4090,68.16666666666667,8000000000,117.35941320293398
781,18,8,26,30.03846153846154,97.625,3905,65.08333333333333,8000000000,122.91933418693984
643,7,3,10,64.3,214.33333333333334,3215,53.583333333333336,3000000000,55.987558320373246
509,8,3,11,46.27272727272727,169.66666666666666,2545,42.416666666666664,3000000000,70.7269155206287
429,4,3,7,61.285714285714285,143,2145,35.75,3000000000,83.91608391608392
130,3,3,6,21.666666666666668,43.333333333333336,650,10.833333333333334,3000000000,276.9230769230769
810,13,3,16,50.625,270,4050,67.5,3000000000,44.44444444444445
729,7,7,14,52.07142857142857,104.14285714285714,3645,60.75,7000000000,115.22633744855968
456,4,3,7,65.14285714285714,152,2280,38,3000000000,78.94736842105263
865,13,3,16,54.0625,288.3333333333333,4325,72.08333333333333,3000000000,41.61849710982659
595,11,3,14,42.5,198.33333333333334,2975,49.583333333333336,3000000000,60.50420168067227
513,9,3,12,42.75,171,2565,42.75,3000000000,70.17543859649123
686,8,3,11,62.36363636363637,228.66666666666666,3430,57.166666666666664,3000000000,52.478134110787174
642,15,3,18,35.666666666666664,214,3210,53.5,3000000000,56.074766355140184
1125,20,3,23,48.91304347826087,375,5625,93.75,3000000000,32
318,7,4,11,28.90909090909091,79.5,1590,26.5,4000000000,150.9433962264151
318,4,3,7,45.42857142857143,106,1590,26.5,3000000000,113.20754716981132
493,8,3,11,44.81818181818182,164.33333333333334,2465,41.083333333333336,3000000000,73.02231237322515
565,13,3,16,35.3125,188.33333333333334,2825,47.083333333333336,3000000000,63.716814159292035
604,10,3,13,46.46153846153846,201.33333333333334,3020,50.333333333333336,3000000000,59.602649006622514
1092,17,5,22,49.63636363636363,218.4,5460,91,5000000000,54.94505494505495
739,7,7,14,52.785714285714285,105.57142857142857,3695,61.583333333333336,7000000000,113.66711772665765
801,9,6,15,53.4,133.5,4005,66.75,6000000000,89.8876404494382
530,8,3,11,48.18181818181818,176.66666666666666,2650,44.166666666666664,3000000000,67.9245283018868
385,6,8,14,27.5,48.125,1925,32.083333333333336,8000000000,249.35064935064932
454,8,3,11,41.27272727272727,151.33333333333334,2270,37.833333333333336,3000000000,79.29515418502203
1272,19,3,22,57.81818181818182,424,6360,106,3000000000,28.30188679245283
377,6,3,9,41.888888888888886,125.66666666666667,1885,31.416666666666668,3000000000,95.49071618037135
657,19,4,23,28.565217391304348,164.25,3285,54.75,4000000000,73.05936073059361
509,9,4,13,39.15384615384615,127.25,2545,42.416666666666664,4000000000,94.30255402750493
521,6,3,9,57.888888888888886,173.66666666666666,2605,43.416666666666664,3000000000,69.0978886756238
517,8,6,14,36.92857142857143,86.16666666666667,2585,43.083333333333336,6000000000,139.26499032882012
374,9,3,12,31.166666666666668,124.66666666666667,1870,31.166666666666668,3000000000,96.2566844919786
604,9,5,14,43.142857142857146,120.8,3020,50.333333333333336,5000000000,99.33774834437085
1136,22,3,25,45.44,378.6666666666667,5680,94.66666666666667,3000000000,31.69014084507042
464,4,7,11,42.18181818181818,66.28571428571429,2320,38.666666666666664,7000000000,181.0344827586207
527,7,3,10,52.7,175.66666666666666,2635,43.916666666666664,3000000000,68.3111954459203
585,4,3,7,83.57142857142857,195,2925,48.75,3000000000,61.53846153846153
730,14,9,23,31.73913043478261,81.11111111111111,3650,60.833333333333336,9000000000,147.94520547945206
748,8,3,11,68,249.33333333333334,3740,62.333333333333336,3000000000,48.1283422459893
531,7,7,14,37.92857142857143,75.85714285714286,2655,44.25,7000000000,158.19209039548022
171,4,3,7,24.428571428571427,57,855,14.25,3000000000,210.52631578947367
555,5,4,9,61.666666666666664,138.75,2775,46.25,4000000000,86.48648648648648
421,6,3,9,46.77777777777778,140.33333333333334,2105,35.083333333333336,3000000000,85.5106888361045
1300,16,3,19,68.42105263157895,433.3333333333333,6500,108.33333333333333,3000000000,27.692307692307693
1286,21,12,33,38.96969696969697,107.16666666666667,6430,107.16666666666667,12000000000,111.97511664074649
701,10,4,14,50.07142857142857,175.25,3505,58.416666666666664,4000000000,68.47360912981455
769,15,5,20,38.45,153.8,3845,64.08333333333333,5000000000,78.02340702210664
307,5,3,8,38.375,102.33333333333333,1535,25.583333333333332,3000000000,117.26384364820846
415,7,3,10,41.5,138.33333333333334,2075,34.583333333333336,3000000000,86.74698795180721
1138,13,3,16,71.125,379.3333333333333,5690,94.83333333333333,3000000000,31.634446397188054
611,6,3,9,67.88888888888889,203.66666666666666,3055,50.916666666666664,3000000000,58.91980360065467
681,7,4,11,61.90909090909091,170.25,3405,56.75,4000000000,70.48458149779735
1238,14,17,31,39.935483870967744,72.82352941176471,6190,103.16666666666667,17000000000,164.78190630048465
563,8,3,11,51.18181818181818,187.66666666666666,2815,46.916666666666664,3000000000,63.94316163410302
558,11,4,15,37.2,139.5,2790,46.5,4000000000,86.02150537634408
851,12,3,15,56.733333333333334,283.6666666666667,4255,70.91666666666667,3000000000,42.30317273795535
910,10,5,15,60.666666666666664,182,4550,75.83333333333333,5000000000,65.93406593406594
617,9,3,12,51.416666666666664,205.66666666666666,3085,51.416666666666664,3000000000,58.346839546191255
515,12,7,19,27.105263157894736,73.57142857142857,2575,42.916666666666664,7000000000,163.10679611650488
612,11,4,15,40.8,153,3060,51,4000000000,78.4313725490196
829,19,3,22,37.68181818181818,276.3333333333333,4145,69.08333333333333,3000000000,43.42581423401689
710,10,7,17,41.76470588235294,101.42857142857143,3550,59.166666666666664,7000000000,118.30985915492958
225,6,3,9,25,75,1125,18.75,3000000000,160
647,18,3,21,30.80952380952381,215.66666666666666,3235,53.916666666666664,3000000000,55.64142194744977
580,9,3,12,48.333333333333336,193.33333333333334,2900,48.333333333333336,3000000000,62.068965517241374
354,7,3,10,35.4,118,1770,29.5,3000000000,101.69491525423729
684,16,3,19,36,228,3420,57,3000000000,52.63157894736842
685,13,8,21,32.61904761904762,85.625,3425,57.083333333333336,8000000000,140.14598540145985
374,7,3,10,37.4,124.66666666666667,1870,31.166666666666668,3000000000,96.2566844919786
427,7,3,10,42.7,142.33333333333334,2135,35.583333333333336,3000000000,84.30913348946135
488,10,3,13,37.53846153846154,162.66666666666666,2440,40.666666666666664,3000000000,73.7704918032787
905,17,3,20,45.25,301.6666666666667,4525,75.41666666666667,3000000000,39.77900552486188
672,15,3,18,37.333333333333336,224,3360,56,3000000000,53.57142857142858
681,13,8,21,32.42857142857143,85.125,3405,56.75,8000000000,140.9691629955947
432,7,6,13,33.23076923076923,72,2160,36,6000000000,166.66666666666666
1004,18,6,24,41.833333333333336,167.33333333333334,5020,83.66666666666667,6000000000,71.71314741035856
633,11,4,15,42.2,158.25,3165,52.75,4000000000,75.82938388625593
489,10,7,17,28.764705882352942,69.85714285714286,2445,40.75,7000000000,171.77914110429447
567,11,3,14,40.5,189,2835,47.25,3000000000,63.492063492063494
677,12,5,17,39.8235294117647,135.4,3385,56.416666666666664,5000000000,88.62629246676515
884,17,3,20,44.2,294.6666666666667,4420,73.66666666666667,3000000000,40.723981900452486
728,19,6,25,29.12,121.33333333333333,3640,60.666666666666664,6000000000,98.9010989010989
633,13,5,18,35.166666666666664,126.6,3165,52.75,5000000000,94.7867298578199
1012,15,3,18,56.22222222222222,337.3333333333333,5060,84.33333333333333,3000000000,35.57312252964427
276,4,3,7,39.42857142857143,92,1380,23,3000000000,130.43478260869566
756,10,7,17,44.470588235294116,108,3780,63,7000000000,111.1111111111111
475,6,4,10,47.5,118.75,2375,39.583333333333336,4000000000,101.05263157894737
564,8,3,11,51.27272727272727,188,2820,47,3000000000,63.829787234042556
518,6,3,9,57.55555555555556,172.66666666666666,2590,43.166666666666664,3000000000,69.4980694980695
687,5,6,11,62.45454545454545,114.5,3435,57.25,6000000000,104.80349344978166
577,7,7,14,41.214285714285715,82.42857142857143,2885,48.083333333333336,7000000000,145.580589254766
660,9,4,13,50.76923076923077,165,3300,55,4000000000,72.72727272727273
598,7,5,12,49.833333333333336,119.6,2990,49.833333333333336,5000000000,100.33444816053512
323,4,5,9,35.888888888888886,64.6,1615,26.916666666666668,5000000000,185.75851393188856
425,3,4,7,60.714285714285715,106.25,2125,35.416666666666664,4000000000,112.94117647058823
385,5,3,8,48.125,128.33333333333334,1925,32.083333333333336,3000000000,93.5064935064935
1177,17,8,25,47.08,147.125,5885,98.08333333333333,8000000000,81.56329651656755
492,10,4,14,35.142857142857146,123,2460,41,4000000000,97.5609756097561
1028,12,9,21,48.95238095238095,114.22222222222223,5140,85.66666666666667,9000000000,105.05836575875486
708,17,3,20,35.4,236,3540,59,3000000000,50.847457627118644
442,6,3,9,49.111111111111114,147.33333333333334,2210,36.833333333333336,3000000000,81.44796380090497
334,9,3,12,27.833333333333332,111.33333333333333,1670,27.833333333333332,3000000000,107.78443113772455
821,10,3,13,63.15384615384615,273.6666666666667,4105,68.41666666666667,3000000000,43.848964677222895
736,14,8,22,33.45454545454545,92,3680,61.333333333333336,8000000000,130.43478260869563
381,7,3,10,38.1,127,1905,31.75,3000000000,94.48818897637796
728,9,4,13,56,182,3640,60.666666666666664,4000000000,65.93406593406594
74,5,3,8,9.25,24.666666666666668,370,6.166666666666667,3000000000,486.48648648648646
626,7,3,10,62.6,208.66666666666666,3130,52.166666666666664,3000000000,57.50798722044728
611,11,3,14,43.642857142857146,203.66666666666666,3055,50.916666666666664,3000000000,58.91980360065467
832,13,3,16,52,277.3333333333333,4160,69.33333333333333,3000000000,43.269230769230774
401,4,4,8,50.125,100.25,2005,33.416666666666664,4000000000,119.70074812967582
494,7,3,10,49.4,164.66666666666666,2470,41.166666666666664,3000000000,72.87449392712551
746,10,8,18,41.44444444444444,93.25,3730,62.166666666666664,8000000000,128.686327077748
270,5,3,8,33.75,90,1350,22.5,3000000000,133.33333333333331
699,11,3,14,49.92857142857143,233,3495,58.25,3000000000,51.50214592274678
566,5,5,10,56.6,113.2,2830,47.166666666666664,5000000000,106.00706713780919
520,9,6,15,34.666666666666664,86.66666666666667,2600,43.333333333333336,6000000000,138.46153846153845
595,7,3,10,59.5,198.33333333333334,2975,49.583333333333336,3000000000,60.50420168067227
436,9,3,12,36.333333333333336,145.33333333333334,2180,36.333333333333336,3000000000,82.56880733944953
882,8,5,13,67.84615384615384,176.4,4410,73.5,5000000000,68.02721088435374
462,7,3,10,46.2,154,2310,38.5,3000000000,77.92207792207792
464,11,4,15,30.933333333333334,116,2320,38.666666666666664,4000000000,103.44827586206897
705,12,3,15,47,235,3525,58.75,3000000000,51.06382978723405
800,12,5,17,47.05882352941177,160,4000,66.66666666666667,5000000000,75
1218,15,3,18,67.66666666666667,406,6090,101.5,3000000000,29.556650246305416
647,11,5,16,40.4375,129.4,3235,53.916666666666664,5000000000,92.73570324574962
940,6,8,14,67.14285714285714,117.5,4700,78.33333333333333,8000000000,102.1276595744681
537,6,3,9,59.666666666666664,179,2685,44.75,3000000000,67.0391061452514
475,10,4,14,33.92857142857143,118.75,2375,39.583333333333336,4000000000,101.05263157894737
1004,17,3,20,50.2,334.6666666666667,5020,83.66666666666667,3000000000,35.85657370517928
637,10,3,13,49,212.33333333333334,3185,53.083333333333336,3000000000,56.5149136577708
394,7,3,10,39.4,131.33333333333334,1970,32.833333333333336,3000000000,91.3705583756345
628,12,3,15,41.86666666666667,209.33333333333334,3140,52.333333333333336,3000000000,57.324840764331206
1044,11,3,14,74.57142857142857,348,5220,87,3000000000,34.48275862068965
597,8,3,11,54.27272727272727,199,2985,49.75,3000000000,60.301507537688444
865,7,8,15,57.666666666666664,108.125,4325,72.08333333333333,8000000000,110.98265895953757
453,10,4,14,32.357142857142854,113.25,2265,37.75,4000000000,105.96026490066225
695,8,3,11,63.18181818181818,231.66666666666666,3475,57.916666666666664,3000000000,51.79856115107914
1094,15,3,18,60.77777777777778,364.6666666666667,5470,91.16666666666667,3000000000,32.90676416819012
686,15,5,20,34.3,137.2,3430,57.166666666666664,5000000000,87.46355685131195
375,6,3,9,41.666666666666664,125,1875,31.25,3000000000,96
628,9,3,12,52.333333333333336,209.33333333333334,3140,52.333333333333336,3000000000,57.324840764331206
611,7,3,10,61.1,203.66666666666666,3055,50.916666666666664,3000000000,58.91980360065467
599,12,3,15,39.93333333333333,199.66666666666666,2995,49.916666666666664,3000000000,60.10016694490819
652,11,4,15,43.46666666666667,163,3260,54.333333333333336,4000000000,73.61963190184049
567,14,3,17,33.35294117647059,189,2835,47.25,3000000000,63.492063492063494
611,13,4,17,35.94117647058823,152.75,3055,50.916666666666664,4000000000,78.55973813420621
315,4,4,8,39.375,78.75,1575,26.25,4000000000,152.38095238095238
313,5,3,8,39.125,104.33333333333333,1565,26.083333333333332,3000000000,115.01597444089457
183,5,3,8,22.875,61,915,15.25,3000000000,196.72131147540983
894,16,3,19,47.05263157894737,298,4470,74.5,3000000000,40.26845637583893
773,13,3,16,48.3125,257.6666666666667,3865,64.41666666666667,3000000000,46.57179818887451
668,8,3,11,60.72727272727273,222.66666666666666,3340,55.666666666666664,3000000000,53.89221556886228
536,9,3,12,44.666666666666664,178.66666666666666,2680,44.666666666666664,3000000000,67.16417910447761
370,7,3,10,37,123.33333333333333,1850,30.833333333333332,3000000000,97.2972972972973
551,6,3,9,61.22222222222222,183.66666666666666,2755,45.916666666666664,3000000000,65.33575317604357
330,6,3,9,36.666666666666664,110,1650,27.5,3000000000,109.0909090909091
536,6,3,9,59.55555555555556,178.66666666666666,2680,44.666666666666664,3000000000,67.16417910447761
956,8,15,23,41.56521739130435,63.733333333333334,4780,79.66666666666667,15000000000,188.28451882845187
389,11,3,14,27.785714285714285,129.66666666666666,1945,32.416666666666664,3000000000,92.54498714652956
558,7,5,12,46.5,111.6,2790,46.5,5000000000,107.52688172043011
414,5,4,9,46,103.5,2070,34.5,4000000000,115.94202898550725
540,7,3,10,54,180,2700,45,3000000000,66.66666666666666
558,13,3,16,34.875,186,2790,46.5,3000000000,64.51612903225806
204,4,3,7,29.142857142857142,68,1020,17,3000000000,176.47058823529412
345,10,3,13,26.53846153846154,115,1725,28.75,3000000000,104.34782608695652
668,8,4,12,55.666666666666664,167,3340,55.666666666666664,4000000000,71.8562874251497
583,6,7,13,44.84615384615385,83.28571428571429,2915,48.583333333333336,7000000000,144.08233276157802
522,9,7,16,32.625,74.57142857142857,2610,43.5,7000000000,160.91954022988506
509,10,4,14,36.357142857142854,127.25,2545,42.416666666666664,4000000000,94.30255402750493
1564,28,3,31,50.45161290322581,521.3333333333334,7820,130.33333333333334,3000000000,23.01790281329923
575,9,3,12,47.916666666666664,191.66666666666666,2875,47.916666666666664,3000000000,62.608695652173914
666,8,6,14,47.57142857142857,111,3330,55.5,6000000000,108.1081081081081
561,14,6,20,28.05,93.5,2805,46.75,6000000000,128.34224598930481
249,5,3,8,31.125,83,1245,20.75,3000000000,144.57831325301206
480,5,3,8,60,160,2400,40,3000000000,75
429,6,3,9,47.666666666666664,143,2145,35.75,3000000000,83.91608391608392
512,18,3,21,24.38095238095238,170.66666666666666,2560,42.666666666666664,3000000000,70.3125
555,6,4,10,55.5,138.75,2775,46.25,4000000000,86.48648648648648
609,16,6,22,27.681818181818183,101.5,3045,50.75,6000000000,118.22660098522167
357,5,3,8,44.625,119,1785,29.75,3000000000,100.84033613445379
799,20,5,25,31.96,159.8,3995,66.58333333333333,5000000000,75.09386733416773
642,11,3,14,45.857142857142854,214,3210,53.5,3000000000,56.074766355140184
1001,14,8,22,45.5,125.125,5005,83.41666666666667,8000000000,95.9040959040959
704,6,9,15,46.93333333333333,78.22222222222223,3520,58.666666666666664,9000000000,153.4090909090909
555,7,3,10,55.5,185,2775,46.25,3000000000,64.86486486486487
691,8,3,11,62.81818181818182,230.33333333333334,3455,57.583333333333336,3000000000,52.098408104196814
928,10,4,14,66.28571428571429,232,4640,77.33333333333333,4000000000,51.724137931034484
931,15,3,18,51.72222222222222,310.3333333333333,4655,77.58333333333333,3000000000,38.66809881847476
493,6,3,9,54.77777777777778,164.33333333333334,2465,41.083333333333336,3000000000,73.02231237322515
705,12,6,18,39.166666666666664,117.5,3525,58.75,6000000000,102.1276595744681
421,9,3,12,35.083333333333336,140.33333333333334,2105,35.083333333333336,3000000000,85.5106888361045
746,10,4,14,53.285714285714285,186.5,3730,62.166666666666664,4000000000,64.343163538874
354,5,5,10,35.4,70.8,1770,29.5,5000000000,169.49152542372883
1325,24,3,27,49.074074074074076,441.6666666666667,6625,110.41666666666667,3000000000,27.169811320754715
411,11,5,16,25.6875,82.2,2055,34.25,5000000000,145.98540145985402
825,11,3,14,58.92857142857143,275,4125,68.75,3000000000,43.63636363636363
682,10,3,13,52.46153846153846,227.33333333333334,3410,56.833333333333336,3000000000,52.785923753665685
291,3,3,6,48.5,97,1455,24.25,3000000000,123.71134020618557
332,4,5,9,36.888888888888886,66.4,1660,27.666666666666668,5000000000,180.72289156626505
524,15,3,18,29.11111111111111,174.66666666666666,2620,43.666666666666664,3000000000,68.70229007633587
545,9,3,12,45.416666666666664,181.66666666666666,2725,45.416666666666664,3000000000,66.05504587155963
659,6,6,12,54.916666666666664,109.83333333333333,3295,54.916666666666664,6000000000,109.25644916540213
800,17,3,20,40,266.6666666666667,4000,66.66666666666667,3000000000,45
749,13,3,16,46.8125,249.66666666666666,3745,62.416666666666664,3000000000,48.06408544726302
567,10,3,13,43.61538461538461,189,2835,47.25,3000000000,63.492063492063494
509,7,3,10,50.9,169.66666666666666,2545,42.416666666666664,3000000000,70.7269155206287
1057,15,10,25,42.28,105.7,5285,88.08333333333333,10000000000,113.52885525070957
299,12,3,15,19.933333333333334,99.66666666666667,1495,24.916666666666668,3000000000,120.40133779264214
418,9,3,12,34.833333333333336,139.33333333333334,2090,34.833333333333336,3000000000,86.1244019138756
547,6,3,9,60.77777777777778,182.33333333333334,2735,45.583333333333336,3000000000,65.81352833638024
321,5,3,8,40.125,107,1605,26.75,3000000000,112.14953271028037
583,11,3,14,41.642857142857146,194.33333333333334,2915,48.583333333333336,3000000000,61.74957118353345
494,4,7,11,44.90909090909091,70.57142857142857,2470,41.166666666666664,7000000000,170.04048582995952
668,6,7,13,51.38461538461539,95.42857142857143,3340,55.666666666666664,7000000000,125.74850299401199
604,8,4,12,50.333333333333336,151,3020,50.333333333333336,4000000000,79.47019867549669
218,7,4,11,19.818181818181817,54.5,1090,18.166666666666668,4000000000,220.18348623853208
922,18,8,26,35.46153846153846,115.25,4610,76.83333333333333,8000000000,104.12147505422995
528,4,4,8,66,132,2640,44,4000000000,90.9090909090909
378,5,7,12,31.5,54,1890,31.5,7000000000,222.2222222222222
438,5,5,10,43.8,87.6,2190,36.5,5000000000,136.986301369863
620,6,3,9,68.88888888888889,206.66666666666666,3100,51.666666666666664,3000000000,58.06451612903226
502,12,3,15,33.46666666666667,167.33333333333334,2510,41.833333333333336,3000000000,71.71314741035856
364,4,4,8,45.5,91,1820,30.333333333333332,4000000000,131.86813186813188
626,10,7,17,36.8235294117647,89.42857142857143,3130,52.166666666666664,7000000000,134.185303514377
278,5,3,8,34.75,92.66666666666667,1390,23.166666666666668,3000000000,129.49640287769785
1008,22,3,25,40.32,336,5040,84,3000000000,35.714285714285715
803,12,10,22,36.5,80.3,4015,66.91666666666667,10000000000,149.439601494396
1074,20,3,23,46.69565217391305,358,5370,89.5,3000000000,33.5195530726257
934,6,7,13,71.84615384615384,133.42857142857142,4670,77.83333333333333,7000000000,89.93576017130623
398,7,3,10,39.8,132.66666666666666,1990,33.166666666666664,3000000000,90.45226130653266
192,5,3,8,24,64,960,16,3000000000,187.5
411,6,3,9,45.666666666666664,137,2055,34.25,3000000000,87.59124087591242
542,7,4,11,49.27272727272727,135.5,2710,45.166666666666664,4000000000,88.5608856088561
661,8,4,12,55.083333333333336,165.25,3305,55.083333333333336,4000000000,72.61724659606656
558,7,4,11,50.72727272727273,139.5,2790,46.5,4000000000,86.02150537634408
1044,15,11,26,40.15384615384615,94.9090909090909,5220,87,11000000000,126.43678160919539
1247,11,12,23,54.21739130434783,103.91666666666667,6235,103.91666666666667,12000000000,115.47714514835604
624,13,4,17,36.705882352941174,156,3120,52,4000000000,76.92307692307693
372,5,6,11,33.81818181818182,62,1860,31,6000000000,193.54838709677418
1390,22,3,25,55.6,463.3333333333333,6950,115.83333333333333,3000000000,25.89928057553957
734,10,6,16,45.875,122.33333333333333,3670,61.166666666666664,6000000000,98.09264305177112
212,9,3,12,17.666666666666668,70.66666666666667,1060,17.666666666666668,3000000000,169.81132075471697
515,8,3,11,46.81818181818182,171.66666666666666,2575,42.916666666666664,3000000000,69.90291262135923
753,7,3,10,75.3,251,3765,62.75,3000000000,47.808764940239044
557,12,3,15,37.13333333333333,185.66666666666666,2785,46.416666666666664,3000000000,64.63195691202873
682,9,3,12,56.833333333333336,227.33333333333334,3410,56.833333333333336,3000000000,52.785923753665685
477,9,3,12,39.75,159,2385,39.75,3000000000,75.47169811320755
315,5,3,8,39.375,105,1575,26.25,3000000000,114.28571428571428
583,13,3,16,36.4375,194.33333333333334,2915,48.583333333333336,3000000000,61.74957118353345
587,8,3,11,53.36363636363637,195.66666666666666,2935,48.916666666666664,3000000000,61.32879045996593
552,9,4,13,42.46153846153846,138,2760,46,4000000000,86.95652173913044
764,14,3,17,44.94117647058823,254.66666666666666,3820,63.666666666666664,3000000000,47.12041884816754
458,8,3,11,41.63636363636363,152.66666666666666,2290,38.166666666666664,3000000000,78.60262008733625
559,12,3,15,37.266666666666666,186.33333333333334,2795,46.583333333333336,3000000000,64.40071556350627
899,8,5,13,69.15384615384616,179.8,4495,74.91666666666667,5000000000,66.74082313681869
514,11,3,14,36.714285714285715,171.33333333333334,2570,42.833333333333336,3000000000,70.03891050583658
598,9,6,15,39.86666666666667,99.66666666666667,2990,49.833333333333336,6000000000,120.40133779264214
466,8,3,11,42.36363636363637,155.33333333333334,2330,38.833333333333336,3000000000,77.25321888412017
506,4,4,8,63.25,126.5,2530,42.166666666666664,4000000000,94.86166007905139
498,11,3,14,35.57142857142857,166,2490,41.5,3000000000,72.28915662650603
855,16,3,19,45,285,4275,71.25,3000000000,42.10526315789474
436,5,4,9,48.44444444444444,109,2180,36.333333333333336,4000000000,110.09174311926604
211,3,4,7,30.142857142857142,52.75,1055,17.583333333333332,4000000000,227.48815165876778
523,8,4,12,43.583333333333336,130.75,2615,43.583333333333336,4000000000,91.77820267686424
607,10,4,14,43.357142857142854,151.75,3035,50.583333333333336,4000000000,79.07742998352553
1056,16,6,22,48,176,5280,88,6000000000,68.18181818181819
239,4,5,9,26.555555555555557,47.8,1195,19.916666666666668,5000000000,251.04602510460248
774,11,10,21,36.857142857142854,77.4,3870,64.5,10000000000,155.03875968992247
868,13,3,16,54.25,289.3333333333333,4340,72.33333333333333,3000000000,41.474654377880185
599,13,3,16,37.4375,199.66666666666666,2995,49.916666666666664,3000000000,60.10016694490819
801,10,7,17,47.11764705882353,114.42857142857143,4005,66.75,7000000000,104.86891385767791
1022,12,3,15,68.13333333333334,340.6666666666667,5110,85.16666666666667,3000000000,35.22504892367906
1054,9,5,14,75.28571428571429,210.8,5270,87.83333333333333,5000000000,56.92599620493359
634,9,5,14,45.285714285714285,126.8,3170,52.833333333333336,5000000000,94.6372239747634
1002,16,6,22,45.54545454545455,167,5010,83.5,6000000000,71.85628742514969
704,14,3,17,41.411764705882355,234.66666666666666,3520,58.666666666666664,3000000000,51.13636363636364
653,17,9,26,25.115384615384617,72.55555555555556,3265,54.416666666666664,9000000000,165.3905053598775
516,8,5,13,39.69230769230769,103.2,2580,43,5000000000,116.27906976744185
1162,19,7,26,44.69230769230769,166,5810,96.83333333333333,7000000000,72.28915662650603
527,5,7,12,43.916666666666664,75.28571428571429,2635,43.916666666666664,7000000000,159.39278937381405
377,7,3,10,37.7,125.66666666666667,1885,31.416666666666668,3000000000,95.49071618037135
366,3,7,10,36.6,52.285714285714285,1830,30.5,7000000000,229.5081967213115
439,11,3,14,31.357142857142858,146.33333333333334,2195,36.583333333333336,3000000000,82.00455580865604
357,5,4,9,39.666666666666664,89.25,1785,29.75,4000000000,134.45378151260505
663,4,5,9,73.66666666666667,132.6,3315,55.25,5000000000,90.49773755656108
563,14,6,20,28.15,93.83333333333333,2815,46.916666666666664,6000000000,127.88632326820604
1462,16,5,21,69.61904761904762,292.4,7310,121.83333333333333,5000000000,41.03967168262654
530,12,4,16,33.125,132.5,2650,44.166666666666664,4000000000,90.56603773584906
1313,20,11,31,42.354838709677416,119.36363636363636,6565,109.41666666666667,11000000000,100.53313023610052
911,14,3,17,53.588235294117645,303.6666666666667,4555,75.91666666666667,3000000000,39.51701427003293
565,9,4,13,43.46153846153846,141.25,2825,47.083333333333336,4000000000,84.95575221238938
428,9,3,12,35.666666666666664,142.66666666666666,2140,35.666666666666664,3000000000,84.11214953271029
878,10,4,14,62.714285714285715,219.5,4390,73.16666666666667,4000000000,54.66970387243735
331,6,3,9,36.77777777777778,110.33333333333333,1655,27.583333333333332,3000000000,108.76132930513594
896,12,9,21,42.666666666666664,99.55555555555556,4480,74.66666666666667,9000000000,120.53571428571428
967,14,4,18,53.72222222222222,241.75,4835,80.58333333333333,4000000000,49.638055842812825
1073,12,3,15,71.53333333333333,357.6666666666667,5365,89.41666666666667,3000000000,33.550792171481824
814,12,7,19,42.8421052631579,116.28571428571429,4070,67.83333333333333,7000000000,103.19410319410319
446,7,4,11,40.54545454545455,111.5,2230,37.166666666666664,4000000000,107.62331838565024
777,6,7,13,59.76923076923077,111,3885,64.75,7000000000,108.1081081081081
727,7,4,11,66.0909090909091,181.75,3635,60.583333333333336,4000000000,66.02475928473177
714,13,5,18,39.666666666666664,142.8,3570,59.5,5000000000,84.03361344537815
786,13,6,19,41.36842105263158,131,3930,65.5,6000000000,91.6030534351145
635,7,4,11,57.72727272727273,158.75,3175,52.916666666666664,4000000000,75.59055118110237
387,4,3,7,55.285714285714285,129,1935,32.25,3000000000,93.02325581395348
608,7,3,10,60.8,202.66666666666666,3040,50.666666666666664,3000000000,59.21052631578947
521,6,3,9,57.888888888888886,173.66666666666666,2605,43.416666666666664,3000000000,69.0978886756238
514,9,3,12,42.833333333333336,171.33333333333334,2570,42.833333333333336,3000000000,70.03891050583658
669,8,3,11,60.81818181818182,223,3345,55.75,3000000000,53.81165919282511
398,8,3,11,36.18181818181818,132.66666666666666,1990,33.166666666666664,3000000000,90.45226130653266
922,8,8,16,57.625,115.25,4610,76.83333333333333,8000000000,104.12147505422995
1085,20,3,23,47.17391304347826,361.6666666666667,5425,90.41666666666667,3000000000,33.17972350230414
870,18,3,21,41.42857142857143,290,4350,72.5,3000000000,41.37931034482759
1486,16,3,19,78.21052631578948,495.3333333333333,7430,123.83333333333333,3000000000,24.226110363391655
586,18,7,25,23.44,83.71428571428571,2930,48.833333333333336,7000000000,143.3447098976109
727,16,3,19,38.26315789473684,242.33333333333334,3635,60.583333333333336,3000000000,49.51856946354883
651,10,3,13,50.07692307692308,217,3255,54.25,3000000000,55.29953917050691
934,11,4,15,62.266666666666666,233.5,4670,77.83333333333333,4000000000,51.391862955032124
609,10,5,15,40.6,121.8,3045,50.75,5000000000,98.52216748768473
1046,9,12,21,49.80952380952381,87.16666666666667,5230,87.16666666666667,12000000000,137.66730401529637
535,5,4,9,59.44444444444444,133.75,2675,44.583333333333336,4000000000,89.7196261682243
1075,18,9,27,39.81481481481482,119.44444444444444,5375,89.58333333333333,9000000000,100.46511627906976
1574,20,13,33,47.696969696969695,121.07692307692308,7870,131.16666666666666,13000000000,99.11054637865313
580,9,4,13,44.61538461538461,145,2900,48.333333333333336,4000000000,82.75862068965517
313,7,3,10,31.3,104.33333333333333,1565,26.083333333333332,3000000000,115.01597444089457
1147,14,7,21,54.61904761904762,163.85714285714286,5735,95.58333333333333,7000000000,73.23452484742808
549,7,3,10,54.9,183,2745,45.75,3000000000,65.57377049180329
535,10,8,18,29.72222222222222,66.875,2675,44.583333333333336,8000000000,179.4392523364486
433,6,3,9,48.111111111111114,144.33333333333334,2165,36.083333333333336,3000000000,83.14087759815241
479,5,3,8,59.875,159.66666666666666,2395,39.916666666666664,3000000000,75.15657620041755
441,4,4,8,55.125,110.25,2205,36.75,4000000000,108.843537414966
310,7,3,10,31,103.33333333333333,1550,25.833333333333332,3000000000,116.12903225806453
375,10,3,13,28.846153846153847,125,1875,31.25,3000000000,96
595,8,6,14,42.5,99.16666666666667,2975,49.583333333333336,6000000000,121.00840336134453
431,4,4,8,53.875,107.75,2155,35.916666666666664,4000000000,111.36890951276102
752,13,6,19,39.578947368421055,125.33333333333333,3760,62.666666666666664,6000000000,95.74468085106383
566,8,4,12,47.166666666666664,141.5,2830,47.166666666666664,4000000000,84.80565371024736
503,4,3,7,71.85714285714286,167.66666666666666,2515,41.916666666666664,3000000000,71.57057654075547
332,5,3,8,41.5,110.66666666666667,1660,27.666666666666668,3000000000,108.43373493975903
302,3,3,6,50.333333333333336,100.66666666666667,1510,25.166666666666668,3000000000,119.20529801324503
741,8,4,12,61.75,185.25,3705,61.75,4000000000,64.77732793522267
500,5,4,9,55.55555555555556,125,2500,41.666666666666664,4000000000,96
659,8,5,13,50.69230769230769,131.8,3295,54.916666666666664,5000000000,91.04704097116844
303,6,3,9,33.666666666666664,101,1515,25.25,3000000000,118.81188118811882
494,7,3,10,49.4,164.66666666666666,2470,41.166666666666664,3000000000,72.87449392712551
649,16,3,19,34.1578947368421,216.33333333333334,3245,54.083333333333336,3000000000,55.46995377503852
373,7,3,10,37.3,124.33333333333333,1865,31.083333333333332,3000000000,96.514745308311
699,8,5,13,53.76923076923077,139.8,3495,58.25,5000000000,85.83690987124464
273,4,4,8,34.125,68.25,1365,22.75,4000000000,175.82417582417582
383,4,3,7,54.714285714285715,127.66666666666667,1915,31.916666666666668,3000000000,93.99477806788512
1080,24,3,27,40,360,5400,90,3000000000,33.33333333333333
641,15,4,19,33.73684210526316,160.25,3205,53.416666666666664,4000000000,74.88299531981279
206,6,5,11,18.727272727272727,41.2,1030,17.166666666666668,5000000000,291.26213592233006
1244,16,7,23,54.08695652173913,177.71428571428572,6220,103.66666666666667,7000000000,67.52411575562701
600,5,7,12,50,85.71428571428571,3000,50,7000000000,140
1183,18,3,21,56.333333333333336,394.3333333333333,5915,98.58333333333333,3000000000,30.431107354184277
666,6,4,10,66.6,166.5,3330,55.5,4000000000,72.07207207207207
412,9,3,12,34.333333333333336,137.33333333333334,2060,34.333333333333336,3000000000,87.37864077669902
626,16,4,20,31.3,156.5,3130,52.166666666666664,4000000000,76.6773162939297
153,6,3,9,17,51,765,12.75,3000000000,235.2941176470588
519,4,3,7,74.14285714285714,173,2595,43.25,3000000000,69.36416184971098
872,8,3,11,79.27272727272727,290.6666666666667,4360,72.66666666666667,3000000000,41.28440366972477
660,7,7,14,47.142857142857146,94.28571428571429,3300,55,7000000000,127.27272727272727
741,14,3,17,43.588235294117645,247,3705,61.75,3000000000,48.582995951417004
441,7,3,10,44.1,147,2205,36.75,3000000000,81.63265306122449
738,10,3,13,56.76923076923077,246,3690,61.5,3000000000,48.78048780487805
1559,21,3,24,64.95833333333333,519.6666666666666,7795,129.91666666666666,3000000000,23.091725465041694
1025,11,8,19,53.94736842105263,128.125,5125,85.41666666666667,8000000000,93.65853658536585
711,12,3,15,47.4,237,3555,59.25,3000000000,50.63291139240506
787,8,5,13,60.53846153846154,157.4,3935,65.58333333333333,5000000000,76.23888182973316
460,10,3,13,35.38461538461539,153.33333333333334,2300,38.333333333333336,3000000000,78.26086956521739
705,15,6,21,33.57142857142857,117.5,3525,58.75,6000000000,102.1276595744681
377,5,6,11,34.27272727272727,62.833333333333336,1885,31.416666666666668,6000000000,190.9814323607427
422,4,4,8,52.75,105.5,2110,35.166666666666664,4000000000,113.74407582938389
649,12,3,15,43.266666666666666,216.33333333333334,3245,54.083333333333336,3000000000,55.46995377503852
1257,22,9,31,40.54838709677419,139.66666666666666,6285,104.75,9000000000,85.91885441527445
277,5,3,8,34.625,92.33333333333333,1385,23.083333333333332,3000000000,129.9638989169675
805,15,4,19,42.36842105263158,201.25,4025,67.08333333333333,4000000000,59.62732919254659
1130,10,3,13,86.92307692307692,376.6666666666667,5650,94.16666666666667,3000000000,31.858407079646017
526,9,9,18,29.22222222222222,58.44444444444444,2630,43.833333333333336,9000000000,205.3231939163498
510,7,3,10,51,170,2550,42.5,3000000000,70.58823529411764
755,13,3,16,47.1875,251.66666666666666,3775,62.916666666666664,3000000000,47.682119205298015
545,12,3,15,36.333333333333336,181.66666666666666,2725,45.416666666666664,3000000000,66.05504587155963
195,3,3,6,32.5,65,975,16.25,3000000000,184.6153846153846
574,11,5,16,35.875,114.8,2870,47.833333333333336,5000000000,104.52961672473867
298,10,3,13,22.923076923076923,99.33333333333333,1490,24.833333333333332,3000000000,120.8053691275168
825,19,3,22,37.5,275,4125,68.75,3000000000,43.63636363636363
327,7,3,10,32.7,109,1635,27.25,3000000000,110.09174311926604
1061,7,5,12,88.41666666666667,212.2,5305,88.41666666666667,5000000000,56.55042412818096
325,7,3,10,32.5,108.33333333333333,1625,27.083333333333332,3000000000,110.76923076923077
1409,19,7,26,54.19230769230769,201.28571428571428,7045,117.41666666666667,7000000000,59.61674946770759
378,5,5,10,37.8,75.6,1890,31.5,5000000000,158.7301587301587
221,9,4,13,17,55.25,1105,18.416666666666668,4000000000,217.1945701357466
765,16,5,21,36.42857142857143,153,3825,63.75,5000000000,78.4313725490196
445,5,3,8,55.625,148.33333333333334,2225,37.083333333333336,3000000000,80.89887640449437
544,11,5,16,34,108.8,2720,45.333333333333336,5000000000,110.29411764705881
678,11,7,18,37.666666666666664,96.85714285714286,3390,56.5,7000000000,123.8938053097345
498,8,3,11,45.27272727272727,166,2490,41.5,3000000000,72.28915662650603
308,5,3,8,38.5,102.66666666666667,1540,25.666666666666668,3000000000,116.88311688311687
667,8,4,12,55.583333333333336,166.75,3335,55.583333333333336,4000000000,71.9640179910045
598,8,8,16,37.375,74.75,2990,49.833333333333336,8000000000,160.5351170568562
420,10,4,14,30,105,2100,35,4000000000,114.28571428571428
619,9,3,12,51.583333333333336,206.33333333333334,3095,51.583333333333336,3000000000,58.158319870759286
512,9,3,12,42.666666666666664,170.66666666666666,2560,42.666666666666664,3000000000,70.3125
625,9,5,14,44.642857142857146,125,3125,52.083333333333336,5000000000,96
871,16,5,21,41.476190476190474,174.2,4355,72.58333333333333,5000000000,68.88633754305397
439,5,4,9,48.77777777777778,109.75,2195,36.583333333333336,4000000000,109.3394077448747
408,5,3,8,51,136,2040,34,3000000000,88.23529411764706
1031,16,3,19,54.26315789473684,343.6666666666667,5155,85.91666666666667,3000000000,34.91755577109602
334,3,3,6,55.666666666666664,111.33333333333333,1670,27.833333333333332,3000000000,107.78443113772455
926,14,3,17,54.470588235294116,308.6666666666667,4630,77.16666666666667,3000000000,38.8768898488121
325,4,3,7,46.42857142857143,108.33333333333333,1625,27.083333333333332,3000000000,110.76923076923077
989,20,3,23,43,329.6666666666667,4945,82.41666666666667,3000000000,36.40040444893832
599,9,3,12,49.916666666666664,199.66666666666666,2995,49.916666666666664,3000000000,60.10016694490819
735,15,3,18,40.833333333333336,245,3675,61.25,3000000000,48.9795918367347
1024,20,9,29,35.310344827586206,113.77777777777777,5120,85.33333333333333,9000000000,105.46875
889,14,9,23,38.65217391304348,98.77777777777777,4445,74.08333333333333,9000000000,121.48481439820023
618,9,5,14,44.142857142857146,123.6,3090,51.5,5000000000,97.08737864077669
530,11,3,14,37.857142857142854,176.66666666666666,2650,44.166666666666664,3000000000,67.9245283018868
808,19,9,28,28.857142857142858,89.77777777777777,4040,67.33333333333333,9000000000,133.66336633663366
391,6,4,10,39.1,97.75,1955,32.583333333333336,4000000000,122.76214833759589
1103,22,3,25,44.12,367.6666666666667,5515,91.91666666666667,3000000000,32.638259292837716
571,7,4,11,51.90909090909091,142.75,2855,47.583333333333336,4000000000,84.0630472854641
813,7,4,11,73.9090909090909,203.25,4065,67.75,4000000000,59.04059040590406
891,19,3,22,40.5,297,4455,74.25,3000000000,40.4040404040404
816,11,8,19,42.94736842105263,102,4080,68,8000000000,117.6470588235294
836,21,9,30,27.866666666666667,92.88888888888889,4180,69.66666666666667,9000000000,129.18660287081337
787,7,3,10,78.7,262.3333333333333,3935,65.58333333333333,3000000000,45.7433290978399
420,11,3,14,30,140,2100,35,3000000000,85.71428571428572
1143,18,3,21,54.42857142857143,381,5715,95.25,3000000000,31.496062992125985
563,13,3,16,35.1875,187.66666666666666,2815,46.916666666666664,3000000000,63.94316163410302
531,9,3,12,44.25,177,2655,44.25,3000000000,67.79661016949153
877,16,4,20,43.85,219.25,4385,73.08333333333333,4000000000,54.73204104903079
329,5,5,10,32.9,65.8,1645,27.416666666666668,5000000000,182.370820668693
757,11,5,16,47.3125,151.4,3785,63.083333333333336,5000000000,79.26023778071334
571,7,3,10,57.1,190.33333333333334,2855,47.583333333333336,3000000000,63.047285464098074
906,18,3,21,43.142857142857146,302,4530,75.5,3000000000,39.735099337748345
444,8,3,11,40.36363636363637,148,2220,37,3000000000,81.08108108108108
604,11,3,14,43.142857142857146,201.33333333333334,3020,50.333333333333336,3000000000,59.602649006622514
402,9,3,12,33.5,134,2010,33.5,3000000000,89.55223880597015
144,4,3,7,20.571428571428573,48,720,12,3000000000,250
1039,13,3,16,64.9375,346.3333333333333,5195,86.58333333333333,3000000000,34.64870067372474
607,5,3,8,75.875,202.33333333333334,3035,50.583333333333336,3000000000,59.308072487644154
605,9,3,12,50.416666666666664,201.66666666666666,3025,50.416666666666664,3000000000,59.50413223140496
531,7,3,10,53.1,177,2655,44.25,3000000000,67.79661016949153
579,8,4,12,48.25,144.75,2895,48.25,4000000000,82.90155440414507
541,7,4,11,49.18181818181818,135.25,2705,45.083333333333336,4000000000,88.724584103512
228,6,4,10,22.8,57,1140,19,4000000000,210.52631578947367
1110,19,4,23,48.26086956521739,277.5,5550,92.5,4000000000,43.24324324324324
641,7,3,10,64.1,213.66666666666666,3205,53.416666666666664,3000000000,56.1622464898596
629,15,4,19,33.10526315789474,157.25,3145,52.416666666666664,4000000000,76.31160572337043
730,12,3,15,48.666666666666664,243.33333333333334,3650,60.833333333333336,3000000000,49.31506849315068
557,10,5,15,37.13333333333333,111.4,2785,46.416666666666664,5000000000,107.71992818671454
539,11,3,14,38.5,179.66666666666666,2695,44.916666666666664,3000000000,66.79035250463822
451,5,3,8,56.375,150.33333333333334,2255,37.583333333333336,3000000000,79.82261640798227
476,6,3,9,52.888888888888886,158.66666666666666,2380,39.666666666666664,3000000000,75.63025210084035
549,7,4,11,49.90909090909091,137.25,2745,45.75,4000000000,87.43169398907104
722,13,8,21,34.38095238095238,90.25,3610,60.166666666666664,8000000000,132.9639889196676
691,10,7,17,40.64705882352941,98.71428571428571,3455,57.583333333333336,7000000000,121.5629522431259
520,6,3,9,57.77777777777778,173.33333333333334,2600,43.333333333333336,3000000000,69.23076923076923
703,15,3,18,39.05555555555556,234.33333333333334,3515,58.583333333333336,3000000000,51.209103840682786
1108,16,9,25,44.32,123.11111111111111,5540,92.33333333333333,9000000000,97.47292418772564
744,15,3,18,41.333333333333336,248,3720,62,3000000000,48.387096774193544
703,15,4,19,37,175.75,3515,58.583333333333336,4000000000,68.27880512091038
627,13,9,22,28.5,69.66666666666667,3135,52.25,9000000000,172.2488038277512
962,13,6,19,50.63157894736842,160.33333333333334,4810,80.16666666666667,6000000000,74.84407484407484
329,4,3,7,47,109.66666666666667,1645,27.416666666666668,3000000000,109.4224924012158
898,18,3,21,42.76190476190476,299.3333333333333,4490,74.83333333333333,3000000000,40.0890868596882
291,7,3,10,29.1,97,1455,24.25,3000000000,123.71134020618557
763,6,6,12,63.583333333333336,127.16666666666667,3815,63.583333333333336,6000000000,94.36435124508517
367,4,3,7,52.42857142857143,122.33333333333333,1835,30.583333333333332,3000000000,98.09264305177112
856,7,7,14,61.142857142857146,122.28571428571429,4280,71.33333333333333,7000000000,98.13084112149534
786,10,10,20,39.3,78.6,3930,65.5,10000000000,152.67175572519085
631,9,4,13,48.53846153846154,157.75,3155,52.583333333333336,4000000000,76.06973058637084
1245,17,3,20,62.25,415,6225,103.75,3000000000,28.91566265060241
634,5,3,8,79.25,211.33333333333334,3170,52.833333333333336,3000000000,56.78233438485804
432,5,5,10,43.2,86.4,2160,36,5000000000,138.88888888888889
854,16,3,19,44.94736842105263,284.6666666666667,4270,71.16666666666667,3000000000,42.15456674473067
819,11,7,18,45.5,117,4095,68.25,7000000000,102.56410256410255
633,9,5,14,45.214285714285715,126.6,3165,52.75,5000000000,94.7867298578199
954,25,3,28,34.07142857142857,318,4770,79.5,3000000000,37.735849056603776
716,21,8,29,24.689655172413794,89.5,3580,59.666666666666664,8000000000,134.0782122905028
468,7,4,11,42.54545454545455,117,2340,39,4000000000,102.56410256410255
607,4,5,9,67.44444444444444,121.4,3035,50.583333333333336,5000000000,98.84678747940691
661,7,3,10,66.1,220.33333333333334,3305,55.083333333333336,3000000000,54.462934947049924
361,7,3,10,36.1,120.33333333333333,1805,30.083333333333332,3000000000,99.7229916897507
513,13,3,16,32.0625,171,2565,42.75,3000000000,70.17543859649123
330,5,3,8,41.25,110,1650,27.5,3000000000,109.0909090909091
323,7,3,10,32.3,107.66666666666667,1615,26.916666666666668,3000000000,111.45510835913312
395,6,3,9,43.888888888888886,131.66666666666666,1975,32.916666666666664,3000000000,91.13924050632912
319,6,3,9,35.44444444444444,106.33333333333333,1595,26.583333333333332,3000000000,112.85266457680251
485,7,3,10,48.5,161.66666666666666,2425,40.416666666666664,3000000000,74.22680412371135
585,11,3,14,41.785714285714285,195,2925,48.75,3000000000,61.53846153846153
748,10,6,16,46.75,124.66666666666667,3740,62.333333333333336,6000000000,96.2566844919786
626,10,3,13,48.15384615384615,208.66666666666666,3130,52.166666666666664,3000000000,57.50798722044728
478,7,3,10,47.8,159.33333333333334,2390,39.833333333333336,3000000000,75.31380753138075
333,4,3,7,47.57142857142857,111,1665,27.75,3000000000,108.1081081081081
442,5,3,8,55.25,147.33333333333334,2210,36.833333333333336,3000000000,81.44796380090497
438,3,3,6,73,146,2190,36.5,3000000000,82.1917808219178
833,17,13,30,27.766666666666666,64.07692307692308,4165,69.41666666666667,13000000000,187.27490996398558
1024,18,12,30,34.13333333333333,85.33333333333333,5120,85.33333333333333,12000000000,140.625
699,5,3,8,87.375,233,3495,58.25,3000000000,51.50214592274678
751,7,3,10,75.1,250.33333333333334,3755,62.583333333333336,3000000000,47.93608521970706
362,9,3,12,30.166666666666668,120.66666666666667,1810,30.166666666666668,3000000000,99.4475138121547
638,8,3,11,58,212.66666666666666,3190,53.166666666666664,3000000000,56.426332288401255
860,13,4,17,50.588235294117645,215,4300,71.66666666666667,4000000000,55.813953488372086
324,5,3,8,40.5,108,1620,27,3000000000,111.1111111111111
211,4,3,7,30.142857142857142,70.33333333333333,1055,17.583333333333332,3000000000,170.61611374407585
885,16,3,19,46.578947368421055,295,4425,73.75,3000000000,40.67796610169491
472,12,3,15,31.466666666666665,157.33333333333334,2360,39.333333333333336,3000000000,76.27118644067795
591,7,5,12,49.25,118.2,2955,49.25,5000000000,101.52284263959392
508,6,3,9,56.44444444444444,169.33333333333334,2540,42.333333333333336,3000000000,70.86614173228345
568,10,3,13,43.69230769230769,189.33333333333334,2840,47.333333333333336,3000000000,63.38028169014084
972,14,3,17,57.1764705882353,324,4860,81,3000000000,37.03703703703704
727,16,3,19,38.26315789473684,242.33333333333334,3635,60.583333333333336,3000000000,49.51856946354883
571,10,4,14,40.785714285714285,142.75,2855,47.583333333333336,4000000000,84.0630472854641
315,7,3,10,31.5,105,1575,26.25,3000000000,114.28571428571428
545,10,3,13,41.92307692307692,181.66666666666666,2725,45.416666666666664,3000000000,66.05504587155963
766,6,5,11,69.63636363636364,153.2,3830,63.833333333333336,5000000000,78.32898172323759
569,5,3,8,71.125,189.66666666666666,2845,47.416666666666664,3000000000,63.26889279437611
1044,12,5,17,61.411764705882355,208.8,5220,87,5000000000,57.47126436781609
734,15,5,20,36.7,146.8,3670,61.166666666666664,5000000000,81.74386920980928
367,4,5,9,40.77777777777778,73.4,1835,30.583333333333332,5000000000,163.48773841961855
956,10,7,17,56.23529411764706,136.57142857142858,4780,79.66666666666667,7000000000,87.86610878661087
467,10,5,15,31.133333333333333,93.4,2335,38.916666666666664,5000000000,128.47965738758032
501,13,3,16,31.3125,167,2505,41.75,3000000000,71.85628742514969
1030,10,3,13,79.23076923076923,343.3333333333333,5150,85.83333333333333,3000000000,34.95145631067962
372,10,3,13,28.615384615384617,124,1860,31,3000000000,96.77419354838709
509,10,3,13,39.15384615384615,169.66666666666666,2545,42.416666666666664,3000000000,70.7269155206287
372,7,3,10,37.2,124,1860,31,3000000000,96.77419354838709
402,11,3,14,28.714285714285715,134,2010,33.5,3000000000,89.55223880597015
730,10,4,14,52.142857142857146,182.5,3650,60.833333333333336,4000000000,65.75342465753424
620,9,3,12,51.666666666666664,206.66666666666666,3100,51.666666666666664,3000000000,58.06451612903226
521,11,5,16,32.5625,104.2,2605,43.416666666666664,5000000000,115.16314779270634
631,7,7,14,45.07142857142857,90.14285714285714,3155,52.583333333333336,7000000000,133.12202852614897
535,6,7,13,41.15384615384615,76.42857142857143,2675,44.583333333333336,7000000000,157.00934579439252
569,8,4,12,47.416666666666664,142.25,2845,47.416666666666664,4000000000,84.3585237258348
579,9,3,12,48.25,193,2895,48.25,3000000000,62.17616580310881
828,11,5,16,51.75,165.6,4140,69,5000000000,72.46376811594203
653,4,3,7,93.28571428571429,217.66666666666666,3265,54.416666666666664,3000000000,55.1301684532925
1030,25,3,28,36.785714285714285,343.3333333333333,5150,85.83333333333333,3000000000,34.95145631067962
821,12,3,15,54.733333333333334,273.6666666666667,4105,68.41666666666667,3000000000,43.848964677222895
267,6,3,9,29.666666666666668,89,1335,22.25,3000000000,134.83146067415728
548,9,3,12,45.666666666666664,182.66666666666666,2740,45.666666666666664,3000000000,65.69343065693431
253,4,3,7,36.142857142857146,84.33333333333333,1265,21.083333333333332,3000000000,142.2924901185771
681,7,3,10,68.1,227,3405,56.75,3000000000,52.86343612334802
495,7,5,12,41.25,99,2475,41.25,5000000000,121.21212121212122
336,5,3,8,42,112,1680,28,3000000000,107.14285714285715
333,6,5,11,30.272727272727273,66.6,1665,27.75,5000000000,180.1801801801802
304,5,3,8,38,101.33333333333333,1520,25.333333333333332,3000000000,118.42105263157895
564,8,3,11,51.27272727272727,188,2820,47,3000000000,63.829787234042556
435,9,3,12,36.25,145,2175,36.25,3000000000,82.75862068965517
737,9,3,12,61.416666666666664,245.66666666666666,3685,61.416666666666664,3000000000,48.846675712347356
556,6,3,9,61.77777777777778,185.33333333333334,2780,46.333333333333336,3000000000,64.74820143884892
705,13,3,16,44.0625,235,3525,58.75,3000000000,51.06382978723405
883,13,4,17,51.94117647058823,220.75,4415,73.58333333333333,4000000000,54.36013590033975
575,10,3,13,44.23076923076923,191.66666666666666,2875,47.916666666666664,3000000000,62.608695652173914
410,6,6,12,34.166666666666664,68.33333333333333,2050,34.166666666666664,6000000000,175.609756097561
406,4,3,7,58,135.33333333333334,2030,33.833333333333336,3000000000,88.66995073891624
415,9,3,12,34.583333333333336,138.33333333333334,2075,34.583333333333336,3000000000,86.74698795180721
576,14,5,19,30.31578947368421,115.2,2880,48,5000000000,104.16666666666667
677,13,3,16,42.3125,225.66666666666666,3385,56.416666666666664,3000000000,53.17577548005909
820,15,3,18,45.55555555555556,273.3333333333333,4100,68.33333333333333,3000000000,43.90243902439025
930,15,6,21,44.285714285714285,155,4650,77.5,6000000000,77.41935483870968
641,7,3,10,64.1,213.66666666666666,3205,53.416666666666664,3000000000,56.1622464898596
730,13,3,16,45.625,243.33333333333334,3650,60.833333333333336,3000000000,49.31506849315068
808,16,7,23,35.130434782608695,115.42857142857143,4040,67.33333333333333,7000000000,103.96039603960396
645,11,3,14,46.07142857142857,215,3225,53.75,3000000000,55.81395348837209
516,8,3,11,46.90909090909091,172,2580,43,3000000000,69.76744186046511
592,10,4,14,42.285714285714285,148,2960,49.333333333333336,4000000000,81.08108108108108
447,9,5,14,31.928571428571427,89.4,2235,37.25,5000000000,134.2281879194631
871,15,3,18,48.388888888888886,290.3333333333333,4355,72.58333333333333,3000000000,41.33180252583238
733,19,3,22,33.31818181818182,244.33333333333334,3665,61.083333333333336,3000000000,49.113233287858115
527,11,3,14,37.642857142857146,175.66666666666666,2635,43.916666666666664,3000000000,68.3111954459203
571,10,3,13,43.92307692307692,190.33333333333334,2855,47.583333333333336,3000000000,63.047285464098074
457,6,3,9,50.77777777777778,152.33333333333334,2285,38.083333333333336,3000000000,78.77461706783369
602,11,3,14,43,200.66666666666666,3010,50.166666666666664,3000000000,59.800664451827245
853,12,4,16,53.3125,213.25,4265,71.08333333333333,4000000000,56.27198124267292
950,11,3,14,67.85714285714286,316.6666666666667,4750,79.16666666666667,3000000000,37.89473684210526
314,5,3,8,39.25,104.66666666666667,1570,26.166666666666668,3000000000,114.64968152866241
769,12,3,15,51.266666666666666,256.3333333333333,3845,64.08333333333333,3000000000,46.81404421326398
484,5,3,8,60.5,161.33333333333334,2420,40.333333333333336,3000000000,74.3801652892562
837,8,3,11,76.0909090909091,279,4185,69.75,3000000000,43.01075268817204
809,9,3,12,67.41666666666667,269.6666666666667,4045,67.41666666666667,3000000000,44.499381953028426
314,6,4,10,31.4,78.5,1570,26.166666666666668,4000000000,152.86624203821657
744,10,3,13,57.23076923076923,248,3720,62,3000000000,48.387096774193544
380,6,3,9,42.22222222222222,126.66666666666667,1900,31.666666666666668,3000000000,94.73684210526316
472,11,3,14,33.714285714285715,157.33333333333334,2360,39.333333333333336,3000000000,76.27118644067795
279,4,3,7,39.857142857142854,93,1395,23.25,3000000000,129.03225806451613
769,13,8,21,36.61904761904762,96.125,3845,64.08333333333333,8000000000,124.83745123537062
363,7,3,10,36.3,121,1815,30.25,3000000000,99.17355371900827
424,12,3,15,28.266666666666666,141.33333333333334,2120,35.333333333333336,3000000000,84.90566037735849
651,18,7,25,26.04,93,3255,54.25,7000000000,129.03225806451613
745,10,3,13,57.30769230769231,248.33333333333334,3725,62.083333333333336,3000000000,48.32214765100671
765,15,3,18,42.5,255,3825,63.75,3000000000,47.05882352941176
756,15,3,18,42,252,3780,63,3000000000,47.61904761904762
367,3,3,6,61.166666666666664,122.33333333333333,1835,30.583333333333332,3000000000,98.09264305177112
524,12,3,15,34.93333333333333,174.66666666666666,2620,43.666666666666664,3000000000,68.70229007633587
553,11,3,14,39.5,184.33333333333334,2765,46.083333333333336,3000000000,65.09945750452079
334,7,3,10,33.4,111.33333333333333,1670,27.833333333333332,3000000000,107.78443113772455
664,7,3,10,66.4,221.33333333333334,3320,55.333333333333336,3000000000,54.21686746987952
323,4,3,7,46.142857142857146,107.66666666666667,1615,26.916666666666668,3000000000,111.45510835913312
668,8,3,11,60.72727272727273,222.66666666666666,3340,55.666666666666664,3000000000,53.89221556886228
394,6,4,10,39.4,98.5,1970,32.833333333333336,4000000000,121.82741116751268
767,13,3,16,47.9375,255.66666666666666,3835,63.916666666666664,3000000000,46.9361147327249
686,11,6,17,40.35294117647059,114.33333333333333,3430,57.166666666666664,6000000000,104.95626822157435
702,6,5,11,63.81818181818182,140.4,3510,58.5,5000000000,85.47008547008546
1046,22,3,25,41.84,348.6666666666667,5230,87.16666666666667,3000000000,34.41682600382409
274,5,3,8,34.25,91.33333333333333,1370,22.833333333333332,3000000000,131.38686131386862
693,7,4,11,63,173.25,3465,57.75,4000000000,69.26406926406926
400,5,4,9,44.44444444444444,100,2000,33.333333333333336,4000000000,119.99999999999999
783,11,5,16,48.9375,156.6,3915,65.25,5000000000,76.62835249042146
628,7,6,13,48.30769230769231,104.66666666666667,3140,52.333333333333336,6000000000,114.64968152866241
779,10,3,13,59.92307692307692,259.6666666666667,3895,64.91666666666667,3000000000,46.21309370988446
667,9,7,16,41.6875,95.28571428571429,3335,55.583333333333336,7000000000,125.93703148425786
1121,11,4,15,74.73333333333333,280.25,5605,93.41666666666667,4000000000,42.81891168599465
405,6,4,10,40.5,101.25,2025,33.75,4000000000,118.51851851851852
583,10,3,13,44.84615384615385,194.33333333333334,2915,48.583333333333336,3000000000,61.74957118353345
698,9,6,15,46.53333333333333,116.33333333333333,3490,58.166666666666664,6000000000,103.1518624641834
1031,17,7,24,42.958333333333336,147.28571428571428,5155,85.91666666666667,7000000000,81.47429679922405
542,10,3,13,41.69230769230769,180.66666666666666,2710,45.166666666666664,3000000000,66.42066420664207
903,9,3,12,75.25,301,4515,75.25,3000000000,39.8671096345515
426,6,5,11,38.72727272727273,85.2,2130,35.5,5000000000,140.8450704225352
883,11,6,17,51.94117647058823,147.16666666666666,4415,73.58333333333333,6000000000,81.54020385050963
414,4,3,7,59.142857142857146,138,2070,34.5,3000000000,86.95652173913044
804,12,8,20,40.2,100.5,4020,67,8000000000,119.40298507462687
727,8,5,13,55.92307692307692,145.4,3635,60.583333333333336,5000000000,82.53094910591471
863,11,6,17,50.76470588235294,143.83333333333334,4315,71.91666666666667,6000000000,83.42989571263034
366,5,4,9,40.666666666666664,91.5,1830,30.5,4000000000,131.14754098360658
580,13,3,16,36.25,193.33333333333334,2900,48.333333333333336,3000000000,62.068965517241374
382,9,3,12,31.833333333333332,127.33333333333333,1910,31.833333333333332,3000000000,94.24083769633508
747,10,4,14,53.357142857142854,186.75,3735,62.25,4000000000,64.2570281124498
571,10,3,13,43.92307692307692,190.33333333333334,2855,47.583333333333336,3000000000,63.047285464098074
574,15,6,21,27.333333333333332,95.66666666666667,2870,47.833333333333336,6000000000,125.4355400696864
686,9,3,12,57.166666666666664,228.66666666666666,3430,57.166666666666664,3000000000,52.478134110787174
604,10,6,16,37.75,100.66666666666667,3020,50.333333333333336,6000000000,119.20529801324503
665,14,8,22,30.227272727272727,83.125,3325,55.416666666666664,8000000000,144.3609022556391
950,15,3,18,52.77777777777778,316.6666666666667,4750,79.16666666666667,3000000000,37.89473684210526
707,12,3,15,47.13333333333333,235.66666666666666,3535,58.916666666666664,3000000000,50.91937765205092
329,5,3,8,41.125,109.66666666666667,1645,27.416666666666668,3000000000,109.4224924012158
726,15,7,22,33,103.71428571428571,3630,60.5,7000000000,115.70247933884298
948,17,3,20,47.4,316,4740,79,3000000000,37.974683544303794
332,7,3,10,33.2,110.66666666666667,1660,27.666666666666668,3000000000,108.43373493975903
556,10,3,13,42.76923076923077,185.33333333333334,2780,46.333333333333336,3000000000,64.74820143884892
814,12,3,15,54.266666666666666,271.3333333333333,4070,67.83333333333333,3000000000,44.22604422604423
507,4,7,11,46.09090909090909,72.42857142857143,2535,42.25,7000000000,165.68047337278108
1197,12,3,15,79.8,399,5985,99.75,3000000000,30.075187969924812
509,4,5,9,56.55555555555556,101.8,2545,42.416666666666664,5000000000,117.87819253438116
533,6,3,9,59.22222222222222,177.66666666666666,2665,44.416666666666664,3000000000,67.5422138836773
802,8,3,11,72.9090909090909,267.3333333333333,4010,66.83333333333333,3000000000,44.887780548628434
458,8,3,11,41.63636363636363,152.66666666666666,2290,38.166666666666664,3000000000,78.60262008733625
474,7,3,10,47.4,158,2370,39.5,3000000000,75.94936708860759
254,3,3,6,42.333333333333336,84.66666666666667,1270,21.166666666666668,3000000000,141.7322834645669
532,9,5,14,38,106.4,2660,44.333333333333336,5000000000,112.78195488721805
683,6,3,9,75.88888888888889,227.66666666666666,3415,56.916666666666664,3000000000,52.7086383601757
1032,11,6,17,60.705882352941174,172,5160,86,6000000000,69.76744186046511
556,10,4,14,39.714285714285715,139,2780,46.333333333333336,4000000000,86.33093525179855
948,20,3,23,41.21739130434783,316,4740,79,3000000000,37.974683544303794
821,17,3,20,41.05,273.6666666666667,4105,68.41666666666667,3000000000,43.848964677222895
978,10,10,20,48.9,97.8,4890,81.5,10000000000,122.69938650306747
864,14,3,17,50.8235294117647,288,4320,72,3000000000,41.666666666666664
502,5,5,10,50.2,100.4,2510,41.833333333333336,5000000000,119.5219123505976
650,6,4,10,65,162.5,3250,54.166666666666664,4000000000,73.84615384615385
796,12,3,15,53.06666666666667,265.3333333333333,3980,66.33333333333333,3000000000,45.22613065326633
386,5,3,8,48.25,128.66666666666666,1930,32.166666666666664,3000000000,93.26424870466322
1034,14,6,20,51.7,172.33333333333334,5170,86.16666666666667,6000000000,69.63249516441006
462,7,3,10,46.2,154,2310,38.5,3000000000,77.92207792207792
784,14,3,17,46.11764705882353,261.3333333333333,3920,65.33333333333333,3000000000,45.91836734693878
555,9,6,15,37,92.5,2775,46.25,6000000000,129.72972972972974
800,14,5,19,42.10526315789474,160,4000,66.66666666666667,5000000000,75
614,6,3,9,68.22222222222223,204.66666666666666,3070,51.166666666666664,3000000000,58.63192182410423
506,8,4,12,42.166666666666664,126.5,2530,42.166666666666664,4000000000,94.86166007905139
883,14,5,19,46.473684210526315,176.6,4415,73.58333333333333,5000000000,67.95016987542469
530,9,5,14,37.857142857142854,106,2650,44.166666666666664,5000000000,113.20754716981132
684,8,5,13,52.61538461538461,136.8,3420,57,5000000000,87.71929824561404
432,5,3,8,54,144,2160,36,3000000000,83.33333333333333
919,12,7,19,48.36842105263158,131.28571428571428,4595,76.58333333333333,7000000000,91.40369967355822
573,9,4,13,44.07692307692308,143.25,2865,47.75,4000000000,83.7696335078534
819,13,3,16,51.1875,273,4095,68.25,3000000000,43.956043956043956
1101,9,9,18,61.166666666666664,122.33333333333333,5505,91.75,9000000000,98.09264305177112
524,13,5,18,29.11111111111111,104.8,2620,43.666666666666664,5000000000,114.50381679389312
1022,11,6,17,60.11764705882353,170.33333333333334,5110,85.16666666666667,6000000000,70.45009784735812
517,12,7,19,27.210526315789473,73.85714285714286,2585,43.083333333333336,7000000000,162.47582205029013
173,4,3,7,24.714285714285715,57.666666666666664,865,14.416666666666666,3000000000,208.09248554913293
738,16,3,19,38.8421052631579,246,3690,61.5,3000000000,48.78048780487805
663,10,3,13,51,221,3315,55.25,3000000000,54.29864253393665
517,7,4,11,47,129.25,2585,43.083333333333336,4000000000,92.84332688588007
619,7,3,10,61.9,206.33333333333334,3095,51.583333333333336,3000000000,58.158319870759286
388,9,3,12,32.333333333333336,129.33333333333334,1940,32.333333333333336,3000000000,92.78350515463917
353,6,3,9,39.22222222222222,117.66666666666667,1765,29.416666666666668,3000000000,101.98300283286119
639,14,5,19,33.63157894736842,127.8,3195,53.25,5000000000,93.89671361502347
198,5,3,8,24.75,66,990,16.5,3000000000,181.8181818181818
593,13,3,16,37.0625,197.66666666666666,2965,49.416666666666664,3000000000,60.708263069139974
526,12,3,15,35.06666666666667,175.33333333333334,2630,43.833333333333336,3000000000,68.44106463878326
781,14,4,18,43.388888888888886,195.25,3905,65.08333333333333,4000000000,61.45966709346992
1268,24,3,27,46.96296296296296,422.6666666666667,6340,105.66666666666667,3000000000,28.39116719242902
423,7,4,11,38.45454545454545,105.75,2115,35.25,4000000000,113.47517730496455
570,11,3,14,40.714285714285715,190,2850,47.5,3000000000,63.1578947368421
651,8,3,11,59.18181818181818,217,3255,54.25,3000000000,55.29953917050691
1367,27,9,36,37.97222222222222,151.88888888888889,6835,113.91666666666667,9000000000,79.00512070226773
368,5,3,8,46,122.66666666666667,1840,30.666666666666668,3000000000,97.82608695652173
528,13,8,21,25.142857142857142,66,2640,44,8000000000,181.8181818181818
525,10,3,13,40.38461538461539,175,2625,43.75,3000000000,68.57142857142857
359,7,3,10,35.9,119.66666666666667,1795,29.916666666666668,3000000000,100.27855153203343
914,11,10,21,43.523809523809526,91.4,4570,76.16666666666667,10000000000,131.29102844638948
672,6,3,9,74.66666666666667,224,3360,56,3000000000,53.57142857142858
283,8,3,11,25.727272727272727,94.33333333333333,1415,23.583333333333332,3000000000,127.20848056537103
343,6,4,10,34.3,85.75,1715,28.583333333333332,4000000000,139.94169096209913
370,9,4,13,28.46153846153846,92.5,1850,30.833333333333332,4000000000,129.72972972972974
1054,18,6,24,43.916666666666664,175.66666666666666,5270,87.83333333333333,6000000000,68.3111954459203
350,8,3,11,31.818181818181817,116.66666666666667,1750,29.166666666666668,3000000000,102.85714285714285
427,5,4,9,47.44444444444444,106.75,2135,35.583333333333336,4000000000,112.41217798594847
812,14,3,17,47.76470588235294,270.6666666666667,4060,67.66666666666667,3000000000,44.33497536945812
568,9,4,13,43.69230769230769,142,2840,47.333333333333336,4000000000,84.50704225352113
440,5,3,8,55,146.66666666666666,2200,36.666666666666664,3000000000,81.81818181818183
471,7,3,10,47.1,157,2355,39.25,3000000000,76.43312101910828
464,8,4,12,38.666666666666664,116,2320,38.666666666666664,4000000000,103.44827586206897
818,11,3,14,58.42857142857143,272.6666666666667,4090,68.16666666666667,3000000000,44.00977995110024
1258,16,8,24,52.416666666666664,157.25,6290,104.83333333333333,8000000000,76.31160572337043
563,13,3,16,35.1875,187.66666666666666,2815,46.916666666666664,3000000000,63.94316163410302
317,5,3,8,39.625,105.66666666666667,1585,26.416666666666668,3000000000,113.56466876971608
599,10,10,20,29.95,59.9,2995,49.916666666666664,10000000000,200.33388981636062
505,6,5,11,45.90909090909091,101,2525,42.083333333333336,5000000000,118.8118811881188
475,8,4,12,39.583333333333336,118.75,2375,39.583333333333336,4000000000,101.05263157894737
490,5,3,8,61.25,163.33333333333334,2450,40.833333333333336,3000000000,73.46938775510203
991,15,3,18,55.05555555555556,330.3333333333333,4955,82.58333333333333,3000000000,36.326942482341074
788,12,5,17,46.35294117647059,157.6,3940,65.66666666666667,5000000000,76.14213197969542
1280,20,3,23,55.65217391304348,426.6666666666667,6400,106.66666666666667,3000000000,28.125
433,4,3,7,61.857142857142854,144.33333333333334,2165,36.083333333333336,3000000000,83.14087759815241
625,6,3,9,69.44444444444444,208.33333333333334,3125,52.083333333333336,3000000000,57.6
916,15,4,19,48.21052631578947,229,4580,76.33333333333333,4000000000,52.401746724890835
763,5,5,10,76.3,152.6,3815,63.583333333333336,5000000000,78.63695937090432
740,15,5,20,37,148,3700,61.666666666666664,5000000000,81.08108108108108
447,10,4,14,31.928571428571427,111.75,2235,37.25,4000000000,107.38255033557047
532,5,6,11,48.36363636363637,88.66666666666667,2660,44.333333333333336,6000000000,135.33834586466165
734,11,6,17,43.1764705882353,122.33333333333333,3670,61.166666666666664,6000000000,98.09264305177112
408,10,4,14,29.142857142857142,102,2040,34,4000000000,117.6470588235294
280,3,3,6,46.666666666666664,93.33333333333333,1400,23.333333333333332,3000000000,128.57142857142858
582,9,3,12,48.5,194,2910,48.5,3000000000,61.855670103092784
707,11,3,14,50.5,235.66666666666666,3535,58.916666666666664,3000000000,50.91937765205092
418,9,3,12,34.833333333333336,139.33333333333334,2090,34.833333333333336,3000000000,86.1244019138756
363,5,3,8,45.375,121,1815,30.25,3000000000,99.17355371900827
629,8,3,11,57.18181818181818,209.66666666666666,3145,52.416666666666664,3000000000,57.233704292527825
845,16,3,19,44.473684210526315,281.6666666666667,4225,70.41666666666667,3000000000,42.603550295857985
847,19,3,22,38.5,282.3333333333333,4235,70.58333333333333,3000000000,42.502951593860686
599,5,3,8,74.875,199.66666666666666,2995,49.916666666666664,3000000000,60.10016694490819
640,7,5,12,53.333333333333336,128,3200,53.333333333333336,5000000000,93.75
787,9,7,16,49.1875,112.42857142857143,3935,65.58333333333333,7000000000,106.73443456162643
1101,19,5,24,45.875,220.2,5505,91.75,5000000000,54.495912806539515
508,9,4,13,39.07692307692308,127,2540,42.333333333333336,4000000000,94.48818897637796
508,8,6,14,36.285714285714285,84.66666666666667,2540,42.333333333333336,6000000000,141.7322834645669
797,11,5,16,49.8125,159.4,3985,66.41666666666667,5000000000,75.28230865746549
569,8,3,11,51.72727272727273,189.66666666666666,2845,47.416666666666664,3000000000,63.26889279437611
916,15,3,18,50.888888888888886,305.3333333333333,4580,76.33333333333333,3000000000,39.301310043668124
527,11,3,14,37.642857142857146,175.66666666666666,2635,43.916666666666664,3000000000,68.3111954459203
480,9,3,12,40,160,2400,40,3000000000,75
966,17,9,26,37.15384615384615,107.33333333333333,4830,80.5,9000000000,111.80124223602485
1366,21,3,24,56.916666666666664,455.3333333333333,6830,113.83333333333333,3000000000,26.35431918008785
664,15,3,18,36.888888888888886,221.33333333333334,3320,55.333333333333336,3000000000,54.21686746987952
747,5,3,8,93.375,249,3735,62.25,3000000000,48.192771084337345
574,8,3,11,52.18181818181818,191.33333333333334,2870,47.833333333333336,3000000000,62.7177700348432
718,9,3,12,59.833333333333336,239.33333333333334,3590,59.833333333333336,3000000000,50.139275766016716
605,15,6,21,28.80952380952381,100.83333333333333,3025,50.416666666666664,6000000000,119.00826446280992
492,8,3,11,44.72727272727273,164,2460,41,3000000000,73.17073170731707
469,5,3,8,58.625,156.33333333333334,2345,39.083333333333336,3000000000,76.75906183368869
488,5,3,8,61,162.66666666666666,2440,40.666666666666664,3000000000,73.7704918032787
594,8,3,11,54,198,2970,49.5,3000000000,60.60606060606061
1162,16,3,19,61.1578947368421,387.3333333333333,5810,96.83333333333333,3000000000,30.98106712564544
869,13,7,20,43.45,124.14285714285714,4345,72.41666666666667,7000000000,96.66283084004601
711,13,3,16,44.4375,237,3555,59.25,3000000000,50.63291139240506
431,3,3,6,71.83333333333333,143.66666666666666,2155,35.916666666666664,3000000000,83.52668213457078
701,14,4,18,38.94444444444444,175.25,3505,58.416666666666664,4000000000,68.47360912981455
360,8,3,11,32.72727272727273,120,1800,30,3000000000,100
1043,18,7,25,41.72,149,5215,86.91666666666667,7000000000,80.53691275167785
291,4,4,8,36.375,72.75,1455,24.25,4000000000,164.94845360824743
444,7,3,10,44.4,148,2220,37,3000000000,81.08108108108108
706,7,3,10,70.6,235.33333333333334,3530,58.833333333333336,3000000000,50.991501416430594
507,12,3,15,33.8,169,2535,42.25,3000000000,71.0059171597633
646,14,5,19,34,129.2,3230,53.833333333333336,5000000000,92.87925696594428
330,6,4,10,33,82.5,1650,27.5,4000000000,145.45454545454547
431,9,3,12,35.916666666666664,143.66666666666666,2155,35.916666666666664,3000000000,83.52668213457078
476,7,3,10,47.6,158.66666666666666,2380,39.666666666666664,3000000000,75.63025210084035
876,18,3,21,41.714285714285715,292,4380,73,3000000000,41.0958904109589
528,11,7,18,29.333333333333332,75.42857142857143,2640,44,7000000000,159.0909090909091
821,16,4,20,41.05,205.25,4105,68.41666666666667,4000000000,58.465286236297196
1480,20,3,23,64.34782608695652,493.3333333333333,7400,123.33333333333333,3000000000,24.324324324324326
1100,12,3,15,73.33333333333333,366.6666666666667,5500,91.66666666666667,3000000000,32.72727272727273
967,12,3,15,64.46666666666667,322.3333333333333,4835,80.58333333333333,3000000000,37.22854188210962
505,11,3,14,36.07142857142857,168.33333333333334,2525,42.083333333333336,3000000000,71.28712871287128
730,7,6,13,56.15384615384615,121.66666666666667,3650,60.833333333333336,6000000000,98.63013698630137
751,8,3,11,68.27272727272727,250.33333333333334,3755,62.583333333333336,3000000000,47.93608521970706
597,8,3,11,54.27272727272727,199,2985,49.75,3000000000,60.301507537688444
453,8,3,11,41.18181818181818,151,2265,37.75,3000000000,79.47019867549669
202,5,3,8,25.25,67.33333333333333,1010,16.833333333333332,3000000000,178.21782178217822
406,13,3,16,25.375,135.33333333333334,2030,33.833333333333336,3000000000,88.66995073891624
685,9,3,12,57.083333333333336,228.33333333333334,3425,57.083333333333336,3000000000,52.55474452554744
553,8,6,14,39.5,92.16666666666667,2765,46.083333333333336,6000000000,130.19891500904157
490,9,3,12,40.833333333333336,163.33333333333334,2450,40.833333333333336,3000000000,73.46938775510203
600,9,3,12,50,200,3000,50,3000000000,60
776,21,3,24,32.333333333333336,258.6666666666667,3880,64.66666666666667,3000000000,46.391752577319586
446,5,3,8,55.75,148.66666666666666,2230,37.166666666666664,3000000000,80.71748878923768
599,9,5,14,42.785714285714285,119.8,2995,49.916666666666664,5000000000,100.16694490818031
572,5,4,9,63.55555555555556,143,2860,47.666666666666664,4000000000,83.91608391608392
952,18,3,21,45.333333333333336,317.3333333333333,4760,79.33333333333333,3000000000,37.815126050420176
535,10,3,13,41.15384615384615,178.33333333333334,2675,44.583333333333336,3000000000,67.28971962616822
428,5,3,8,53.5,142.66666666666666,2140,35.666666666666664,3000000000,84.11214953271029
325,4,3,7,46.42857142857143,108.33333333333333,1625,27.083333333333332,3000000000,110.76923076923077
595,8,4,12,49.583333333333336,148.75,2975,49.583333333333336,4000000000,80.67226890756302
347,6,3,9,38.55555555555556,115.66666666666667,1735,28.916666666666668,3000000000,103.7463976945245
1298,26,9,35,37.08571428571429,144.22222222222223,6490,108.16666666666667,9000000000,83.20493066255779
763,15,6,21,36.333333333333336,127.16666666666667,3815,63.583333333333336,6000000000,94.36435124508517
639,10,6,16,39.9375,106.5,3195,53.25,6000000000,112.67605633802816
893,7,3,10,89.3,297.6666666666667,4465,74.41666666666667,3000000000,40.31354983202688
497,6,5,11,45.18181818181818,99.4,2485,41.416666666666664,5000000000,120.72434607645876
730,15,4,19,38.421052631578945,182.5,3650,60.833333333333336,4000000000,65.75342465753424
1376,14,15,29,47.44827586206897,91.73333333333333,6880,114.66666666666667,15000000000,130.81395348837208
613,11,3,14,43.785714285714285,204.33333333333334,3065,51.083333333333336,3000000000,58.727569331158236
683,9,4,13,52.53846153846154,170.75,3415,56.916666666666664,4000000000,70.27818448023426
351,7,3,10,35.1,117,1755,29.25,3000000000,102.56410256410255
554,6,3,9,61.55555555555556,184.66666666666666,2770,46.166666666666664,3000000000,64.98194945848375
549,8,3,11,49.90909090909091,183,2745,45.75,3000000000,65.57377049180329
403,12,3,15,26.866666666666667,134.33333333333334,2015,33.583333333333336,3000000000,89.33002481389578
728,11,3,14,52,242.66666666666666,3640,60.666666666666664,3000000000,49.45054945054945
881,12,7,19,46.36842105263158,125.85714285714286,4405,73.41666666666667,7000000000,95.34619750283767
925,14,3,17,54.411764705882355,308.3333333333333,4625,77.08333333333333,3000000000,38.91891891891892
570,13,6,19,30,95,2850,47.5,6000000000,126.3157894736842
502,12,4,16,31.375,125.5,2510,41.833333333333336,4000000000,95.61752988047809
661,9,3,12,55.083333333333336,220.33333333333334,3305,55.083333333333336,3000000000,54.462934947049924
501,3,5,8,62.625,100.2,2505,41.75,5000000000,119.76047904191616
706,7,8,15,47.06666666666667,88.25,3530,58.833333333333336,8000000000,135.97733711048159
459,6,3,9,51,153,2295,38.25,3000000000,78.4313725490196
725,9,3,12,60.416666666666664,241.66666666666666,3625,60.416666666666664,3000000000,49.6551724137931
354,4,3,7,50.57142857142857,118,1770,29.5,3000000000,101.69491525423729
502,7,3,10,50.2,167.33333333333334,2510,41.833333333333336,3000000000,71.71314741035856
593,20,5,25,23.72,118.6,2965,49.416666666666664,5000000000,101.18043844856662
742,10,5,15,49.46666666666667,148.4,3710,61.833333333333336,5000000000,80.86253369272237
977,20,4,24,40.708333333333336,244.25,4885,81.41666666666667,4000000000,49.12998976458547
373,7,3,10,37.3,124.33333333333333,1865,31.083333333333332,3000000000,96.514745308311
429,4,3,7,61.285714285714285,143,2145,35.75,3000000000,83.91608391608392
1288,14,12,26,49.53846153846154,107.33333333333333,6440,107.33333333333333,12000000000,111.80124223602486
774,14,5,19,40.73684210526316,154.8,3870,64.5,5000000000,77.51937984496124
719,8,3,11,65.36363636363636,239.66666666666666,3595,59.916666666666664,3000000000,50.06954102920724
563,10,4,14,40.214285714285715,140.75,2815,46.916666666666664,4000000000,85.2575488454707
527,5,4,9,58.55555555555556,131.75,2635,43.916666666666664,4000000000,91.08159392789375
543,4,4,8,67.875,135.75,2715,45.25,4000000000,88.39779005524862
566,7,5,12,47.166666666666664,113.2,2830,47.166666666666664,5000000000,106.00706713780919
368,6,3,9,40.888888888888886,122.66666666666667,1840,30.666666666666668,3000000000,97.82608695652173
362,7,3,10,36.2,120.66666666666667,1810,30.166666666666668,3000000000,99.4475138121547
679,11,6,17,39.94117647058823,113.16666666666667,3395,56.583333333333336,6000000000,106.03829160530192
843,12,7,19,44.36842105263158,120.42857142857143,4215,70.25,7000000000,99.644128113879
1021,18,3,21,48.61904761904762,340.3333333333333,5105,85.08333333333333,3000000000,35.259549461312446
604,14,5,19,31.789473684210527,120.8,3020,50.333333333333336,5000000000,99.33774834437085
483,6,3,9,53.666666666666664,161,2415,40.25,3000000000,74.53416149068323
309,4,3,7,44.142857142857146,103,1545,25.75,3000000000,116.50485436893204
537,9,3,12,44.75,179,2685,44.75,3000000000,67.0391061452514
455,9,3,12,37.916666666666664,151.66666666666666,2275,37.916666666666664,3000000000,79.12087912087912
696,9,3,12,58,232,3480,58,3000000000,51.724137931034484
408,9,3,12,34,136,2040,34,3000000000,88.23529411764706
666,10,10,20,33.3,66.6,3330,55.5,10000000000,180.1801801801802
1200,17,8,25,48,150,6000,100,8000000000,80
501,6,5,11,45.54545454545455,100.2,2505,41.75,5000000000,119.76047904191616
513,9,3,12,42.75,171,2565,42.75,3000000000,70.17543859649123
1032,20,3,23,44.869565217391305,344,5160,86,3000000000,34.883720930232556
643,13,3,16,40.1875,214.33333333333334,3215,53.583333333333336,3000000000,55.987558320373246
280,7,3,10,28,93.33333333333333,1400,23.333333333333332,3000000000,128.57142857142858
669,9,3,12,55.75,223,3345,55.75,3000000000,53.81165919282511
432,9,4,13,33.23076923076923,108,2160,36,4000000000,111.1111111111111
306,5,4,9,34,76.5,1530,25.5,4000000000,156.8627450980392
311,4,5,9,34.55555555555556,62.2,1555,25.916666666666668,5000000000,192.92604501607715
623,16,3,19,32.78947368421053,207.66666666666666,3115,51.916666666666664,3000000000,57.784911717495994
769,7,3,10,76.9,256.3333333333333,3845,64.08333333333333,3000000000,46.81404421326398
413,4,3,7,59,137.66666666666666,2065,34.416666666666664,3000000000,87.16707021791768
873,10,5,15,58.2,174.6,4365,72.75,5000000000,68.72852233676976
290,7,3,10,29,96.66666666666667,1450,24.166666666666668,3000000000,124.13793103448275
166,7,3,10,16.6,55.333333333333336,830,13.833333333333334,3000000000,216.86746987951807
216,4,3,7,30.857142857142858,72,1080,18,3000000000,166.66666666666666
269,5,3,8,33.625,89.66666666666667,1345,22.416666666666668,3000000000,133.82899628252787
171,5,3,8,21.375,57,855,14.25,3000000000,210.52631578947367
345,6,5,11,31.363636363636363,69,1725,28.75,5000000000,173.91304347826087
1420,32,3,35,40.57142857142857,473.3333333333333,7100,118.33333333333333,3000000000,25.35211267605634
837,12,7,19,44.05263157894737,119.57142857142857,4185,69.75,7000000000,100.35842293906809
452,5,5,10,45.2,90.4,2260,37.666666666666664,5000000000,132.7433628318584
422,4,3,7,60.285714285714285,140.66666666666666,2110,35.166666666666664,3000000000,85.30805687203792
422,5,5,10,42.2,84.4,2110,35.166666666666664,5000000000,142.18009478672988
370,7,3,10,37,123.33333333333333,1850,30.833333333333332,3000000000,97.2972972972973
1009,17,9,26,38.80769230769231,112.11111111111111,5045,84.08333333333333,9000000000,107.0366699702676
615,8,6,14,43.92857142857143,102.5,3075,51.25,6000000000,117.07317073170732
628,10,3,13,48.30769230769231,209.33333333333334,3140,52.333333333333336,3000000000,57.324840764331206
654,10,4,14,46.714285714285715,163.5,3270,54.5,4000000000,73.39449541284404
812,7,5,12,67.66666666666667,162.4,4060,67.66666666666667,5000000000,73.89162561576354
168,6,3,9,18.666666666666668,56,840,14,3000000000,214.2857142857143
489,8,4,12,40.75,122.25,2445,40.75,4000000000,98.15950920245399
1085,15,3,18,60.27777777777778,361.6666666666667,5425,90.41666666666667,3000000000,33.17972350230414
976,8,10,18,54.22222222222222,97.6,4880,81.33333333333333,10000000000,122.95081967213115
569,5,3,8,71.125,189.66666666666666,2845,47.416666666666664,3000000000,63.26889279437611
563,10,4,14,40.214285714285715,140.75,2815,46.916666666666664,4000000000,85.2575488454707
376,9,3,12,31.333333333333332,125.33333333333333,1880,31.333333333333332,3000000000,95.74468085106383
760,12,3,15,50.666666666666664,253.33333333333334,3800,63.333333333333336,3000000000,47.36842105263158
260,7,4,11,23.636363636363637,65,1300,21.666666666666668,4000000000,184.6153846153846
614,14,5,19,32.31578947368421,122.8,3070,51.166666666666664,5000000000,97.7198697068404
1122,19,3,22,51,374,5610,93.5,3000000000,32.085561497326204
862,9,9,18,47.888888888888886,95.77777777777777,4310,71.83333333333333,9000000000,125.29002320185616
857,17,3,20,42.85,285.6666666666667,4285,71.41666666666667,3000000000,42.00700116686114
530,6,3,9,58.888888888888886,176.66666666666666,2650,44.166666666666664,3000000000,67.9245283018868
659,12,3,15,43.93333333333333,219.66666666666666,3295,54.916666666666664,3000000000,54.628224582701066
703,14,3,17,41.35294117647059,234.33333333333334,3515,58.583333333333336,3000000000,51.209103840682786
248,3,3,6,41.333333333333336,82.66666666666667,1240,20.666666666666668,3000000000,145.16129032258064
389,7,3,10,38.9,129.66666666666666,1945,32.416666666666664,3000000000,92.54498714652956
426,7,3,10,42.6,142,2130,35.5,3000000000,84.50704225352113
412,5,3,8,51.5,137.33333333333334,2060,34.333333333333336,3000000000,87.37864077669902
638,7,7,14,45.57142857142857,91.14285714285714,3190,53.166666666666664,7000000000,131.6614420062696
774,13,4,17,45.529411764705884,193.5,3870,64.5,4000000000,62.015503875968996
468,5,4,9,52,117,2340,39,4000000000,102.56410256410255
325,5,3,8,40.625,108.33333333333333,1625,27.083333333333332,3000000000,110.76923076923077
458,9,3,12,38.166666666666664,152.66666666666666,2290,38.166666666666664,3000000000,78.60262008733625
735,13,3,16,45.9375,245,3675,61.25,3000000000,48.9795918367347
1643,18,13,31,53,126.38461538461539,8215,136.91666666666666,13000000000,94.94826536822885
639,18,4,22,29.045454545454547,159.75,3195,53.25,4000000000,75.11737089201878
548,10,3,13,42.15384615384615,182.66666666666666,2740,45.666666666666664,3000000000,65.69343065693431
392,5,3,8,49,130.66666666666666,1960,32.666666666666664,3000000000,91.83673469387756
848,9,3,12,70.66666666666667,282.6666666666667,4240,70.66666666666667,3000000000,42.45283018867924
535,5,6,11,48.63636363636363,89.16666666666667,2675,44.583333333333336,6000000000,134.57943925233644
416,7,3,10,41.6,138.66666666666666,2080,34.666666666666664,3000000000,86.53846153846155
275,4,3,7,39.285714285714285,91.66666666666667,1375,22.916666666666668,3000000000,130.9090909090909
867,9,5,14,61.92857142857143,173.4,4335,72.25,5000000000,69.20415224913495
861,10,5,15,57.4,172.2,4305,71.75,5000000000,69.68641114982579
635,8,3,11,57.72727272727273,211.66666666666666,3175,52.916666666666664,3000000000,56.69291338582677
563,12,6,18,31.27777777777778,93.83333333333333,2815,46.916666666666664,6000000000,127.88632326820604
958,15,5,20,47.9,191.6,4790,79.83333333333333,5000000000,62.630480167014625
890,17,5,22,40.45454545454545,178,4450,74.16666666666667,5000000000,67.41573033707864
543,12,4,16,33.9375,135.75,2715,45.25,4000000000,88.39779005524862
270,8,5,13,20.76923076923077,54,1350,22.5,5000000000,222.2222222222222
643,13,6,19,33.8421052631579,107.16666666666667,3215,53.583333333333336,6000000000,111.97511664074649
380,6,3,9,42.22222222222222,126.66666666666667,1900,31.666666666666668,3000000000,94.73684210526316
974,11,12,23,42.34782608695652,81.16666666666667,4870,81.16666666666667,12000000000,147.84394250513344
473,8,5,13,36.38461538461539,94.6,2365,39.416666666666664,5000000000,126.84989429175477
620,7,5,12,51.666666666666664,124,3100,51.666666666666664,5000000000,96.77419354838709
414,5,4,9,46,103.5,2070,34.5,4000000000,115.94202898550725
446,12,3,15,29.733333333333334,148.66666666666666,2230,37.166666666666664,3000000000,80.71748878923768
333,4,3,7,47.57142857142857,111,1665,27.75,3000000000,108.1081081081081
560,8,4,12,46.666666666666664,140,2800,46.666666666666664,4000000000,85.71428571428572
648,8,3,11,58.90909090909091,216,3240,54,3000000000,55.55555555555555
724,16,4,20,36.2,181,3620,60.333333333333336,4000000000,66.29834254143647
138,3,3,6,23,46,690,11.5,3000000000,260.8695652173913
1580,13,14,27,58.51851851851852,112.85714285714286,7900,131.66666666666666,14000000000,106.32911392405065
811,8,3,11,73.72727272727273,270.3333333333333,4055,67.58333333333333,3000000000,44.38964241676942
556,8,3,11,50.54545454545455,185.33333333333334,2780,46.333333333333336,3000000000,64.74820143884892
695,12,3,15,46.333333333333336,231.66666666666666,3475,57.916666666666664,3000000000,51.79856115107914
1212,16,10,26,46.61538461538461,121.2,6060,101,10000000000,99.00990099009901
233,6,3,9,25.88888888888889,77.66666666666667,1165,19.416666666666668,3000000000,154.50643776824035
638,11,7,18,35.44444444444444,91.14285714285714,3190,53.166666666666664,7000000000,131.6614420062696
626,10,3,13,48.15384615384615,208.66666666666666,3130,52.166666666666664,3000000000,57.50798722044728
347,5,3,8,43.375,115.66666666666667,1735,28.916666666666668,3000000000,103.7463976945245
303,7,3,10,30.3,101,1515,25.25,3000000000,118.81188118811882
850,16,4,20,42.5,212.5,4250,70.83333333333333,4000000000,56.470588235294116
275,4,3,7,39.285714285714285,91.66666666666667,1375,22.916666666666668,3000000000,130.9090909090909
397,9,3,12,33.083333333333336,132.33333333333334,1985,33.083333333333336,3000000000,90.6801007556675
938,7,8,15,62.53333333333333,117.25,4690,78.16666666666667,8000000000,102.34541577825159
337,3,3,6,56.166666666666664,112.33333333333333,1685,28.083333333333332,3000000000,106.82492581602374
538,12,3,15,35.86666666666667,179.33333333333334,2690,44.833333333333336,3000000000,66.91449814126393
1034,18,8,26,39.76923076923077,129.25,5170,86.16666666666667,8000000000,92.84332688588007
179,4,3,7,25.571428571428573,59.666666666666664,895,14.916666666666666,3000000000,201.1173184357542
443,11,3,14,31.642857142857142,147.66666666666666,2215,36.916666666666664,3000000000,81.26410835214448
275,5,3,8,34.375,91.66666666666667,1375,22.916666666666668,3000000000,130.9090909090909
246,3,4,7,35.142857142857146,61.5,1230,20.5,4000000000,195.1219512195122
595,4,3,7,85,198.33333333333334,2975,49.583333333333336,3000000000,60.50420168067227
480,4,3,7,68.57142857142857,160,2400,40,3000000000,75
575,6,5,11,52.27272727272727,115,2875,47.916666666666664,5000000000,104.34782608695653
974,17,8,25,38.96,121.75,4870,81.16666666666667,8000000000,98.56262833675565
752,8,6,14,53.714285714285715,125.33333333333333,3760,62.666666666666664,6000000000,95.74468085106383
605,10,3,13,46.53846153846154,201.66666666666666,3025,50.416666666666664,3000000000,59.50413223140496
248,5,4,9,27.555555555555557,62,1240,20.666666666666668,4000000000,193.54838709677418
797,18,3,21,37.95238095238095,265.6666666666667,3985,66.41666666666667,3000000000,45.1693851944793
490,11,5,16,30.625,98,2450,40.833333333333336,5000000000,122.44897959183672
391,6,3,9,43.44444444444444,130.33333333333334,1955,32.583333333333336,3000000000,92.07161125319692
385,5,3,8,48.125,128.33333333333334,1925,32.083333333333336,3000000000,93.5064935064935
889,20,7,27,32.925925925925924,127,4445,74.08333333333333,7000000000,94.48818897637797
561,11,3,14,40.07142857142857,187,2805,46.75,3000000000,64.171122994652407
753,4,3,7,107.57142857142857,251,3765,62.75,3000000000,47.808764940239044
552,10,3,13,42.46153846153846,184,2760,46,3000000000,65.21739130434783
419,7,3,10,41.9,139.66666666666666,2095,34.916666666666664,3000000000,85.91885441527447
1061,17,9,26,40.80769230769231,117.88888888888889,5305,88.41666666666667,9000000000,101.79076343072572
662,18,4,22,30.09090909090909,165.5,3310,55.166666666666664,4000000000,72.50755287009063
545,4,6,10,54.5,90.83333333333333,2725,45.416666666666664,6000000000,132.11009174311926
756,14,6,20,37.8,126,3780,63,6000000000,95.23809523809524
592,7,3,10,59.2,197.33333333333334,2960,49.333333333333336,3000000000,60.81081081081081
846,11,3,14,60.42857142857143,282,4230,70.5,3000000000,42.5531914893617
624,9,3,12,52,208,3120,52,3000000000,57.69230769230769
643,13,3,16,40.1875,214.33333333333334,3215,53.583333333333336,3000000000,55.987558320373246
766,10,7,17,45.05882352941177,109.42857142857143,3830,63.833333333333336,7000000000,109.66057441253263
471,10,3,13,36.23076923076923,157,2355,39.25,3000000000,76.43312101910828
619,13,6,19,32.578947368421055,103.16666666666667,3095,51.583333333333336,6000000000,116.31663974151857
633,11,3,14,45.214285714285715,211,3165,52.75,3000000000,56.87203791469194
556,3,3,6,92.66666666666667,185.33333333333334,2780,46.333333333333336,3000000000,64.74820143884892
649,13,3,16,40.5625,216.33333333333334,3245,54.083333333333336,3000000000,55.46995377503852
754,18,3,21,35.904761904761905,251.33333333333334,3770,62.833333333333336,3000000000,47.745358090185675
792,8,3,11,72,264,3960,66,3000000000,45.45454545454545
672,12,3,15,44.8,224,3360,56,3000000000,53.57142857142858
884,11,6,17,52,147.33333333333334,4420,73.66666666666667,6000000000,81.44796380090497
499,9,5,14,35.642857142857146,99.8,2495,41.583333333333336,5000000000,120.24048096192384
1043,15,7,22,47.40909090909091,149,5215,86.91666666666667,7000000000,80.53691275167785
644,7,3,10,64.4,214.66666666666666,3220,53.666666666666664,3000000000,55.90062111801243
416,5,5,10,41.6,83.2,2080,34.666666666666664,5000000000,144.23076923076925
1019,13,9,22,46.31818181818182,113.22222222222223,5095,84.91666666666667,9000000000,105.98626104023552
689,15,4,19,36.26315789473684,172.25,3445,57.416666666666664,4000000000,69.66618287373005
405,9,3,12,33.75,135,2025,33.75,3000000000,88.8888888888889
449,6,3,9,49.888888888888886,149.66666666666666,2245,37.416666666666664,3000000000,80.1781737193764
983,15,9,24,40.958333333333336,109.22222222222223,4915,81.91666666666667,9000000000,109.8677517802645
1481,19,3,22,67.31818181818181,493.6666666666667,7405,123.41666666666667,3000000000,24.307900067521945
379,5,3,8,47.375,126.33333333333333,1895,31.583333333333332,3000000000,94.9868073878628
554,8,5,13,42.61538461538461,110.8,2770,46.166666666666664,5000000000,108.30324909747294
831,10,5,15,55.4,166.2,4155,69.25,5000000000,72.20216606498195
583,10,6,16,36.4375,97.16666666666667,2915,48.583333333333336,6000000000,123.4991423670669
387,6,3,9,43,129,1935,32.25,3000000000,93.02325581395348
582,13,5,18,32.333333333333336,116.4,2910,48.5,5000000000,103.09278350515464
454,8,3,11,41.27272727272727,151.33333333333334,2270,37.833333333333336,3000000000,79.29515418502203
468,9,3,12,39,156,2340,39,3000000000,76.92307692307693
617,11,3,14,44.07142857142857,205.66666666666666,3085,51.416666666666664,3000000000,58.346839546191255
803,12,6,18,44.611111111111114,133.83333333333334,4015,66.91666666666667,6000000000,89.6637608966376
514,8,3,11,46.72727272727273,171.33333333333334,2570,42.833333333333336,3000000000,70.03891050583658
378,8,3,11,34.36363636363637,126,1890,31.5,3000000000,95.23809523809524
1130,15,9,24,47.083333333333336,125.55555555555556,5650,94.16666666666667,9000000000,95.57522123893804
571,8,3,11,51.90909090909091,190.33333333333334,2855,47.583333333333336,3000000000,63.047285464098074
946,15,7,22,43,135.14285714285714,4730,78.83333333333333,7000000000,88.79492600422834
438,11,3,14,31.285714285714285,146,2190,36.5,3000000000,82.1917808219178
496,8,5,13,38.15384615384615,99.2,2480,41.333333333333336,5000000000,120.96774193548386
454,5,4,9,50.44444444444444,113.5,2270,37.833333333333336,4000000000,105.72687224669602
470,9,3,12,39.166666666666664,156.66666666666666,2350,39.166666666666664,3000000000,76.59574468085107
493,7,4,11,44.81818181818182,123.25,2465,41.083333333333336,4000000000,97.3630831643002
573,8,3,11,52.09090909090909,191,2865,47.75,3000000000,62.82722513089005
540,4,4,8,67.5,135,2700,45,4000000000,88.8888888888889
317,5,3,8,39.625,105.66666666666667,1585,26.416666666666668,3000000000,113.56466876971608
677,9,7,16,42.3125,96.71428571428571,3385,56.416666666666664,7000000000,124.0768094534712
589,6,3,9,65.44444444444444,196.33333333333334,2945,49.083333333333336,3000000000,61.120543293718164
802,16,4,20,40.1,200.5,4010,66.83333333333333,4000000000,59.85037406483791
559,10,3,13,43,186.33333333333334,2795,46.583333333333336,3000000000,64.40071556350627
861,10,11,21,41,78.27272727272727,4305,71.75,11000000000,153.31010452961672
644,8,3,11,58.54545454545455,214.66666666666666,3220,53.666666666666664,3000000000,55.90062111801243
546,10,3,13,42,182,2730,45.5,3000000000,65.93406593406593
446,10,3,13,34.30769230769231,148.66666666666666,2230,37.166666666666664,3000000000,80.71748878923768
481,7,3,10,48.1,160.33333333333334,2405,40.083333333333336,3000000000,74.84407484407484
616,7,3,10,61.6,205.33333333333334,3080,51.333333333333336,3000000000,58.441558441558435
245,7,3,10,24.5,81.66666666666667,1225,20.416666666666668,3000000000,146.93877551020407
513,9,7,16,32.0625,73.28571428571429,2565,42.75,7000000000,163.74269005847952
845,19,3,22,38.40909090909091,281.6666666666667,4225,70.41666666666667,3000000000,42.603550295857985
681,16,3,19,35.8421052631579,227,3405,56.75,3000000000,52.86343612334802
851,13,3,16,53.1875,283.6666666666667,4255,70.91666666666667,3000000000,42.30317273795535
686,10,5,15,45.733333333333334,137.2,3430,57.166666666666664,5000000000,87.46355685131195
509,12,4,16,31.8125,127.25,2545,42.416666666666664,4000000000,94.30255402750493
453,6,8,14,32.357142857142854,56.625,2265,37.75,8000000000,211.9205298013245
882,12,7,19,46.421052631578945,126,4410,73.5,7000000000,95.23809523809524
513,7,4,11,46.63636363636363,128.25,2565,42.75,4000000000,93.5672514619883
908,20,7,27,33.629629629629626,129.71428571428572,4540,75.66666666666667,7000000000,92.51101321585902
1119,13,3,16,69.9375,373,5595,93.25,3000000000,32.171581769437
342,3,3,6,57,114,1710,28.5,3000000000,105.26315789473684
677,10,5,15,45.13333333333333,135.4,3385,56.416666666666664,5000000000,88.62629246676515
405,9,3,12,33.75,135,2025,33.75,3000000000,88.8888888888889
742,8,3,11,67.45454545454545,247.33333333333334,3710,61.833333333333336,3000000000,48.517520215633425
232,4,3,7,33.142857142857146,77.33333333333333,1160,19.333333333333332,3000000000,155.17241379310346
367,4,3,7,52.42857142857143,122.33333333333333,1835,30.583333333333332,3000000000,98.09264305177112
828,15,3,18,46,276,4140,69,3000000000,43.47826086956522
845,12,5,17,49.705882352941174,169,4225,70.41666666666667,5000000000,71.0059171597633
1073,20,5,25,42.92,214.6,5365,89.41666666666667,5000000000,55.917986952469704
1276,16,9,25,51.04,141.77777777777777,6380,106.33333333333333,9000000000,84.63949843260188
904,15,8,23,39.30434782608695,113,4520,75.33333333333333,8000000000,106.19469026548673
754,13,3,16,47.125,251.33333333333334,3770,62.833333333333336,3000000000,47.745358090185675
672,16,7,23,29.217391304347824,96,3360,56,7000000000,125
804,13,7,20,40.2,114.85714285714286,4020,67,7000000000,104.47761194029852
711,11,3,14,50.785714285714285,237,3555,59.25,3000000000,50.63291139240506
625,6,5,11,56.81818181818182,125,3125,52.083333333333336,5000000000,96
696,7,4,11,63.27272727272727,174,3480,58,4000000000,68.9655172413793
295,7,3,10,29.5,98.33333333333333,1475,24.583333333333332,3000000000,122.03389830508475
470,14,3,17,27.647058823529413,156.66666666666666,2350,39.166666666666664,3000000000,76.59574468085107
955,14,5,19,50.26315789473684,191,4775,79.58333333333333,5000000000,62.827225130890056
352,5,3,8,44,117.33333333333333,1760,29.333333333333332,3000000000,102.27272727272728
747,12,5,17,43.94117647058823,149.4,3735,62.25,5000000000,80.32128514056225
413,7,3,10,41.3,137.66666666666666,2065,34.416666666666664,3000000000,87.16707021791768
746,20,3,23,32.43478260869565,248.66666666666666,3730,62.166666666666664,3000000000,48.2573726541555
639,7,5,12,53.25,127.8,3195,53.25,5000000000,93.89671361502347
1173,17,3,20,58.65,391,5865,97.75,3000000000,30.690537084398976
773,4,3,7,110.42857142857143,257.6666666666667,3865,64.41666666666667,3000000000,46.57179818887451
798,10,7,17,46.94117647058823,114,3990,66.5,7000000000,105.26315789473684
825,13,3,16,51.5625,275,4125,68.75,3000000000,43.63636363636363
296,6,3,9,32.888888888888886,98.66666666666667,1480,24.666666666666668,3000000000,121.62162162162161
681,17,3,20,34.05,227,3405,56.75,3000000000,52.86343612334802
297,4,3,7,42.42857142857143,99,1485,24.75,3000000000,121.21212121212122
280,4,3,7,40,93.33333333333333,1400,23.333333333333332,3000000000,128.57142857142858
1159,24,3,27,42.925925925925924,386.3333333333333,5795,96.58333333333333,3000000000,31.06125970664366
247,9,3,12,20.583333333333332,82.33333333333333,1235,20.583333333333332,3000000000,145.74898785425103
250,5,3,8,31.25,83.33333333333333,1250,20.833333333333332,3000000000,144
807,8,3,11,73.36363636363636,269,4035,67.25,3000000000,44.60966542750929
264,7,3,10,26.4,88,1320,22,3000000000,136.36363636363637
625,10,3,13,48.07692307692308,208.33333333333334,3125,52.083333333333336,3000000000,57.6
763,9,3,12,63.583333333333336,254.33333333333334,3815,63.583333333333336,3000000000,47.18217562254259
660,9,4,13,50.76923076923077,165,3300,55,4000000000,72.72727272727273
390,7,3,10,39,130,1950,32.5,3000000000,92.3076923076923
719,9,3,12,59.916666666666664,239.66666666666666,3595,59.916666666666664,3000000000,50.06954102920724
538,9,4,13,41.38461538461539,134.5,2690,44.833333333333336,4000000000,89.21933085501858
379,7,3,10,37.9,126.33333333333333,1895,31.583333333333332,3000000000,94.9868073878628
276,6,3,9,30.666666666666668,92,1380,23,3000000000,130.43478260869566
576,11,3,14,41.142857142857146,192,2880,48,3000000000,62.5
864,10,5,15,57.6,172.8,4320,72,5000000000,69.44444444444444
1128,21,9,30,37.6,125.33333333333333,5640,94,9000000000,95.74468085106383
525,14,3,17,30.88235294117647,175,2625,43.75,3000000000,68.57142857142857
534,10,3,13,41.07692307692308,178,2670,44.5,3000000000,67.41573033707864
635,16,3,19,33.421052631578945,211.66666666666666,3175,52.916666666666664,3000000000,56.69291338582677
482,4,3,7,68.85714285714286,160.66666666666666,2410,40.166666666666664,3000000000,74.68879668049793
581,13,3,16,36.3125,193.66666666666666,2905,48.416666666666664,3000000000,61.96213425129088
720,14,3,17,42.35294117647059,240,3600,60,3000000000,50
667,9,8,17,39.23529411764706,83.375,3335,55.583333333333336,8000000000,143.928035982009
351,4,3,7,50.142857142857146,117,1755,29.25,3000000000,102.56410256410255
675,7,3,10,67.5,225,3375,56.25,3000000000,53.333333333333336
595,4,3,7,85,198.33333333333334,2975,49.583333333333336,3000000000,60.50420168067227
688,11,7,18,38.22222222222222,98.28571428571429,3440,57.333333333333336,7000000000,122.09302325581395
506,9,7,16,31.625,72.28571428571429,2530,42.166666666666664,7000000000,166.00790513833994
508,8,3,11,46.18181818181818,169.33333333333334,2540,42.333333333333336,3000000000,70.86614173228345
270,6,4,10,27,67.5,1350,22.5,4000000000,177.7777777777778
603,4,3,7,86.14285714285714,201,3015,50.25,3000000000,59.701492537313435
236,6,3,9,26.22222222222222,78.66666666666667,1180,19.666666666666668,3000000000,152.5423728813559
653,11,4,15,43.53333333333333,163.25,3265,54.416666666666664,4000000000,73.50689127105667
933,11,8,19,49.10526315789474,116.625,4665,77.75,8000000000,102.89389067524115
380,6,3,9,42.22222222222222,126.66666666666667,1900,31.666666666666668,3000000000,94.73684210526316
548,10,4,14,39.142857142857146,137,2740,45.666666666666664,4000000000,87.59124087591242
376,7,6,13,28.923076923076923,62.666666666666664,1880,31.333333333333332,6000000000,191.48936170212767
480,13,3,16,30,160,2400,40,3000000000,75
1057,14,6,20,52.85,176.16666666666666,5285,88.08333333333333,6000000000,68.11731315042573
572,6,6,12,47.666666666666664,95.33333333333333,2860,47.666666666666664,6000000000,125.87412587412588
744,15,3,18,41.333333333333336,248,3720,62,3000000000,48.387096774193544
403,5,7,12,33.583333333333336,57.57142857142857,2015,33.583333333333336,7000000000,208.4367245657568
529,8,4,12,44.083333333333336,132.25,2645,44.083333333333336,4000000000,90.73724007561437
1061,13,12,25,42.44,88.41666666666667,5305,88.41666666666667,12000000000,135.7210179076343
882,19,7,26,33.92307692307692,126,4410,73.5,7000000000,95.23809523809524
1268,16,10,26,48.76923076923077,126.8,6340,105.66666666666667,10000000000,94.6372239747634
937,23,7,30,31.233333333333334,133.85714285714286,4685,78.08333333333333,7000000000,89.64781216648879
621,10,3,13,47.76923076923077,207,3105,51.75,3000000000,57.971014492753625
538,4,3,7,76.85714285714286,179.33333333333334,2690,44.833333333333336,3000000000,66.91449814126393
1126,15,3,18,62.55555555555556,375.3333333333333,5630,93.83333333333333,3000000000,31.97158081705151
416,7,3,10,41.6,138.66666666666666,2080,34.666666666666664,3000000000,86.53846153846155
926,18,3,21,44.095238095238095,308.6666666666667,4630,77.16666666666667,3000000000,38.8768898488121
624,12,3,15,41.6,208,3120,52,3000000000,57.69230769230769
159,4,4,8,19.875,39.75,795,13.25,4000000000,301.8867924528302
375,3,5,8,46.875,75,1875,31.25,5000000000,160
565,8,4,12,47.083333333333336,141.25,2825,47.083333333333336,4000000000,84.95575221238938
1186,16,6,22,53.90909090909091,197.66666666666666,5930,98.83333333333333,6000000000,60.708263069139974
562,8,5,13,43.23076923076923,112.4,2810,46.833333333333336,5000000000,106.76156583629893
1042,17,6,23,45.30434782608695,173.66666666666666,5210,86.83333333333333,6000000000,69.0978886756238
568,7,3,10,56.8,189.33333333333334,2840,47.333333333333336,3000000000,63.38028169014084
167,8,3,11,15.181818181818182,55.666666666666664,835,13.916666666666666,3000000000,215.5688622754491
511,5,3,8,63.875,170.33333333333334,2555,42.583333333333336,3000000000,70.45009784735812
560,13,8,21,26.666666666666668,70,2800,46.666666666666664,8000000000,171.42857142857144
1025,16,3,19,53.94736842105263,341.6666666666667,5125,85.41666666666667,3000000000,35.1219512195122
838,8,7,15,55.86666666666667,119.71428571428571,4190,69.83333333333333,7000000000,100.23866348448688
731,8,6,14,52.214285714285715,121.83333333333333,3655,60.916666666666664,6000000000,98.4952120383037
643,10,9,19,33.8421052631579,71.44444444444444,3215,53.583333333333336,9000000000,167.96267496111975
965,19,3,22,43.86363636363637,321.6666666666667,4825,80.41666666666667,3000000000,37.30569948186528
535,11,3,14,38.214285714285715,178.33333333333334,2675,44.583333333333336,3000000000,67.28971962616822
652,10,3,13,50.15384615384615,217.33333333333334,3260,54.333333333333336,3000000000,55.214723926380366
930,15,3,18,51.666666666666664,310,4650,77.5,3000000000,38.70967741935484
914,17,3,20,45.7,304.6666666666667,4570,76.16666666666667,3000000000,39.387308533916844
461,6,3,9,51.22222222222222,153.66666666666666,2305,38.416666666666664,3000000000,78.09110629067246
631,5,3,8,78.875,210.33333333333334,3155,52.583333333333336,3000000000,57.05229793977813
364,5,4,9,40.44444444444444,91,1820,30.333333333333332,4000000000,131.86813186813188
104,3,3,6,17.333333333333332,34.666666666666664,520,8.666666666666666,3000000000,346.1538461538462
447,10,3,13,34.38461538461539,149,2235,37.25,3000000000,80.53691275167786
576,14,3,17,33.88235294117647,192,2880,48,3000000000,62.5
714,13,6,19,37.578947368421055,119,3570,59.5,6000000000,100.84033613445379
307,5,4,9,34.111111111111114,76.75,1535,25.583333333333332,4000000000,156.35179153094464
664,9,7,16,41.5,94.85714285714286,3320,55.333333333333336,7000000000,126.50602409638554
563,7,3,10,56.3,187.66666666666666,2815,46.916666666666664,3000000000,63.94316163410302
509,8,4,12,42.416666666666664,127.25,2545,42.416666666666664,4000000000,94.30255402750493
615,9,7,16,38.4375,87.85714285714286,3075,51.25,7000000000,136.58536585365852
786,8,7,15,52.4,112.28571428571429,3930,65.5,7000000000,106.87022900763358
871,16,7,23,37.869565217391305,124.42857142857143,4355,72.58333333333333,7000000000,96.44087256027555
406,8,3,11,36.90909090909091,135.33333333333334,2030,33.833333333333336,3000000000,88.66995073891624
819,11,5,16,51.1875,163.8,4095,68.25,5000000000,73.26007326007326
259,7,4,11,23.545454545454547,64.75,1295,21.583333333333332,4000000000,185.32818532818536
737,23,6,29,25.413793103448278,122.83333333333333,3685,61.416666666666664,6000000000,97.69335142469471
312,6,3,9,34.666666666666664,104,1560,26,3000000000,115.38461538461539
650,13,3,16,40.625,216.66666666666666,3250,54.166666666666664,3000000000,55.38461538461539
426,10,3,13,32.76923076923077,142,2130,35.5,3000000000,84.50704225352113
630,4,3,7,90,210,3150,52.5,3000000000,57.14285714285714
346,7,4,11,31.454545454545453,86.5,1730,28.833333333333332,4000000000,138.72832369942196
301,6,3,9,33.44444444444444,100.33333333333333,1505,25.083333333333332,3000000000,119.60132890365449
666,12,5,17,39.1764705882353,133.2,3330,55.5,5000000000,90.0900900900901
558,10,3,13,42.92307692307692,186,2790,46.5,3000000000,64.51612903225806
1311,23,3,26,50.42307692307692,437,6555,109.25,3000000000,27.45995423340961
1094,18,3,21,52.095238095238095,364.6666666666667,5470,91.16666666666667,3000000000,32.90676416819012
730,15,3,18,40.55555555555556,243.33333333333334,3650,60.833333333333336,3000000000,49.31506849315068
230,4,3,7,32.857142857142854,76.66666666666667,1150,19.166666666666668,3000000000,156.52173913043478
1048,21,10,31,33.806451612903224,104.8,5240,87.33333333333333,10000000000,114.50381679389312
556,10,3,13,42.76923076923077,185.33333333333334,2780,46.333333333333336,3000000000,64.74820143884892
915,15,3,18,50.833333333333336,305,4575,76.25,3000000000,39.34426229508197
360,3,3,6,60,120,1800,30,3000000000,100
491,9,3,12,40.916666666666664,163.66666666666666,2455,40.916666666666664,3000000000,73.31975560081467
601,9,3,12,50.083333333333336,200.33333333333334,3005,50.083333333333336,3000000000,59.90016638935108
745,9,3,12,62.083333333333336,248.33333333333334,3725,62.083333333333336,3000000000,48.32214765100671
936,12,3,15,62.4,312,4680,78,3000000000,38.46153846153847
375,7,3,10,37.5,125,1875,31.25,3000000000,96
219,3,3,6,36.5,73,1095,18.25,3000000000,164.3835616438356
362,7,3,10,36.2,120.66666666666667,1810,30.166666666666668,3000000000,99.4475138121547
376,6,3,9,41.77777777777778,125.33333333333333,1880,31.333333333333332,3000000000,95.74468085106383
693,13,6,19,36.473684210526315,115.5,3465,57.75,6000000000,103.8961038961039
771,12,3,15,51.4,257,3855,64.25,3000000000,46.69260700389105
278,6,3,9,30.88888888888889,92.66666666666667,1390,23.166666666666668,3000000000,129.49640287769785
699,10,5,15,46.6,139.8,3495,58.25,5000000000,85.83690987124464
1115,14,3,17,65.58823529411765,371.6666666666667,5575,92.91666666666667,3000000000,32.28699551569507
911,13,3,16,56.9375,303.6666666666667,4555,75.91666666666667,3000000000,39.51701427003293
474,8,3,11,43.09090909090909,158,2370,39.5,3000000000,75.94936708860759
488,3,4,7,69.71428571428571,122,2440,40.666666666666664,4000000000,98.36065573770492
489,11,3,14,34.92857142857143,163,2445,40.75,3000000000,73.61963190184049
479,7,3,10,47.9,159.66666666666666,2395,39.916666666666664,3000000000,75.15657620041755
358,8,3,11,32.54545454545455,119.33333333333333,1790,29.833333333333332,3000000000,100.5586592178771
290,5,4,9,32.22222222222222,72.5,1450,24.166666666666668,4000000000,165.51724137931035
582,5,6,11,52.90909090909091,97,2910,48.5,6000000000,123.71134020618557
882,16,5,21,42,176.4,4410,73.5,5000000000,68.02721088435374
1201,13,3,16,75.0625,400.3333333333333,6005,100.08333333333333,3000000000,29.975020815986678
595,8,3,11,54.09090909090909,198.33333333333334,2975,49.583333333333336,3000000000,60.50420168067227
328,6,3,9,36.44444444444444,109.33333333333333,1640,27.333333333333332,3000000000,109.7560975609756
479,10,3,13,36.84615384615385,159.66666666666666,2395,39.916666666666664,3000000000,75.15657620041755
398,6,4,10,39.8,99.5,1990,33.166666666666664,4000000000,120.6030150753769
523,6,5,11,47.54545454545455,104.6,2615,43.583333333333336,5000000000,114.72275334608031
589,10,3,13,45.30769230769231,196.33333333333334,2945,49.083333333333336,3000000000,61.120543293718164
781,10,3,13,60.07692307692308,260.3333333333333,3905,65.08333333333333,3000000000,46.09475032010244
570,8,5,13,43.84615384615385,114,2850,47.5,5000000000,105.26315789473684
818,12,7,19,43.05263157894737,116.85714285714286,4090,68.16666666666667,7000000000,102.68948655256723
657,10,3,13,50.53846153846154,219,3285,54.75,3000000000,54.79452054794521
470,9,3,12,39.166666666666664,156.66666666666666,2350,39.166666666666664,3000000000,76.59574468085107
830,12,3,15,55.333333333333336,276.6666666666667,4150,69.16666666666667,3000000000,43.37349397590361
462,5,3,8,57.75,154,2310,38.5,3000000000,77.92207792207792
545,10,3,13,41.92307692307692,181.66666666666666,2725,45.416666666666664,3000000000,66.05504587155963
1041,18,3,21,49.57142857142857,347,5205,86.75,3000000000,34.5821325648415
324,4,4,8,40.5,81,1620,27,4000000000,148.14814814814815
215,6,3,9,23.88888888888889,71.66666666666667,1075,17.916666666666668,3000000000,167.44186046511626
990,14,6,20,49.5,165,4950,82.5,6000000000,72.72727272727273
376,10,4,14,26.857142857142858,94,1880,31.333333333333332,4000000000,127.65957446808511
566,10,6,16,35.375,94.33333333333333,2830,47.166666666666664,6000000000,127.20848056537103
181,6,3,9,20.11111111111111,60.333333333333336,905,15.083333333333334,3000000000,198.8950276243094
535,9,6,15,35.666666666666664,89.16666666666667,2675,44.583333333333336,6000000000,134.57943925233644
358,9,3,12,29.833333333333332,119.33333333333333,1790,29.833333333333332,3000000000,100.5586592178771
631,12,3,15,42.06666666666667,210.33333333333334,3155,52.583333333333336,3000000000,57.05229793977813
1058,12,3,15,70.53333333333333,352.6666666666667,5290,88.16666666666667,3000000000,34.02646502835538
965,15,7,22,43.86363636363637,137.85714285714286,4825,80.41666666666667,7000000000,87.04663212435231
279,4,3,7,39.857142857142854,93,1395,23.25,3000000000,129.03225806451613
267,4,3,7,38.142857142857146,89,1335,22.25,3000000000,134.83146067415728
508,14,5,19,26.736842105263158,101.6,2540,42.333333333333336,5000000000,118.11023622047244
441,8,3,11,40.09090909090909,147,2205,36.75,3000000000,81.63265306122449
718,10,5,15,47.86666666666667,143.6,3590,59.833333333333336,5000000000,83.56545961002784
915,10,3,13,70.38461538461539,305,4575,76.25,3000000000,39.34426229508197
291,3,3,6,48.5,97,1455,24.25,3000000000,123.71134020618557
324,7,3,10,32.4,108,1620,27,3000000000,111.1111111111111
459,6,3,9,51,153,2295,38.25,3000000000,78.4313725490196
1189,26,6,32,37.15625,198.16666666666666,5945,99.08333333333333,6000000000,60.55508830950379
617,10,3,13,47.46153846153846,205.66666666666666,3085,51.416666666666664,3000000000,58.346839546191255
519,7,3,10,51.9,173,2595,43.25,3000000000,69.36416184971098
541,4,3,7,77.28571428571429,180.33333333333334,2705,45.083333333333336,3000000000,66.54343807763401
610,9,3,12,50.833333333333336,203.33333333333334,3050,50.833333333333336,3000000000,59.01639344262294
1034,19,5,24,43.083333333333336,206.8,5170,86.16666666666667,5000000000,58.027079303675045
476,10,3,13,36.61538461538461,158.66666666666666,2380,39.666666666666664,3000000000,75.63025210084035
850,22,7,29,29.310344827586206,121.42857142857143,4250,70.83333333333333,7000000000,98.82352941176471
878,15,10,25,35.12,87.8,4390,73.16666666666667,10000000000,136.6742596810934
679,9,4,13,52.23076923076923,169.75,3395,56.583333333333336,4000000000,70.6921944035346
953,14,3,17,56.05882352941177,317.6666666666667,4765,79.41666666666667,3000000000,37.775445960125914
360,8,6,14,25.714285714285715,60,1800,30,6000000000,200
326,6,3,9,36.22222222222222,108.66666666666667,1630,27.166666666666668,3000000000,110.42944785276073
316,7,7,14,22.571428571428573,45.142857142857146,1580,26.333333333333332,7000000000,265.8227848101266
1138,19,7,26,43.76923076923077,162.57142857142858,5690,94.83333333333333,7000000000,73.81370826010544
784,11,10,21,37.333333333333336,78.4,3920,65.33333333333333,10000000000,153.06122448979593
481,6,3,9,53.44444444444444,160.33333333333334,2405,40.083333333333336,3000000000,74.84407484407484
641,4,4,8,80.125,160.25,3205,53.416666666666664,4000000000,74.88299531981279
603,10,3,13,46.38461538461539,201,3015,50.25,3000000000,59.701492537313435
438,4,3,7,62.57142857142857,146,2190,36.5,3000000000,82.1917808219178
537,9,3,12,44.75,179,2685,44.75,3000000000,67.0391061452514
568,6,5,11,51.63636363636363,113.6,2840,47.333333333333336,5000000000,105.6338028169014
264,6,4,10,26.4,66,1320,22,4000000000,181.8181818181818
696,6,7,13,53.53846153846154,99.42857142857143,3480,58,7000000000,120.6896551724138
936,15,7,22,42.54545454545455,133.71428571428572,4680,78,7000000000,89.74358974358974
309,7,3,10,30.9,103,1545,25.75,3000000000,116.50485436893204
467,4,3,7,66.71428571428571,155.66666666666666,2335,38.916666666666664,3000000000,77.08779443254818
624,8,4,12,52,156,3120,52,4000000000,76.92307692307693
574,8,3,11,52.18181818181818,191.33333333333334,2870,47.833333333333336,3000000000,62.7177700348432
782,8,6,14,55.857142857142854,130.33333333333334,3910,65.16666666666667,6000000000,92.07161125319692
452,7,3,10,45.2,150.66666666666666,2260,37.666666666666664,3000000000,79.64601769911505
565,7,5,12,47.083333333333336,113,2825,47.083333333333336,5000000000,106.19469026548671
258,3,5,8,32.25,51.6,1290,21.5,5000000000,232.5581395348837
356,5,3,8,44.5,118.66666666666667,1780,29.666666666666668,3000000000,101.12359550561797
750,9,7,16,46.875,107.14285714285714,3750,62.5,7000000000,112
494,11,4,15,32.93333333333333,123.5,2470,41.166666666666664,4000000000,97.16599190283401
585,6,3,9,65,195,2925,48.75,3000000000,61.53846153846153
838,11,5,16,52.375,167.6,4190,69.83333333333333,5000000000,71.59904534606207
1394,15,8,23,60.608695652173914,174.25,6970,116.16666666666667,8000000000,68.86657101865137
446,5,4,9,49.55555555555556,111.5,2230,37.166666666666664,4000000000,107.62331838565024
745,5,7,12,62.083333333333336,106.42857142857143,3725,62.083333333333336,7000000000,112.75167785234898
239,6,5,11,21.727272727272727,47.8,1195,19.916666666666668,5000000000,251.04602510460248
1051,17,3,20,52.55,350.3333333333333,5255,87.58333333333333,3000000000,34.25309229305424
681,15,3,18,37.833333333333336,227,3405,56.75,3000000000,52.86343612334802
501,6,3,9,55.666666666666664,167,2505,41.75,3000000000,71.85628742514969
513,9,8,17,30.176470588235293,64.125,2565,42.75,8000000000,187.1345029239766
601,11,3,14,42.92857142857143,200.33333333333334,3005,50.083333333333336,3000000000,59.90016638935108
244,4,3,7,34.857142857142854,81.33333333333333,1220,20.333333333333332,3000000000,147.5409836065574
672,10,9,19,35.36842105263158,74.66666666666667,3360,56,9000000000,160.7142857142857
1305,24,4,28,46.607142857142854,326.25,6525,108.75,4000000000,36.781609195402304
491,9,3,12,40.916666666666664,163.66666666666666,2455,40.916666666666664,3000000000,73.31975560081467
469,8,4,12,39.083333333333336,117.25,2345,39.083333333333336,4000000000,102.34541577825159
775,13,6,19,40.78947368421053,129.16666666666666,3875,64.58333333333333,6000000000,92.90322580645162
481,9,4,13,37,120.25,2405,40.083333333333336,4000000000,99.79209979209979
799,8,3,11,72.63636363636364,266.3333333333333,3995,66.58333333333333,3000000000,45.056320400500624
958,18,7,25,38.32,136.85714285714286,4790,79.83333333333333,7000000000,87.68267223382047
451,10,3,13,34.69230769230769,150.33333333333334,2255,37.583333333333336,3000000000,79.82261640798227
514,7,3,10,51.4,171.33333333333334,2570,42.833333333333336,3000000000,70.03891050583658
695,9,5,14,49.642857142857146,139,3475,57.916666666666664,5000000000,86.33093525179856
515,7,4,11,46.81818181818182,128.75,2575,42.916666666666664,4000000000,93.20388349514563
275,7,4,11,25,68.75,1375,22.916666666666668,4000000000,174.54545454545453
316,6,3,9,35.111111111111114,105.33333333333333,1580,26.333333333333332,3000000000,113.9240506329114
1062,18,11,29,36.62068965517241,96.54545454545455,5310,88.5,11000000000,124.29378531073446
189,3,3,6,31.5,63,945,15.75,3000000000,190.47619047619048
361,3,3,6,60.166666666666664,120.33333333333333,1805,30.083333333333332,3000000000,99.7229916897507
657,8,5,13,50.53846153846154,131.4,3285,54.75,5000000000,91.32420091324201
662,7,4,11,60.18181818181818,165.5,3310,55.166666666666664,4000000000,72.50755287009063
462,11,3,14,33,154,2310,38.5,3000000000,77.92207792207792
624,7,4,11,56.72727272727273,156,3120,52,4000000000,76.92307692307693
579,8,3,11,52.63636363636363,193,2895,48.25,3000000000,62.17616580310881
802,10,4,14,57.285714285714285,200.5,4010,66.83333333333333,4000000000,59.85037406483791
807,12,6,18,44.833333333333336,134.5,4035,67.25,6000000000,89.21933085501858
785,13,3,16,49.0625,261.6666666666667,3925,65.41666666666667,3000000000,45.859872611464965
980,19,3,22,44.54545454545455,326.6666666666667,4900,81.66666666666667,3000000000,36.73469387755102
1000,11,4,15,66.66666666666667,250,5000,83.33333333333333,4000000000,48
510,4,3,7,72.85714285714286,170,2550,42.5,3000000000,70.58823529411764
632,11,3,14,45.142857142857146,210.66666666666666,3160,52.666666666666664,3000000000,56.9620253164557
545,7,7,14,38.92857142857143,77.85714285714286,2725,45.416666666666664,7000000000,154.12844036697248
785,12,4,16,49.0625,196.25,3925,65.41666666666667,4000000000,61.146496815286625
713,13,3,16,44.5625,237.66666666666666,3565,59.416666666666664,3000000000,50.490883590462836
192,5,3,8,24,64,960,16,3000000000,187.5
1212,14,6,20,60.6,202,6060,101,6000000000,59.40594059405941
785,11,6,17,46.1764705882353,130.83333333333334,3925,65.41666666666667,6000000000,91.71974522292993
545,8,3,11,49.54545454545455,181.66666666666666,2725,45.416666666666664,3000000000,66.05504587155963
326,5,3,8,40.75,108.66666666666667,1630,27.166666666666668,3000000000,110.42944785276073
297,7,3,10,29.7,99,1485,24.75,3000000000,121.21212121212122
549,9,3,12,45.75,183,2745,45.75,3000000000,65.57377049180329
728,15,3,18,40.44444444444444,242.66666666666666,3640,60.666666666666664,3000000000,49.45054945054945
646,11,7,18,35.888888888888886,92.28571428571429,3230,53.833333333333336,7000000000,130.03095975232196
544,12,4,16,34,136,2720,45.333333333333336,4000000000,88.23529411764706
457,9,3,12,38.083333333333336,152.33333333333334,2285,38.083333333333336,3000000000,78.77461706783369
409,7,3,10,40.9,136.33333333333334,2045,34.083333333333336,3000000000,88.01955990220048
285,7,3,10,28.5,95,1425,23.75,3000000000,126.3157894736842
947,13,3,16,59.1875,315.6666666666667,4735,78.91666666666667,3000000000,38.01478352692713
370,8,6,14,26.428571428571427,61.666666666666664,1850,30.833333333333332,6000000000,194.5945945945946
951,19,3,22,43.22727272727273,317,4755,79.25,3000000000,37.85488958990537
721,9,3,12,60.083333333333336,240.33333333333334,3605,60.083333333333336,3000000000,49.930651872399444
900,12,3,15,60,300,4500,75,3000000000,40
824,13,4,17,48.470588235294116,206,4120,68.66666666666667,4000000000,58.252427184466015
345,4,4,8,43.125,86.25,1725,28.75,4000000000,139.1304347826087
414,7,3,10,41.4,138,2070,34.5,3000000000,86.95652173913044
921,9,4,13,70.84615384615384,230.25,4605,76.75,4000000000,52.11726384364821
501,9,3,12,41.75,167,2505,41.75,3000000000,71.85628742514969
524,10,3,13,40.30769230769231,174.66666666666666,2620,43.666666666666664,3000000000,68.70229007633587
371,5,3,8,46.375,123.66666666666667,1855,30.916666666666668,3000000000,97.03504043126685
311,7,3,10,31.1,103.66666666666667,1555,25.916666666666668,3000000000,115.75562700964629
359,11,3,14,25.642857142857142,119.66666666666667,1795,29.916666666666668,3000000000,100.27855153203343
516,9,3,12,43,172,2580,43,3000000000,69.76744186046511
281,6,3,9,31.22222222222222,93.66666666666667,1405,23.416666666666668,3000000000,128.1138790035587
1188,10,3,13,91.38461538461539,396,5940,99,3000000000,30.303030303030305
868,10,9,19,45.68421052631579,96.44444444444444,4340,72.33333333333333,9000000000,124.42396313364056
481,8,3,11,43.72727272727273,160.33333333333334,2405,40.083333333333336,3000000000,74.84407484407484
573,10,5,15,38.2,114.6,2865,47.75,5000000000,104.71204188481676
337,5,3,8,42.125,112.33333333333333,1685,28.083333333333332,3000000000,106.82492581602374
434,5,3,8,54.25,144.66666666666666,2170,36.166666666666664,3000000000,82.94930875576037
934,12,3,15,62.266666666666666,311.3333333333333,4670,77.83333333333333,3000000000,38.54389721627409
910,14,6,20,45.5,151.66666666666666,4550,75.83333333333333,6000000000,79.12087912087912
1005,19,3,22,45.68181818181818,335,5025,83.75,3000000000,35.820895522388064
420,6,4,10,42,105,2100,35,4000000000,114.28571428571428
1116,10,8,18,62,139.5,5580,93,8000000000,86.02150537634408
605,9,3,12,50.416666666666664,201.66666666666666,3025,50.416666666666664,3000000000,59.50413223140496
1179,15,7,22,53.59090909090909,168.42857142857142,5895,98.25,7000000000,71.24681933842238
541,5,3,8,67.625,180.33333333333334,2705,45.083333333333336,3000000000,66.54343807763401
909,18,3,21,43.285714285714285,303,4545,75.75,3000000000,39.603960396039604
638,6,7,13,49.07692307692308,91.14285714285714,3190,53.166666666666664,7000000000,131.6614420062696
280,7,3,10,28,93.33333333333333,1400,23.333333333333332,3000000000,128.57142857142858
1042,9,10,19,54.8421052631579,104.2,5210,86.83333333333333,10000000000,115.16314779270634
660,13,4,17,38.8235294117647,165,3300,55,4000000000,72.72727272727273
371,6,3,9,41.22222222222222,123.66666666666667,1855,30.916666666666668,3000000000,97.03504043126685
680,15,7,22,30.90909090909091,97.14285714285714,3400,56.666666666666664,7000000000,123.52941176470588
354,10,6,16,22.125,59,1770,29.5,6000000000,203.38983050847457
502,9,5,14,35.857142857142854,100.4,2510,41.833333333333336,5000000000,119.5219123505976
639,10,5,15,42.6,127.8,3195,53.25,5000000000,93.89671361502347
435,7,3,10,43.5,145,2175,36.25,3000000000,82.75862068965517
769,12,3,15,51.266666666666666,256.3333333333333,3845,64.08333333333333,3000000000,46.81404421326398
748,8,6,14,53.42857142857143,124.66666666666667,3740,62.333333333333336,6000000000,96.2566844919786
356,8,3,11,32.36363636363637,118.66666666666667,1780,29.666666666666668,3000000000,101.12359550561797
380,5,5,10,38,76,1900,31.666666666666668,5000000000,157.89473684210526
491,6,4,10,49.1,122.75,2455,40.916666666666664,4000000000,97.759674134419555
577,10,6,16,36.0625,96.16666666666667,2885,48.083333333333336,6000000000,124.78336221837088
1100,18,6,24,45.833333333333336,183.33333333333334,5500,91.66666666666667,6000000000,65.45454545454545
633,7,5,12,52.75,126.6,3165,52.75,5000000000,94.7867298578199
430,7,3,10,43,143.33333333333334,2150,35.833333333333336,3000000000,83.72093023255813
1050,14,4,18,58.333333333333336,262.5,5250,87.5,4000000000,45.714285714285715
619,6,6,12,51.583333333333336,103.16666666666667,3095,51.583333333333336,6000000000,116.31663974151857
420,6,3,9,46.666666666666664,140,2100,35,3000000000,85.71428571428572
301,7,3,10,30.1,100.33333333333333,1505,25.083333333333332,3000000000,119.60132890365449
980,16,4,20,49,245,4900,81.66666666666667,4000000000,48.97959183673469
557,6,5,11,50.63636363636363,111.4,2785,46.416666666666664,5000000000,107.71992818671454
744,13,6,19,39.1578947368421,124,3720,62,6000000000,96.77419354838709
269,3,3,6,44.833333333333336,89.66666666666667,1345,22.416666666666668,3000000000,133.82899628252787
456,4,3,7,65.14285714285714,152,2280,38,3000000000,78.94736842105263
1443,27,6,33,43.72727272727273,240.5,7215,120.25,6000000000,49.896049896049895
290,5,3,8,36.25,96.66666666666667,1450,24.166666666666668,3000000000,124.13793103448275
407,9,5,14,29.071428571428573,81.4,2035,33.916666666666664,5000000000,147.42014742014743
612,14,3,17,36,204,3060,51,3000000000,58.8235294117647
484,3,3,6,80.66666666666667,161.33333333333334,2420,40.333333333333336,3000000000,74.3801652892562
504,9,3,12,42,168,2520,42,3000000000,71.42857142857143
401,8,3,11,36.45454545454545,133.66666666666666,2005,33.416666666666664,3000000000,89.77556109725687
1115,21,10,31,35.96774193548387,111.5,5575,92.91666666666667,10000000000,107.62331838565022
829,11,3,14,59.214285714285715,276.3333333333333,4145,69.08333333333333,3000000000,43.42581423401689
889,10,3,13,68.38461538461539,296.3333333333333,4445,74.08333333333333,3000000000,40.49493813273341
522,5,5,10,52.2,104.4,2610,43.5,5000000000,114.94252873563218
578,9,6,15,38.53333333333333,96.33333333333333,2890,48.166666666666664,6000000000,124.56747404844292
521,5,3,8,65.125,173.66666666666666,2605,43.416666666666664,3000000000,69.0978886756238
392,8,6,14,28,65.33333333333333,1960,32.666666666666664,6000000000,183.67346938775512
479,9,3,12,39.916666666666664,159.66666666666666,2395,39.916666666666664,3000000000,75.15657620041755
528,8,5,13,40.61538461538461,105.6,2640,44,5000000000,113.63636363636364
1398,19,5,24,58.25,279.6,6990,116.5,5000000000,42.91845493562232
386,7,3,10,38.6,128.66666666666666,1930,32.166666666666664,3000000000,93.26424870466322
488,6,7,13,37.53846153846154,69.71428571428571,2440,40.666666666666664,7000000000,172.13114754098362
859,12,4,16,53.6875,214.75,4295,71.58333333333333,4000000000,55.87892898719442
1213,20,3,23,52.73913043478261,404.3333333333333,6065,101.08333333333333,3000000000,29.67848309975268
456,4,3,7,65.14285714285714,152,2280,38,3000000000,78.94736842105263
506,4,3,7,72.28571428571429,168.66666666666666,2530,42.166666666666664,3000000000,71.14624505928855
312,3,3,6,52,104,1560,26,3000000000,115.38461538461539
770,10,5,15,51.333333333333336,154,3850,64.16666666666667,5000000000,77.9220779220779
740,9,10,19,38.94736842105263,74,3700,61.666666666666664,10000000000,162.16216216216216
216,3,3,6,36,72,1080,18,3000000000,166.66666666666666
917,14,4,18,50.94444444444444,229.25,4585,76.41666666666667,4000000000,52.344601962922575
287,6,3,9,31.88888888888889,95.66666666666667,1435,23.916666666666668,3000000000,125.4355400696864
498,8,6,14,35.57142857142857,83,2490,41.5,6000000000,144.57831325301206
1045,13,6,19,55,174.16666666666666,5225,87.08333333333333,6000000000,68.89952153110048
490,11,3,14,35,163.33333333333334,2450,40.833333333333336,3000000000,73.46938775510203
314,9,3,12,26.166666666666668,104.66666666666667,1570,26.166666666666668,3000000000,114.64968152866241
566,14,3,17,33.294117647058826,188.66666666666666,2830,47.166666666666664,3000000000,63.60424028268552
1210,16,3,19,63.68421052631579,403.3333333333333,6050,100.83333333333333,3000000000,29.75206611570248
454,8,3,11,41.27272727272727,151.33333333333334,2270,37.833333333333336,3000000000,79.29515418502203
203,5,3,8,25.375,67.66666666666667,1015,16.916666666666668,3000000000,177.33990147783248
464,5,3,8,58,154.66666666666666,2320,38.666666666666664,3000000000,77.58620689655173
505,5,3,8,63.125,168.33333333333334,2525,42.083333333333336,3000000000,71.28712871287128
448,6,5,11,40.72727272727273,89.6,2240,37.333333333333336,5000000000,133.92857142857142
314,4,3,7,44.857142857142854,104.66666666666667,1570,26.166666666666668,3000000000,114.64968152866241
564,7,3,10,56.4,188,2820,47,3000000000,63.829787234042556
388,8,3,11,35.27272727272727,129.33333333333334,1940,32.333333333333336,3000000000,92.78350515463917
594,13,4,17,34.94117647058823,148.5,2970,49.5,4000000000,80.8080808080808
455,5,3,8,56.875,151.66666666666666,2275,37.916666666666664,3000000000,79.12087912087912
760,12,4,16,47.5,190,3800,63.333333333333336,4000000000,63.1578947368421
852,18,3,21,40.57142857142857,284,4260,71,3000000000,42.25352112676057
918,20,13,33,27.818181818181817,70.61538461538461,4590,76.5,13000000000,169.9346405228758
471,6,4,10,47.1,117.75,2355,39.25,4000000000,101.91082802547771
858,11,6,17,50.470588235294116,143,4290,71.5,6000000000,83.91608391608392
587,11,3,14,41.92857142857143,195.66666666666666,2935,48.916666666666664,3000000000,61.32879045996593
594,9,6,15,39.6,99,2970,49.5,6000000000,121.21212121212122
584,7,3,10,58.4,194.66666666666666,2920,48.666666666666664,3000000000,61.64383561643836
634,6,3,9,70.44444444444444,211.33333333333334,3170,52.833333333333336,3000000000,56.78233438485804
338,6,6,12,28.166666666666668,56.333333333333336,1690,28.166666666666668,6000000000,213.01775147928993
656,7,3,10,65.6,218.66666666666666,3280,54.666666666666664,3000000000,54.8780487804878
744,11,3,14,53.142857142857146,248,3720,62,3000000000,48.387096774193544
480,7,4,11,43.63636363636363,120,2400,40,4000000000,100
534,7,6,13,41.07692307692308,89,2670,44.5,6000000000,134.83146067415728
629,8,9,17,37,69.88888888888889,3145,52.416666666666664,9000000000,171.70111287758348
186,4,3,7,26.571428571428573,62,930,15.5,3000000000,193.54838709677418
431,7,3,10,43.1,143.66666666666666,2155,35.916666666666664,3000000000,83.52668213457078
734,6,9,15,48.93333333333333,81.55555555555556,3670,61.166666666666664,9000000000,147.13896457765668
275,7,3,10,27.5,91.66666666666667,1375,22.916666666666668,3000000000,130.9090909090909
397,3,3,6,66.16666666666667,132.33333333333334,1985,33.083333333333336,3000000000,90.6801007556675
850,9,3,12,70.83333333333333,283.3333333333333,4250,70.83333333333333,3000000000,42.352941176470594
626,9,8,17,36.8235294117647,78.25,3130,52.166666666666664,8000000000,153.3546325878594
857,11,3,14,61.214285714285715,285.6666666666667,4285,71.41666666666667,3000000000,42.00700116686114
536,8,3,11,48.72727272727273,178.66666666666666,2680,44.666666666666664,3000000000,67.16417910447761
765,13,4,17,45,191.25,3825,63.75,4000000000,62.745098039215684
329,4,3,7,47,109.66666666666667,1645,27.416666666666668,3000000000,109.4224924012158
581,13,3,16,36.3125,193.66666666666666,2905,48.416666666666664,3000000000,61.96213425129088
979,11,3,14,69.92857142857143,326.3333333333333,4895,81.58333333333333,3000000000,36.77221654749745
515,8,3,11,46.81818181818182,171.66666666666666,2575,42.916666666666664,3000000000,69.90291262135923
757,7,3,10,75.7,252.33333333333334,3785,63.083333333333336,3000000000,47.556142668428
451,6,3,9,50.111111111111114,150.33333333333334,2255,37.583333333333336,3000000000,79.82261640798227
717,15,3,18,39.833333333333336,239,3585,59.75,3000000000,50.2092050209205
964,14,3,17,56.705882352941174,321.3333333333333,4820,80.33333333333333,3000000000,37.344398340248965
509,5,3,8,63.625,169.66666666666666,2545,42.416666666666664,3000000000,70.7269155206287
1318,14,3,17,77.52941176470588,439.3333333333333,6590,109.83333333333333,3000000000,27.314112291350533
394,5,4,9,43.77777777777778,98.5,1970,32.833333333333336,4000000000,121.82741116751268
646,13,3,16,40.375,215.33333333333334,3230,53.833333333333336,3000000000,55.72755417956656
504,13,4,17,29.647058823529413,126,2520,42,4000000000,95.23809523809524
427,11,3,14,30.5,142.33333333333334,2135,35.583333333333336,3000000000,84.30913348946135
622,13,6,19,32.73684210526316,103.66666666666667,3110,51.833333333333336,6000000000,115.75562700964629
649,15,3,18,36.05555555555556,216.33333333333334,3245,54.083333333333336,3000000000,55.46995377503852
719,9,3,12,59.916666666666664,239.66666666666666,3595,59.916666666666664,3000000000,50.06954102920724
111,5,4,9,12.333333333333334,27.75,555,9.25,4000000000,432.4324324324324
590,7,3,10,59,196.66666666666666,2950,49.166666666666664,3000000000,61.016949152542374
250,4,3,7,35.714285714285715,83.33333333333333,1250,20.833333333333332,3000000000,144
1005,18,5,23,43.69565217391305,201,5025,83.75,5000000000,59.701492537313435
616,10,6,16,38.5,102.66666666666667,3080,51.333333333333336,6000000000,116.88311688311687
500,5,3,8,62.5,166.66666666666666,2500,41.666666666666664,3000000000,72
813,14,3,17,47.8235294117647,271,4065,67.75,3000000000,44.28044280442804
521,5,6,11,47.36363636363637,86.83333333333333,2605,43.416666666666664,6000000000,138.1957773512476
945,12,3,15,63,315,4725,78.75,3000000000,38.095238095238095
451,8,3,11,41,150.33333333333334,2255,37.583333333333336,3000000000,79.82261640798227
616,9,4,13,47.38461538461539,154,3080,51.333333333333336,4000000000,77.92207792207792
496,11,3,14,35.42857142857143,165.33333333333334,2480,41.333333333333336,3000000000,72.58064516129032
413,4,3,7,59,137.66666666666666,2065,34.416666666666664,3000000000,87.16707021791768
409,7,3,10,40.9,136.33333333333334,2045,34.083333333333336,3000000000,88.01955990220048
402,7,3,10,40.2,134,2010,33.5,3000000000,89.55223880597015
332,6,3,9,36.888888888888886,110.66666666666667,1660,27.666666666666668,3000000000,108.43373493975903
615,13,3,16,38.4375,205,3075,51.25,3000000000,58.53658536585366
402,10,3,13,30.923076923076923,134,2010,33.5,3000000000,89.55223880597015
408,9,7,16,25.5,58.285714285714285,2040,34,7000000000,205.88235294117646
380,7,4,11,34.54545454545455,95,1900,31.666666666666668,4000000000,126.3157894736842
384,10,4,14,27.428571428571427,96,1920,32,4000000000,125
287,5,3,8,35.875,95.66666666666667,1435,23.916666666666668,3000000000,125.4355400696864
265,5,3,8,33.125,88.33333333333333,1325,22.083333333333332,3000000000,135.8490566037736
1051,13,7,20,52.55,150.14285714285714,5255,87.58333333333333,7000000000,79.92388201712654
598,6,3,9,66.44444444444444,199.33333333333334,2990,49.833333333333336,3000000000,60.20066889632107
784,16,4,20,39.2,196,3920,65.33333333333333,4000000000,61.22448979591837
1136,14,6,20,56.8,189.33333333333334,5680,94.66666666666667,6000000000,63.38028169014084
547,8,4,12,45.583333333333336,136.75,2735,45.583333333333336,4000000000,87.75137111517367
622,15,3,18,34.55555555555556,207.33333333333334,3110,51.833333333333336,3000000000,57.877813504823145
455,10,3,13,35,151.66666666666666,2275,37.916666666666664,3000000000,79.12087912087912
1119,14,4,18,62.166666666666664,279.75,5595,93.25,4000000000,42.89544235924933
968,14,8,22,44,121,4840,80.66666666666667,8000000000,99.17355371900825
1027,13,3,16,64.1875,342.3333333333333,5135,85.58333333333333,3000000000,35.05355404089581
877,13,10,23,38.130434782608695,87.7,4385,73.08333333333333,10000000000,136.830102622577
516,7,3,10,51.6,172,2580,43,3000000000,69.76744186046511
724,12,7,19,38.10526315789474,103.42857142857143,3620,60.333333333333336,7000000000,116.02209944751381
811,10,5,15,54.06666666666667,162.2,4055,67.58333333333333,5000000000,73.98273736128237
332,7,3,10,33.2,110.66666666666667,1660,27.666666666666668,3000000000,108.43373493975903
243,4,5,9,27,48.6,1215,20.25,5000000000,246.91358024691357
706,9,3,12,58.833333333333336,235.33333333333334,3530,58.833333333333336,3000000000,50.991501416430594
546,13,5,18,30.333333333333332,109.2,2730,45.5,5000000000,109.8901098901099
712,8,3,11,64.72727272727273,237.33333333333334,3560,59.333333333333336,3000000000,50.561797752808985
601,11,3,14,42.92857142857143,200.33333333333334,3005,50.083333333333336,3000000000,59.90016638935108
417,4,3,7,59.57142857142857,139,2085,34.75,3000000000,86.33093525179855
811,15,3,18,45.05555555555556,270.3333333333333,4055,67.58333333333333,3000000000,44.38964241676942
746,10,3,13,57.38461538461539,248.66666666666666,3730,62.166666666666664,3000000000,48.2573726541555
920,19,3,22,41.81818181818182,306.6666666666667,4600,76.66666666666667,3000000000,39.130434782608695
534,10,4,14,38.142857142857146,133.5,2670,44.5,4000000000,89.8876404494382
1029,16,7,23,44.73913043478261,147,5145,85.75,7000000000,81.63265306122449
580,16,3,19,30.526315789473685,193.33333333333334,2900,48.333333333333336,3000000000,62.068965517241374
628,11,5,16,39.25,125.6,3140,52.333333333333336,5000000000,95.54140127388534
1298,21,8,29,44.758620689655174,162.25,6490,108.16666666666667,8000000000,73.95993836671802
947,14,3,17,55.705882352941174,315.6666666666667,4735,78.91666666666667,3000000000,38.01478352692713
203,5,3,8,25.375,67.66666666666667,1015,16.916666666666668,3000000000,177.33990147783248
549,5,3,8,68.625,183,2745,45.75,3000000000,65.57377049180329
489,9,3,12,40.75,163,2445,40.75,3000000000,73.61963190184049
670,7,3,10,67,223.33333333333334,3350,55.833333333333336,3000000000,53.731343283582085
541,5,3,8,67.625,180.33333333333334,2705,45.083333333333336,3000000000,66.54343807763401
610,6,9,15,40.666666666666664,67.77777777777777,3050,50.833333333333336,9000000000,177.04918032786884
691,9,3,12,57.583333333333336,230.33333333333334,3455,57.583333333333336,3000000000,52.098408104196814
534,8,3,11,48.54545454545455,178,2670,44.5,3000000000,67.41573033707864
851,14,9,23,37,94.55555555555556,4255,70.91666666666667,9000000000,126.90951821386602
504,7,4,11,45.81818181818182,126,2520,42,4000000000,95.23809523809524
372,8,3,11,33.81818181818182,124,1860,31,3000000000,96.77419354838709
747,5,5,10,74.7,149.4,3735,62.25,5000000000,80.32128514056225
360,5,3,8,45,120,1800,30,3000000000,100
815,7,5,12,67.91666666666667,163,4075,67.91666666666667,5000000000,73.61963190184049
1113,9,7,16,69.5625,159,5565,92.75,7000000000,75.47169811320755
239,5,3,8,29.875,79.66666666666667,1195,19.916666666666668,3000000000,150.6276150627615
580,13,7,20,29,82.85714285714286,2900,48.333333333333336,7000000000,144.82758620689654
342,8,3,11,31.09090909090909,114,1710,28.5,3000000000,105.26315789473684
753,5,7,12,62.75,107.57142857142857,3765,62.75,7000000000,111.55378486055777
781,10,3,13,60.07692307692308,260.3333333333333,3905,65.08333333333333,3000000000,46.09475032010244
853,10,9,19,44.89473684210526,94.77777777777777,4265,71.08333333333333,9000000000,126.61195779601407
708,11,3,14,50.57142857142857,236,3540,59,3000000000,50.847457627118644
680,4,5,9,75.55555555555556,136,3400,56.666666666666664,5000000000,88.23529411764707
439,4,3,7,62.714285714285715,146.33333333333334,2195,36.583333333333336,3000000000,82.00455580865604
537,8,5,13,41.30769230769231,107.4,2685,44.75,5000000000,111.73184357541899
299,7,3,10,29.9,99.66666666666667,1495,24.916666666666668,3000000000,120.40133779264214
343,6,4,10,34.3,85.75,1715,28.583333333333332,4000000000,139.94169096209913
403,5,6,11,36.63636363636363,67.16666666666667,2015,33.583333333333336,6000000000,178.66004962779155
293,5,5,10,29.3,58.6,1465,24.416666666666668,5000000000,204.778156996587
328,5,3,8,41,109.33333333333333,1640,27.333333333333332,3000000000,109.7560975609756
682,14,3,17,40.11764705882353,227.33333333333334,3410,56.833333333333336,3000000000,52.785923753665685
1118,16,5,21,53.23809523809524,223.6,5590,93.16666666666667,5000000000,53.66726296958855
386,16,3,19,20.31578947368421,128.66666666666666,1930,32.166666666666664,3000000000,93.26424870466322
373,9,3,12,31.083333333333332,124.33333333333333,1865,31.083333333333332,3000000000,96.514745308311
899,10,3,13,69.15384615384616,299.6666666666667,4495,74.91666666666667,3000000000,40.04449388209121
933,14,3,17,54.88235294117647,311,4665,77.75,3000000000,38.58520900321543
701,10,7,17,41.23529411764706,100.14285714285714,3505,58.416666666666664,7000000000,119.82881597717548
1057,14,5,19,55.63157894736842,211.4,5285,88.08333333333333,5000000000,56.764427625354784
292,5,4,9,32.44444444444444,73,1460,24.333333333333332,4000000000,164.38356164383563
1152,24,3,27,42.666666666666664,384,5760,96,3000000000,31.25
967,22,5,27,35.81481481481482,193.4,4835,80.58333333333333,5000000000,62.04756980351603
287,4,3,7,41,95.66666666666667,1435,23.916666666666668,3000000000,125.4355400696864
862,12,6,18,47.888888888888886,143.66666666666666,4310,71.83333333333333,6000000000,83.52668213457078
1573,30,3,33,47.666666666666664,524.3333333333334,7865,131.08333333333334,3000000000,22.886204704386522
552,11,7,18,30.666666666666668,78.85714285714286,2760,46,7000000000,152.17391304347825
926,10,3,13,71.23076923076923,308.6666666666667,4630,77.16666666666667,3000000000,38.8768898488121
426,9,3,12,35.5,142,2130,35.5,3000000000,84.50704225352113
691,12,3,15,46.06666666666667,230.33333333333334,3455,57.583333333333336,3000000000,52.098408104196814
855,12,10,22,38.86363636363637,85.5,4275,71.25,10000000000,140.35087719298247
310,4,3,7,44.285714285714285,103.33333333333333,1550,25.833333333333332,3000000000,116.12903225806453
832,17,4,21,39.61904761904762,208,4160,69.33333333333333,4000000000,57.69230769230769
645,10,3,13,49.61538461538461,215,3225,53.75,3000000000,55.81395348837209
569,9,3,12,47.416666666666664,189.66666666666666,2845,47.416666666666664,3000000000,63.26889279437611
991,14,3,17,58.294117647058826,330.3333333333333,4955,82.58333333333333,3000000000,36.326942482341074
296,5,5,10,29.6,59.2,1480,24.666666666666668,5000000000,202.7027027027027
561,11,5,16,35.0625,112.2,2805,46.75,5000000000,106.951871657754
545,13,5,18,30.27777777777778,109,2725,45.416666666666664,5000000000,110.09174311926607
512,4,7,11,46.54545454545455,73.14285714285714,2560,42.666666666666664,7000000000,164.0625
307,4,3,7,43.857142857142854,102.33333333333333,1535,25.583333333333332,3000000000,117.26384364820846
613,11,3,14,43.785714285714285,204.33333333333334,3065,51.083333333333336,3000000000,58.727569331158236
1024,11,6,17,60.23529411764706,170.66666666666666,5120,85.33333333333333,6000000000,70.3125
676,16,11,27,25.037037037037038,61.45454545454545,3380,56.333333333333336,11000000000,195.2662721893491
290,9,3,12,24.166666666666668,96.66666666666667,1450,24.166666666666668,3000000000,124.13793103448275
830,16,6,22,37.72727272727273,138.33333333333334,4150,69.16666666666667,6000000000,86.74698795180721
761,11,3,14,54.357142857142854,253.66666666666666,3805,63.416666666666664,3000000000,47.306176084099874
583,7,3,10,58.3,194.33333333333334,2915,48.583333333333336,3000000000,61.74957118353345
437,11,4,15,29.133333333333333,109.25,2185,36.416666666666664,4000000000,109.83981693363846
638,7,3,10,63.8,212.66666666666666,3190,53.166666666666664,3000000000,56.426332288401255
375,8,3,11,34.09090909090909,125,1875,31.25,3000000000,96
1084,18,3,21,51.61904761904762,361.3333333333333,5420,90.33333333333333,3000000000,33.210332103321036
560,5,4,9,62.22222222222222,140,2800,46.666666666666664,4000000000,85.71428571428572
277,7,3,10,27.7,92.33333333333333,1385,23.083333333333332,3000000000,129.9638989169675
466,7,3,10,46.6,155.33333333333334,2330,38.833333333333336,3000000000,77.25321888412017
504,4,6,10,50.4,84,2520,42,6000000000,142.85714285714286
670,9,7,16,41.875,95.71428571428571,3350,55.833333333333336,7000000000,125.3731343283582
423,6,4,10,42.3,105.75,2115,35.25,4000000000,113.47517730496455
526,8,5,13,40.46153846153846,105.2,2630,43.833333333333336,5000000000,114.06844106463878
967,20,4,24,40.291666666666664,241.75,4835,80.58333333333333,4000000000,49.638055842812825
1188,10,3,13,91.38461538461539,396,5940,99,3000000000,30.303030303030305
541,8,3,11,49.18181818181818,180.33333333333334,2705,45.083333333333336,3000000000,66.54343807763401
1101,14,3,17,64.76470588235294,367,5505,91.75,3000000000,32.69754768392371
701,9,6,15,46.733333333333334,116.83333333333333,3505,58.416666666666664,6000000000,102.71041369472184
770,12,4,16,48.125,192.5,3850,64.16666666666667,4000000000,62.33766233766233
200,7,3,10,20,66.66666666666667,1000,16.666666666666668,3000000000,180
536,9,6,15,35.733333333333334,89.33333333333333,2680,44.666666666666664,6000000000,134.32835820895522
1027,12,4,16,64.1875,256.75,5135,85.58333333333333,4000000000,46.738072054527755
1091,16,10,26,41.96153846153846,109.1,5455,90.91666666666667,10000000000,109.99083409715857
1097,21,7,28,39.17857142857143,156.71428571428572,5485,91.41666666666667,7000000000,76.57247037374657
878,12,3,15,58.53333333333333,292.6666666666667,4390,73.16666666666667,3000000000,41.00227790432802
869,13,3,16,54.3125,289.6666666666667,4345,72.41666666666667,3000000000,41.42692750287687
1085,24,3,27,40.18518518518518,361.6666666666667,5425,90.41666666666667,3000000000,33.17972350230414
121,3,3,6,20.166666666666668,40.333333333333336,605,10.083333333333334,3000000000,297.5206611570248
687,14,5,19,36.1578947368421,137.4,3435,57.25,5000000000,87.33624454148472
413,7,3,10,41.3,137.66666666666666,2065,34.416666666666664,3000000000,87.16707021791768
551,12,3,15,36.733333333333334,183.66666666666666,2755,45.916666666666664,3000000000,65.33575317604357
661,8,5,13,50.84615384615385,132.2,3305,55.083333333333336,5000000000,90.7715582450832
801,12,3,15,53.4,267,4005,66.75,3000000000,44.9438202247191
756,12,3,15,50.4,252,3780,63,3000000000,47.61904761904762
615,8,3,11,55.90909090909091,205,3075,51.25,3000000000,58.53658536585366
661,12,5,17,38.88235294117647,132.2,3305,55.083333333333336,5000000000,90.7715582450832
751,13,3,16,46.9375,250.33333333333334,3755,62.583333333333336,3000000000,47.93608521970706
736,16,6,22,33.45454545454545,122.66666666666667,3680,61.333333333333336,6000000000,97.82608695652173
745,11,4,15,49.666666666666664,186.25,3725,62.083333333333336,4000000000,64.42953020134227
828,12,4,16,51.75,207,4140,69,4000000000,57.971014492753625
431,6,3,9,47.888888888888886,143.66666666666666,2155,35.916666666666664,3000000000,83.52668213457078
384,4,5,9,42.666666666666664,76.8,1920,32,5000000000,156.25
421,9,3,12,35.083333333333336,140.33333333333334,2105,35.083333333333336,3000000000,85.5106888361045
559,11,3,14,39.92857142857143,186.33333333333334,2795,46.583333333333336,3000000000,64.40071556350627
736,8,4,12,61.333333333333336,184,3680,61.333333333333336,4000000000,65.21739130434781
623,8,3,11,56.63636363636363,207.66666666666666,3115,51.916666666666664,3000000000,57.784911717495994
223,9,3,12,18.583333333333332,74.33333333333333,1115,18.583333333333332,3000000000,161.43497757847535
1198,25,12,37,32.37837837837838,99.83333333333333,5990,99.83333333333333,12000000000,120.20033388981638
616,9,3,12,51.333333333333336,205.33333333333334,3080,51.333333333333336,3000000000,58.441558441558435
881,21,3,24,36.708333333333336,293.6666666666667,4405,73.41666666666667,3000000000,40.86265607264472
767,11,9,20,38.35,85.22222222222223,3835,63.916666666666664,9000000000,140.80834419817472
316,4,3,7,45.142857142857146,105.33333333333333,1580,26.333333333333332,3000000000,113.9240506329114
616,7,3,10,61.6,205.33333333333334,3080,51.333333333333336,3000000000,58.441558441558435
584,7,5,12,48.666666666666664,116.8,2920,48.666666666666664,5000000000,102.73972602739725
465,8,6,14,33.214285714285715,77.5,2325,38.75,6000000000,154.83870967741936
1840,24,6,30,61.333333333333336,306.6666666666667,9200,153.33333333333334,6000000000,39.130434782608695
796,8,6,14,56.857142857142854,132.66666666666666,3980,66.33333333333333,6000000000,90.45226130653266
320,4,3,7,45.714285714285715,106.66666666666667,1600,26.666666666666668,3000000000,112.5
996,14,3,17,58.588235294117645,332,4980,83,3000000000,36.144578313253014
574,13,3,16,35.875,191.33333333333334,2870,47.833333333333336,3000000000,62.7177700348432
706,13,3,16,44.125,235.33333333333334,3530,58.833333333333336,3000000000,50.991501416430594
278,3,3,6,46.333333333333336,92.66666666666667,1390,23.166666666666668,3000000000,129.49640287769785
1026,15,7,22,46.63636363636363,146.57142857142858,5130,85.5,7000000000,81.87134502923976
940,13,3,16,58.75,313.3333333333333,4700,78.33333333333333,3000000000,38.297872340425535
629,6,7,13,48.38461538461539,89.85714285714286,3145,52.416666666666664,7000000000,133.54531001589825
563,8,3,11,51.18181818181818,187.66666666666666,2815,46.916666666666664,3000000000,63.94316163410302
954,9,11,20,47.7,86.72727272727273,4770,79.5,11000000000,138.36477987421384
531,10,3,13,40.84615384615385,177,2655,44.25,3000000000,67.79661016949153
329,5,3,8,41.125,109.66666666666667,1645,27.416666666666668,3000000000,109.4224924012158
1079,23,3,26,41.5,359.6666666666667,5395,89.91666666666667,3000000000,33.364226135310474
1029,15,7,22,46.77272727272727,147,5145,85.75,7000000000,81.63265306122449
346,4,4,8,43.25,86.5,1730,28.833333333333332,4000000000,138.72832369942196
774,9,6,15,51.6,129,3870,64.5,6000000000,93.02325581395348
273,7,4,11,24.818181818181817,68.25,1365,22.75,4000000000,175.82417582417582
727,10,8,18,40.388888888888886,90.875,3635,60.583333333333336,8000000000,132.04951856946354
734,9,4,13,56.46153846153846,183.5,3670,61.166666666666664,4000000000,65.39509536784742
698,11,3,14,49.857142857142854,232.66666666666666,3490,58.166666666666664,3000000000,51.5759312320917
547,5,7,12,45.583333333333336,78.14285714285714,2735,45.583333333333336,7000000000,153.5648994515539
595,8,8,16,37.1875,74.375,2975,49.583333333333336,8000000000,161.34453781512605
761,10,3,13,58.53846153846154,253.66666666666666,3805,63.416666666666664,3000000000,47.306176084099874
500,8,3,11,45.45454545454545,166.66666666666666,2500,41.666666666666664,3000000000,72
352,7,3,10,35.2,117.33333333333333,1760,29.333333333333332,3000000000,102.27272727272728
605,11,3,14,43.214285714285715,201.66666666666666,3025,50.416666666666664,3000000000,59.50413223140496
551,8,5,13,42.38461538461539,110.2,2755,45.916666666666664,5000000000,108.89292196007261
857,15,6,21,40.80952380952381,142.83333333333334,4285,71.41666666666667,6000000000,84.01400233372227
510,8,3,11,46.36363636363637,170,2550,42.5,3000000000,70.58823529411764
612,6,6,12,51,102,3060,51,6000000000,117.6470588235294
612,10,4,14,43.714285714285715,153,3060,51,4000000000,78.4313725490196
641,19,3,22,29.136363636363637,213.66666666666666,3205,53.416666666666664,3000000000,56.1622464898596
347,8,3,11,31.545454545454547,115.66666666666667,1735,28.916666666666668,3000000000,103.7463976945245
417,7,3,10,41.7,139,2085,34.75,3000000000,86.33093525179855
177,3,3,6,29.5,59,885,14.75,3000000000,203.38983050847457
402,7,3,10,40.2,134,2010,33.5,3000000000,89.55223880597015
604,6,3,9,67.11111111111111,201.33333333333334,3020,50.333333333333336,3000000000,59.602649006622514
390,9,3,12,32.5,130,1950,32.5,3000000000,92.3076923076923
332,7,3,10,33.2,110.66666666666667,1660,27.666666666666668,3000000000,108.43373493975903
415,5,4,9,46.111111111111114,103.75,2075,34.583333333333336,4000000000,115.66265060240963
282,5,3,8,35.25,94,1410,23.5,3000000000,127.65957446808511
616,10,3,13,47.38461538461539,205.33333333333334,3080,51.333333333333336,3000000000,58.441558441558435
183,5,3,8,22.875,61,915,15.25,3000000000,196.72131147540983
622,14,3,17,36.588235294117645,207.33333333333334,3110,51.833333333333336,3000000000,57.877813504823145
1059,9,9,18,58.833333333333336,117.66666666666667,5295,88.25,9000000000,101.98300283286119
289,4,3,7,41.285714285714285,96.33333333333333,1445,24.083333333333332,3000000000,124.56747404844292
555,9,3,12,46.25,185,2775,46.25,3000000000,64.86486486486487
364,3,3,6,60.666666666666664,121.33333333333333,1820,30.333333333333332,3000000000,98.9010989010989
652,12,3,15,43.46666666666667,217.33333333333334,3260,54.333333333333336,3000000000,55.214723926380366
694,11,3,14,49.57142857142857,231.33333333333334,3470,57.833333333333336,3000000000,51.87319884726225
1216,22,3,25,48.64,405.3333333333333,6080,101.33333333333333,3000000000,29.605263157894736
904,15,8,23,39.30434782608695,113,4520,75.33333333333333,8000000000,106.19469026548673
982,12,3,15,65.46666666666667,327.3333333333333,4910,81.83333333333333,3000000000,36.65987780040734
609,8,6,14,43.5,101.5,3045,50.75,6000000000,118.22660098522167
1026,20,3,23,44.608695652173914,342,5130,85.5,3000000000,35.08771929824562
528,7,3,10,52.8,176,2640,44,3000000000,68.18181818181819
685,8,4,12,57.083333333333336,171.25,3425,57.083333333333336,4000000000,70.07299270072993
404,4,6,10,40.4,67.33333333333333,2020,33.666666666666664,6000000000,178.21782178217822
340,6,4,10,34,85,1700,28.333333333333332,4000000000,141.17647058823528
642,10,4,14,45.857142857142854,160.5,3210,53.5,4000000000,74.76635514018692
696,7,5,12,58,139.2,3480,58,5000000000,86.20689655172414
562,9,4,13,43.23076923076923,140.5,2810,46.833333333333336,4000000000,85.40925266903915
343,3,4,7,49,85.75,1715,28.583333333333332,4000000000,139.94169096209913
597,14,5,19,31.42105263157895,119.4,2985,49.75,5000000000,100.50251256281408
626,10,7,17,36.8235294117647,89.42857142857143,3130,52.166666666666664,7000000000,134.185303514377
320,7,3,10,32,106.66666666666667,1600,26.666666666666668,3000000000,112.5
433,5,5,10,43.3,86.6,2165,36.083333333333336,5000000000,138.568129330254
705,11,6,17,41.470588235294116,117.5,3525,58.75,6000000000,102.1276595744681
746,20,3,23,32.43478260869565,248.66666666666666,3730,62.166666666666664,3000000000,48.2573726541555
1130,18,8,26,43.46153846153846,141.25,5650,94.16666666666667,8000000000,84.95575221238938
560,4,5,9,62.22222222222222,112,2800,46.666666666666664,5000000000,107.14285714285715
815,10,3,13,62.69230769230769,271.6666666666667,4075,67.91666666666667,3000000000,44.17177914110429
866,11,3,14,61.857142857142854,288.6666666666667,4330,72.16666666666667,3000000000,41.57043879907621
399,9,3,12,33.25,133,1995,33.25,3000000000,90.22556390977444
645,10,3,13,49.61538461538461,215,3225,53.75,3000000000,55.81395348837209
1054,23,3,26,40.53846153846154,351.3333333333333,5270,87.83333333333333,3000000000,34.15559772296015
329,4,4,8,41.125,82.25,1645,27.416666666666668,4000000000,145.8966565349544
741,14,3,17,43.588235294117645,247,3705,61.75,3000000000,48.582995951417004
762,10,3,13,58.61538461538461,254,3810,63.5,3000000000,47.24409448818898
884,11,5,16,55.25,176.8,4420,73.66666666666667,5000000000,67.8733031674208
266,4,3,7,38,88.66666666666667,1330,22.166666666666668,3000000000,135.33834586466165
299,6,3,9,33.22222222222222,99.66666666666667,1495,24.916666666666668,3000000000,120.40133779264214
547,10,7,17,32.1764705882353,78.14285714285714,2735,45.583333333333336,7000000000,153.5648994515539
266,8,3,11,24.181818181818183,88.66666666666667,1330,22.166666666666668,3000000000,135.33834586466165
635,7,3,10,63.5,211.66666666666666,3175,52.916666666666664,3000000000,56.69291338582677
374,5,3,8,46.75,124.66666666666667,1870,31.166666666666668,3000000000,96.2566844919786
1112,8,12,20,55.6,92.66666666666667,5560,92.66666666666667,12000000000,129.49640287769785
817,12,3,15,54.46666666666667,272.3333333333333,4085,68.08333333333333,3000000000,44.06364749082008
787,14,7,21,37.476190476190474,112.42857142857143,3935,65.58333333333333,7000000000,106.73443456162643
1203,22,9,31,38.806451612903224,133.66666666666666,6015,100.25,9000000000,89.77556109725685
576,7,3,10,57.6,192,2880,48,3000000000,62.5
235,8,3,11,21.363636363636363,78.33333333333333,1175,19.583333333333332,3000000000,153.19148936170214
660,10,3,13,50.76923076923077,220,3300,55,3000000000,54.54545454545455
718,14,6,20,35.9,119.66666666666667,3590,59.833333333333336,6000000000,100.27855153203343
1248,22,8,30,41.6,156,6240,104,8000000000,76.92307692307693
510,5,4,9,56.666666666666664,127.5,2550,42.5,4000000000,94.11764705882352
512,9,6,15,34.13333333333333,85.33333333333333,2560,42.666666666666664,6000000000,140.625
782,11,6,17,46,130.33333333333334,3910,65.16666666666667,6000000000,92.07161125319692
469,10,3,13,36.07692307692308,156.33333333333334,2345,39.083333333333336,3000000000,76.75906183368869
1091,13,3,16,68.1875,363.6666666666667,5455,90.91666666666667,3000000000,32.99725022914757
493,4,9,13,37.92307692307692,54.77777777777778,2465,41.083333333333336,9000000000,219.06693711967546
585,9,6,15,39,97.5,2925,48.75,6000000000,123.07692307692307
644,12,3,15,42.93333333333333,214.66666666666666,3220,53.666666666666664,3000000000,55.90062111801243
1002,12,3,15,66.8,334,5010,83.5,3000000000,35.928143712574844
794,6,3,9,88.22222222222223,264.6666666666667,3970,66.16666666666667,3000000000,45.34005037783375
521,10,5,15,34.733333333333334,104.2,2605,43.416666666666664,5000000000,115.16314779270634
1145,18,3,21,54.523809523809526,381.6666666666667,5725,95.41666666666667,3000000000,31.441048034934493
387,4,6,10,38.7,64.5,1935,32.25,6000000000,186.04651162790697
473,11,3,14,33.785714285714285,157.66666666666666,2365,39.416666666666664,3000000000,76.10993657505286
179,6,3,9,19.88888888888889,59.666666666666664,895,14.916666666666666,3000000000,201.1173184357542
611,7,5,12,50.916666666666664,122.2,3055,50.916666666666664,5000000000,98.19967266775778
1063,22,8,30,35.43333333333333,132.875,5315,88.58333333333333,8000000000,90.31044214487301
934,11,13,24,38.916666666666664,71.84615384615384,4670,77.83333333333333,13000000000,167.0235546038544
485,10,3,13,37.30769230769231,161.66666666666666,2425,40.416666666666664,3000000000,74.22680412371135
191,5,3,8,23.875,63.666666666666664,955,15.916666666666666,3000000000,188.48167539267016
970,18,3,21,46.19047619047619,323.3333333333333,4850,80.83333333333333,3000000000,37.11340206185567
441,4,3,7,63,147,2205,36.75,3000000000,81.63265306122449
481,5,3,8,60.125,160.33333333333334,2405,40.083333333333336,3000000000,74.84407484407484
1060,16,7,23,46.08695652173913,151.42857142857142,5300,88.33333333333333,7000000000,79.24528301886792
538,9,3,12,44.833333333333336,179.33333333333334,2690,44.833333333333336,3000000000,66.91449814126393
749,14,3,17,44.05882352941177,249.66666666666666,3745,62.416666666666664,3000000000,48.06408544726302
398,6,3,9,44.22222222222222,132.66666666666666,1990,33.166666666666664,3000000000,90.45226130653266
217,7,3,10,21.7,72.33333333333333,1085,18.083333333333332,3000000000,165.89861751152074
358,8,7,15,23.866666666666667,51.142857142857146,1790,29.833333333333332,7000000000,234.6368715083799
470,9,3,12,39.166666666666664,156.66666666666666,2350,39.166666666666664,3000000000,76.59574468085107
581,10,3,13,44.69230769230769,193.66666666666666,2905,48.416666666666664,3000000000,61.96213425129088
740,7,3,10,74,246.66666666666666,3700,61.666666666666664,3000000000,48.64864864864865
289,7,3,10,28.9,96.33333333333333,1445,24.083333333333332,3000000000,124.56747404844292
285,3,3,6,47.5,95,1425,23.75,3000000000,126.3157894736842
473,10,3,13,36.38461538461539,157.66666666666666,2365,39.416666666666664,3000000000,76.10993657505286
1065,21,3,24,44.375,355,5325,88.75,3000000000,33.80281690140845
554,16,3,19,29.157894736842106,184.66666666666666,2770,46.166666666666664,3000000000,64.98194945848375
1157,18,5,23,50.30434782608695,231.4,5785,96.41666666666667,5000000000,51.85825410544512
654,7,3,10,65.4,218,3270,54.5,3000000000,55.04587155963302
405,6,4,10,40.5,101.25,2025,33.75,4000000000,118.51851851851852
963,8,6,14,68.78571428571429,160.5,4815,80.25,6000000000,74.76635514018692
786,8,3,11,71.45454545454545,262,3930,65.5,3000000000,45.80152671755725
153,4,3,7,21.857142857142858,51,765,12.75,3000000000,235.2941176470588
548,11,3,14,39.142857142857146,182.66666666666666,2740,45.666666666666664,3000000000,65.69343065693431
711,14,3,17,41.8235294117647,237,3555,59.25,3000000000,50.63291139240506
785,15,3,18,43.611111111111114,261.6666666666667,3925,65.41666666666667,3000000000,45.859872611464965
788,9,4,13,60.61538461538461,197,3940,65.66666666666667,4000000000,60.91370558375634
972,15,3,18,54,324,4860,81,3000000000,37.03703703703704
796,10,9,19,41.89473684210526,88.44444444444444,3980,66.33333333333333,9000000000,135.678391959799
783,16,3,19,41.21052631578947,261,3915,65.25,3000000000,45.97701149425288
249,9,3,12,20.75,83,1245,20.75,3000000000,144.57831325301206
782,12,8,20,39.1,97.75,3910,65.16666666666667,8000000000,122.76214833759589
786,17,8,25,31.44,98.25,3930,65.5,8000000000,122.13740458015268
622,8,4,12,51.833333333333336,155.5,3110,51.833333333333336,4000000000,77.17041800643086
1171,21,3,24,48.791666666666664,390.3333333333333,5855,97.58333333333333,3000000000,30.742954739538856
417,6,3,9,46.333333333333336,139,2085,34.75,3000000000,86.33093525179855
653,12,6,18,36.27777777777778,108.83333333333333,3265,54.416666666666664,6000000000,110.260336906585
673,12,7,19,35.421052631578945,96.14285714285714,3365,56.083333333333336,7000000000,124.81426448736998
389,8,3,11,35.36363636363637,129.66666666666666,1945,32.416666666666664,3000000000,92.54498714652956
780,14,3,17,45.88235294117647,260,3900,65,3000000000,46.15384615384615
730,10,4,14,52.142857142857146,182.5,3650,60.833333333333336,4000000000,65.75342465753424
345,5,3,8,43.125,115,1725,28.75,3000000000,104.34782608695652
443,6,3,9,49.22222222222222,147.66666666666666,2215,36.916666666666664,3000000000,81.26410835214448
410,6,5,11,37.27272727272727,82,2050,34.166666666666664,5000000000,146.34146341463418
285,4,3,7,40.714285714285715,95,1425,23.75,3000000000,126.3157894736842
416,7,3,10,41.6,138.66666666666666,2080,34.666666666666664,3000000000,86.53846153846155
500,7,4,11,45.45454545454545,125,2500,41.666666666666664,4000000000,96
422,6,6,12,35.166666666666664,70.33333333333333,2110,35.166666666666664,6000000000,170.61611374407585
401,9,3,12,33.416666666666664,133.66666666666666,2005,33.416666666666664,3000000000,89.77556109725687
689,12,3,15,45.93333333333333,229.66666666666666,3445,57.416666666666664,3000000000,52.249637155297535
704,4,5,9,78.22222222222223,140.8,3520,58.666666666666664,5000000000,85.22727272727273
957,8,9,17,56.294117647058826,106.33333333333333,4785,79.75,9000000000,112.85266457680251
482,5,3,8,60.25,160.66666666666666,2410,40.166666666666664,3000000000,74.68879668049793
345,4,3,7,49.285714285714285,115,1725,28.75,3000000000,104.34782608695652
419,10,3,13,32.23076923076923,139.66666666666666,2095,34.916666666666664,3000000000,85.91885441527447
505,7,4,11,45.90909090909091,126.25,2525,42.083333333333336,4000000000,95.04950495049505
1198,22,3,25,47.92,399.3333333333333,5990,99.83333333333333,3000000000,30.050083472454094
165,6,3,9,18.333333333333332,55,825,13.75,3000000000,218.1818181818182
1190,16,12,28,42.5,99.16666666666667,5950,99.16666666666667,12000000000,121.00840336134453
713,8,3,11,64.81818181818181,237.66666666666666,3565,59.416666666666664,3000000000,50.490883590462836
830,8,4,12,69.16666666666667,207.5,4150,69.16666666666667,4000000000,57.831325301204814
437,10,4,14,31.214285714285715,109.25,2185,36.416666666666664,4000000000,109.83981693363846
653,4,3,7,93.28571428571429,217.66666666666666,3265,54.416666666666664,3000000000,55.1301684532925
403,5,3,8,50.375,134.33333333333334,2015,33.583333333333336,3000000000,89.33002481389578
531,7,3,10,53.1,177,2655,44.25,3000000000,67.79661016949153
419,6,3,9,46.55555555555556,139.66666666666666,2095,34.916666666666664,3000000000,85.91885441527447
529,6,5,11,48.09090909090909,105.8,2645,44.083333333333336,5000000000,113.42155009451794
499,5,5,10,49.9,99.8,2495,41.583333333333336,5000000000,120.24048096192384
627,11,3,14,44.785714285714285,209,3135,52.25,3000000000,57.41626794258373
688,9,3,12,57.333333333333336,229.33333333333334,3440,57.333333333333336,3000000000,52.325581395348834
301,7,3,10,30.1,100.33333333333333,1505,25.083333333333332,3000000000,119.60132890365449
300,3,4,7,42.857142857142854,75,1500,25,4000000000,160
339,10,3,13,26.076923076923077,113,1695,28.25,3000000000,106.19469026548673
836,10,3,13,64.3076923076923,278.6666666666667,4180,69.66666666666667,3000000000,43.0622009569378
935,16,3,19,49.21052631578947,311.6666666666667,4675,77.91666666666667,3000000000,38.50267379679144
1182,18,12,30,39.4,98.5,5910,98.5,12000000000,121.82741116751268
535,6,3,9,59.44444444444444,178.33333333333334,2675,44.583333333333336,3000000000,67.28971962616822
567,10,3,13,43.61538461538461,189,2835,47.25,3000000000,63.492063492063494
292,11,3,14,20.857142857142858,97.33333333333333,1460,24.333333333333332,3000000000,123.28767123287672
662,9,4,13,50.92307692307692,165.5,3310,55.166666666666664,4000000000,72.50755287009063
650,7,5,12,54.166666666666664,130,3250,54.166666666666664,5000000000,92.30769230769232
662,7,3,10,66.2,220.66666666666666,3310,55.166666666666664,3000000000,54.38066465256797
1149,20,3,23,49.95652173913044,383,5745,95.75,3000000000,31.33159268929504
448,9,3,12,37.333333333333336,149.33333333333334,2240,37.333333333333336,3000000000,80.35714285714285
318,5,3,8,39.75,106,1590,26.5,3000000000,113.20754716981132
627,8,3,11,57,209,3135,52.25,3000000000,57.41626794258373
187,6,3,9,20.77777777777778,62.333333333333336,935,15.583333333333334,3000000000,192.5133689839572
453,11,3,14,32.357142857142854,151,2265,37.75,3000000000,79.47019867549669
434,9,4,13,33.38461538461539,108.5,2170,36.166666666666664,4000000000,110.59907834101384
436,5,3,8,54.5,145.33333333333334,2180,36.333333333333336,3000000000,82.56880733944953
642,12,3,15,42.8,214,3210,53.5,3000000000,56.074766355140184
680,14,3,17,40,226.66666666666666,3400,56.666666666666664,3000000000,52.94117647058824
553,11,4,15,36.86666666666667,138.25,2765,46.083333333333336,4000000000,86.79927667269439
636,4,4,8,79.5,159,3180,53,4000000000,75.47169811320755
522,10,3,13,40.15384615384615,174,2610,43.5,3000000000,68.9655172413793
381,8,3,11,34.63636363636363,127,1905,31.75,3000000000,94.48818897637796
580,13,3,16,36.25,193.33333333333334,2900,48.333333333333336,3000000000,62.068965517241374
856,14,3,17,50.35294117647059,285.3333333333333,4280,71.33333333333333,3000000000,42.056074766355145
495,7,3,10,49.5,165,2475,41.25,3000000000,72.72727272727273
514,10,3,13,39.53846153846154,171.33333333333334,2570,42.833333333333336,3000000000,70.03891050583658
340,5,5,10,34,68,1700,28.333333333333332,5000000000,176.47058823529414
563,14,3,17,33.11764705882353,187.66666666666666,2815,46.916666666666664,3000000000,63.94316163410302
499,7,3,10,49.9,166.33333333333334,2495,41.583333333333336,3000000000,72.14428857715431
367,5,4,9,40.77777777777778,91.75,1835,30.583333333333332,4000000000,130.79019073569484
860,9,7,16,53.75,122.85714285714286,4300,71.66666666666667,7000000000,97.67441860465115
500,6,3,9,55.55555555555556,166.66666666666666,2500,41.666666666666664,3000000000,72
731,5,4,9,81.22222222222223,182.75,3655,60.916666666666664,4000000000,65.66347469220247
458,7,4,11,41.63636363636363,114.5,2290,38.166666666666664,4000000000,104.80349344978167
914,9,6,15,60.93333333333333,152.33333333333334,4570,76.16666666666667,6000000000,78.77461706783369
1305,22,3,25,52.2,435,6525,108.75,3000000000,27.586206896551726
450,5,3,8,56.25,150,2250,37.5,3000000000,80
603,11,3,14,43.07142857142857,201,3015,50.25,3000000000,59.701492537313435
325,12,3,15,21.666666666666668,108.33333333333333,1625,27.083333333333332,3000000000,110.76923076923077
312,5,3,8,39,104,1560,26,3000000000,115.38461538461539
434,8,4,12,36.166666666666664,108.5,2170,36.166666666666664,4000000000,110.59907834101384
323,5,3,8,40.375,107.66666666666667,1615,26.916666666666668,3000000000,111.45510835913312
530,11,3,14,37.857142857142854,176.66666666666666,2650,44.166666666666664,3000000000,67.9245283018868
628,14,7,21,29.904761904761905,89.71428571428571,3140,52.333333333333336,7000000000,133.7579617834395
634,15,3,18,35.22222222222222,211.33333333333334,3170,52.833333333333336,3000000000,56.78233438485804
871,11,6,17,51.23529411764706,145.16666666666666,4355,72.58333333333333,6000000000,82.66360505166476
1176,17,12,29,40.55172413793103,98,5880,98,12000000000,122.44897959183673
388,5,4,9,43.111111111111114,97,1940,32.333333333333336,4000000000,123.71134020618557
585,8,3,11,53.18181818181818,195,2925,48.75,3000000000,61.53846153846153
830,15,7,22,37.72727272727273,118.57142857142857,4150,69.16666666666667,7000000000,101.20481927710843
731,6,6,12,60.916666666666664,121.83333333333333,3655,60.916666666666664,6000000000,98.4952120383037
378,4,3,7,54,126,1890,31.5,3000000000,95.23809523809524
285,6,4,10,28.5,71.25,1425,23.75,4000000000,168.42105263157896
821,7,3,10,82.1,273.6666666666667,4105,68.41666666666667,3000000000,43.848964677222895
828,14,8,22,37.63636363636363,103.5,4140,69,8000000000,115.94202898550725
511,6,3,9,56.77777777777778,170.33333333333334,2555,42.583333333333336,3000000000,70.45009784735812
722,16,3,19,38,240.66666666666666,3610,60.166666666666664,3000000000,49.86149584487535
494,6,4,10,49.4,123.5,2470,41.166666666666664,4000000000,97.16599190283401
872,14,3,17,51.294117647058826,290.6666666666667,4360,72.66666666666667,3000000000,41.28440366972477
1075,19,16,35,30.714285714285715,67.1875,5375,89.58333333333333,16000000000,178.6046511627907
525,8,4,12,43.75,131.25,2625,43.75,4000000000,91.42857142857143
935,18,4,22,42.5,233.75,4675,77.91666666666667,4000000000,51.33689839572192
548,11,3,14,39.142857142857146,182.66666666666666,2740,45.666666666666664,3000000000,65.69343065693431
509,9,5,14,36.357142857142854,101.8,2545,42.416666666666664,5000000000,117.87819253438116
1350,12,9,21,64.28571428571429,150,6750,112.5,9000000000,80
547,10,3,13,42.07692307692308,182.33333333333334,2735,45.583333333333336,3000000000,65.81352833638024
509,7,3,10,50.9,169.66666666666666,2545,42.416666666666664,3000000000,70.7269155206287
629,13,3,16,39.3125,209.66666666666666,3145,52.416666666666664,3000000000,57.233704292527825
512,10,3,13,39.38461538461539,170.66666666666666,2560,42.666666666666664,3000000000,70.3125
585,10,3,13,45,195,2925,48.75,3000000000,61.53846153846153
503,6,3,9,55.888888888888886,167.66666666666666,2515,41.916666666666664,3000000000,71.57057654075547
580,11,4,15,38.666666666666664,145,2900,48.333333333333336,4000000000,82.75862068965517
554,7,3,10,55.4,184.66666666666666,2770,46.166666666666664,3000000000,64.98194945848375
550,13,3,16,34.375,183.33333333333334,2750,45.833333333333336,3000000000,65.45454545454545
436,6,5,11,39.63636363636363,87.2,2180,36.333333333333336,5000000000,137.61467889908258
185,4,3,7,26.428571428571427,61.666666666666664,925,15.416666666666666,3000000000,194.5945945945946
321,5,3,8,40.125,107,1605,26.75,3000000000,112.14953271028037
513,8,4,12,42.75,128.25,2565,42.75,4000000000,93.5672514619883
983,6,6,12,81.91666666666667,163.83333333333334,4915,81.91666666666667,6000000000,73.24516785350967
703,10,5,15,46.86666666666667,140.6,3515,58.583333333333336,5000000000,85.34850640113798
711,9,9,18,39.5,79,3555,59.25,9000000000,151.89873417721518
423,7,4,11,38.45454545454545,105.75,2115,35.25,4000000000,113.47517730496455
427,5,3,8,53.375,142.33333333333334,2135,35.583333333333336,3000000000,84.30913348946135
460,5,3,8,57.5,153.33333333333334,2300,38.333333333333336,3000000000,78.26086956521739
869,13,7,20,43.45,124.14285714285714,4345,72.41666666666667,7000000000,96.66283084004601
478,5,3,8,59.75,159.33333333333334,2390,39.833333333333336,3000000000,75.31380753138075
222,4,3,7,31.714285714285715,74,1110,18.5,3000000000,162.16216216216216
1757,23,3,26,67.57692307692308,585.6666666666666,8785,146.41666666666666,3000000000,20.489470688673876
504,8,3,11,45.81818181818182,168,2520,42,3000000000,71.42857142857143
843,17,3,20,42.15,281,4215,70.25,3000000000,42.704626334519574
588,6,3,9,65.33333333333333,196,2940,49,3000000000,61.224489795918366
187,6,3,9,20.77777777777778,62.333333333333336,935,15.583333333333334,3000000000,192.5133689839572
434,6,4,10,43.4,108.5,2170,36.166666666666664,4000000000,110.59907834101384
385,6,3,9,42.77777777777778,128.33333333333334,1925,32.083333333333336,3000000000,93.5064935064935
292,5,3,8,36.5,97.33333333333333,1460,24.333333333333332,3000000000,123.28767123287672
565,12,3,15,37.666666666666664,188.33333333333334,2825,47.083333333333336,3000000000,63.716814159292035
348,5,6,11,31.636363636363637,58,1740,29,6000000000,206.89655172413794
563,6,3,9,62.55555555555556,187.66666666666666,2815,46.916666666666664,3000000000,63.94316163410302
624,9,3,12,52,208,3120,52,3000000000,57.69230769230769
1389,20,3,23,60.391304347826086,463,6945,115.75,3000000000,25.91792656587473
556,10,4,14,39.714285714285715,139,2780,46.333333333333336,4000000000,86.33093525179855
838,8,3,11,76.18181818181819,279.3333333333333,4190,69.83333333333333,3000000000,42.95942720763723
804,14,5,19,42.31578947368421,160.8,4020,67,5000000000,74.6268656716418
642,11,3,14,45.857142857142854,214,3210,53.5,3000000000,56.074766355140184
1051,12,3,15,70.06666666666666,350.3333333333333,5255,87.58333333333333,3000000000,34.25309229305424
456,4,3,7,65.14285714285714,152,2280,38,3000000000,78.94736842105263
364,6,3,9,40.44444444444444,121.33333333333333,1820,30.333333333333332,3000000000,98.9010989010989
654,12,5,17,38.470588235294116,130.8,3270,54.5,5000000000,91.74311926605505
740,10,3,13,56.92307692307692,246.66666666666666,3700,61.666666666666664,3000000000,48.64864864864865
484,9,4,13,37.23076923076923,121,2420,40.333333333333336,4000000000,99.17355371900825
365,6,4,10,36.5,91.25,1825,30.416666666666668,4000000000,131.50684931506848
636,8,3,11,57.81818181818182,212,3180,53,3000000000,56.60377358490566
427,10,3,13,32.84615384615385,142.33333333333334,2135,35.583333333333336,3000000000,84.30913348946135
113,3,3,6,18.833333333333332,37.666666666666664,565,9.416666666666666,3000000000,318.5840707964602
1128,8,3,11,102.54545454545455,376,5640,94,3000000000,31.914893617021278
388,5,3,8,48.5,129.33333333333334,1940,32.333333333333336,3000000000,92.78350515463917
466,7,5,12,38.833333333333336,93.2,2330,38.833333333333336,5000000000,128.75536480686694
384,6,4,10,38.4,96,1920,32,4000000000,125
427,8,3,11,38.81818181818182,142.33333333333334,2135,35.583333333333336,3000000000,84.30913348946135
667,10,4,14,47.642857142857146,166.75,3335,55.583333333333336,4000000000,71.9640179910045
958,7,3,10,95.8,319.3333333333333,4790,79.83333333333333,3000000000,37.57828810020877
563,5,4,9,62.55555555555556,140.75,2815,46.916666666666664,4000000000,85.2575488454707
1148,18,10,28,41,114.8,5740,95.66666666666667,10000000000,104.52961672473867
521,11,3,14,37.214285714285715,173.66666666666666,2605,43.416666666666664,3000000000,69.0978886756238
872,20,9,29,30.06896551724138,96.88888888888889,4360,72.66666666666667,9000000000,123.8532110091743
1107,13,11,24,46.125,100.63636363636364,5535,92.25,11000000000,119.24119241192412
895,13,3,16,55.9375,298.3333333333333,4475,74.58333333333333,3000000000,40.22346368715084
910,11,6,17,53.529411764705884,151.66666666666666,4550,75.83333333333333,6000000000,79.12087912087912
401,9,3,12,33.416666666666664,133.66666666666666,2005,33.416666666666664,3000000000,89.77556109725687
1360,14,8,22,61.81818181818182,170,6800,113.33333333333333,8000000000,70.58823529411764
761,16,4,20,38.05,190.25,3805,63.416666666666664,4000000000,63.074901445466494
864,18,11,29,29.79310344827586,78.54545454545455,4320,72,11000000000,152.7777777777778
768,13,3,16,48,256,3840,64,3000000000,46.875
510,6,4,10,51,127.5,2550,42.5,4000000000,94.11764705882352
721,8,5,13,55.46153846153846,144.2,3605,60.083333333333336,5000000000,83.21775312066575
1224,15,11,26,47.07692307692308,111.27272727272727,6120,102,11000000000,107.84313725490196
508,4,3,7,72.57142857142857,169.33333333333334,2540,42.333333333333336,3000000000,70.86614173228345
190,4,3,7,27.142857142857142,63.333333333333336,950,15.833333333333334,3000000000,189.47368421052633
727,11,3,14,51.92857142857143,242.33333333333334,3635,60.583333333333336,3000000000,49.51856946354883
624,10,4,14,44.57142857142857,156,3120,52,4000000000,76.92307692307693
321,5,5,10,32.1,64.2,1605,26.75,5000000000,186.9158878504673
720,10,4,14,51.42857142857143,180,3600,60,4000000000,66.66666666666666
576,5,4,9,64,144,2880,48,4000000000,83.33333333333333
1172,20,11,31,37.806451612903224,106.54545454545455,5860,97.66666666666667,11000000000,112.62798634812286
567,5,3,8,70.875,189,2835,47.25,3000000000,63.492063492063494
653,12,7,19,34.36842105263158,93.28571428571429,3265,54.416666666666664,7000000000,128.63705972434914
520,8,5,13,40,104,2600,43.333333333333336,5000000000,115.38461538461537
941,17,8,25,37.64,117.625,4705,78.41666666666667,8000000000,102.01912858661
608,12,3,15,40.53333333333333,202.66666666666666,3040,50.666666666666664,3000000000,59.21052631578947
361,4,3,7,51.57142857142857,120.33333333333333,1805,30.083333333333332,3000000000,99.7229916897507
825,16,3,19,43.421052631578945,275,4125,68.75,3000000000,43.63636363636363
787,13,5,18,43.72222222222222,157.4,3935,65.58333333333333,5000000000,76.23888182973316
441,3,7,10,44.1,63,2205,36.75,7000000000,190.47619047619048
466,10,7,17,27.41176470588235,66.57142857142857,2330,38.833333333333336,7000000000,180.25751072961373
1044,13,6,19,54.94736842105263,174,5220,87,6000000000,68.9655172413793
484,8,3,11,44,161.33333333333334,2420,40.333333333333336,3000000000,74.3801652892562
197,3,3,6,32.833333333333336,65.66666666666667,985,16.416666666666668,3000000000,182.741116751269
624,12,5,17,36.705882352941174,124.8,3120,52,5000000000,96.15384615384616
896,14,3,17,52.705882352941174,298.6666666666667,4480,74.66666666666667,3000000000,40.17857142857142
668,9,3,12,55.666666666666664,222.66666666666666,3340,55.666666666666664,3000000000,53.89221556886228
1058,8,6,14,75.57142857142857,176.33333333333334,5290,88.16666666666667,6000000000,68.05293005671076
891,19,3,22,40.5,297,4455,74.25,3000000000,40.4040404040404
529,6,3,9,58.77777777777778,176.33333333333334,2645,44.083333333333336,3000000000,68.05293005671076
834,14,3,17,49.05882352941177,278,4170,69.5,3000000000,43.165467625899275
733,6,7,13,56.38461538461539,104.71428571428571,3665,61.083333333333336,7000000000,114.59754433833561
564,14,3,17,33.1764705882353,188,2820,47,3000000000,63.829787234042556
482,6,5,11,43.81818181818182,96.4,2410,40.166666666666664,5000000000,124.48132780082989
318,6,3,9,35.333333333333336,106,1590,26.5,3000000000,113.20754716981132
504,11,3,14,36,168,2520,42,3000000000,71.42857142857143
1130,17,8,25,45.2,141.25,5650,94.16666666666667,8000000000,84.95575221238938
372,10,3,13,28.615384615384617,124,1860,31,3000000000,96.77419354838709
321,7,3,10,32.1,107,1605,26.75,3000000000,112.14953271028037
601,5,4,9,66.77777777777777,150.25,3005,50.083333333333336,4000000000,79.86688851913478
557,11,5,16,34.8125,111.4,2785,46.416666666666664,5000000000,107.71992818671454
975,19,4,23,42.391304347826086,243.75,4875,81.25,4000000000,49.23076923076923
558,6,3,9,62,186,2790,46.5,3000000000,64.51612903225806
745,12,3,15,49.666666666666664,248.33333333333334,3725,62.083333333333336,3000000000,48.32214765100671
582,6,4,10,58.2,145.5,2910,48.5,4000000000,82.47422680412372
243,8,3,11,22.09090909090909,81,1215,20.25,3000000000,148.14814814814815
836,9,8,17,49.1764705882353,104.5,4180,69.66666666666667,8000000000,114.83253588516745
316,5,6,11,28.727272727272727,52.666666666666664,1580,26.333333333333332,6000000000,227.8481012658228
203,4,4,8,25.375,50.75,1015,16.916666666666668,4000000000,236.45320197044333
809,20,9,29,27.896551724137932,89.88888888888889,4045,67.41666666666667,9000000000,133.49814585908527
709,13,3,16,44.3125,236.33333333333334,3545,59.083333333333336,3000000000,50.77574047954865
599,11,3,14,42.785714285714285,199.66666666666666,2995,49.916666666666664,3000000000,60.10016694490819
736,17,9,26,28.307692307692307,81.77777777777777,3680,61.333333333333336,9000000000,146.7391304347826
522,8,3,11,47.45454545454545,174,2610,43.5,3000000000,68.9655172413793
368,4,8,12,30.666666666666668,46,1840,30.666666666666668,8000000000,260.86956521739125
954,12,6,18,53,159,4770,79.5,6000000000,75.47169811320755
1208,12,9,21,57.523809523809526,134.22222222222223,6040,100.66666666666667,9000000000,89.40397350993376
671,13,3,16,41.9375,223.66666666666666,3355,55.916666666666664,3000000000,53.65126676602087
449,6,3,9,49.888888888888886,149.66666666666666,2245,37.416666666666664,3000000000,80.1781737193764
375,4,3,7,53.57142857142857,125,1875,31.25,3000000000,96
621,11,7,18,34.5,88.71428571428571,3105,51.75,7000000000,135.2657004830918
687,10,3,13,52.84615384615385,229,3435,57.25,3000000000,52.40174672489083
526,10,3,13,40.46153846153846,175.33333333333334,2630,43.833333333333336,3000000000,68.44106463878326
588,4,7,11,53.45454545454545,84,2940,49,7000000000,142.85714285714286
274,5,3,8,34.25,91.33333333333333,1370,22.833333333333332,3000000000,131.38686131386862
599,14,3,17,35.23529411764706,199.66666666666666,2995,49.916666666666664,3000000000,60.10016694490819
428,7,3,10,42.8,142.66666666666666,2140,35.666666666666664,3000000000,84.11214953271029
899,11,3,14,64.21428571428571,299.6666666666667,4495,74.91666666666667,3000000000,40.04449388209121
168,5,3,8,21,56,840,14,3000000000,214.2857142857143
303,4,4,8,37.875,75.75,1515,25.25,4000000000,158.41584158415841
649,10,3,13,49.92307692307692,216.33333333333334,3245,54.083333333333336,3000000000,55.46995377503852
432,8,3,11,39.27272727272727,144,2160,36,3000000000,83.33333333333333
371,5,6,11,33.72727272727273,61.833333333333336,1855,30.916666666666668,6000000000,194.0700808625337
357,5,3,8,44.625,119,1785,29.75,3000000000,100.84033613445379
749,15,7,22,34.04545454545455,107,3745,62.416666666666664,7000000000,112.14953271028037
644,13,3,16,40.25,214.66666666666666,3220,53.666666666666664,3000000000,55.90062111801243
584,8,3,11,53.09090909090909,194.66666666666666,2920,48.666666666666664,3000000000,61.64383561643836
888,12,4,16,55.5,222,4440,74,4000000000,54.05405405405405
447,11,3,14,31.928571428571427,149,2235,37.25,3000000000,80.53691275167786
721,11,6,17,42.411764705882355,120.16666666666667,3605,60.083333333333336,6000000000,99.86130374479889
447,6,4,10,44.7,111.75,2235,37.25,4000000000,107.38255033557047
1156,20,3,23,50.26086956521739,385.3333333333333,5780,96.33333333333333,3000000000,31.14186851211073
985,14,6,20,49.25,164.16666666666666,4925,82.08333333333333,6000000000,73.09644670050761
752,9,6,15,50.13333333333333,125.33333333333333,3760,62.666666666666664,6000000000,95.74468085106383
499,11,3,14,35.642857142857146,166.33333333333334,2495,41.583333333333336,3000000000,72.14428857715431
239,4,3,7,34.142857142857146,79.66666666666667,1195,19.916666666666668,3000000000,150.6276150627615
786,12,6,18,43.666666666666664,131,3930,65.5,6000000000,91.6030534351145
280,3,3,6,46.666666666666664,93.33333333333333,1400,23.333333333333332,3000000000,128.57142857142858
217,6,3,9,24.11111111111111,72.33333333333333,1085,18.083333333333332,3000000000,165.89861751152074
402,5,3,8,50.25,134,2010,33.5,3000000000,89.55223880597015
231,3,4,7,33,57.75,1155,19.25,4000000000,207.7922077922078
291,9,3,12,24.25,97,1455,24.25,3000000000,123.71134020618557
480,8,3,11,43.63636363636363,160,2400,40,3000000000,75
635,12,3,15,42.333333333333336,211.66666666666666,3175,52.916666666666664,3000000000,56.69291338582677
246,5,3,8,30.75,82,1230,20.5,3000000000,146.34146341463415
790,6,8,14,56.42857142857143,98.75,3950,65.83333333333333,8000000000,121.51898734177216
826,10,4,14,59,206.5,4130,68.83333333333333,4000000000,58.11138014527845
337,4,4,8,42.125,84.25,1685,28.083333333333332,4000000000,142.433234421365
858,14,3,17,50.470588235294116,286,4290,71.5,3000000000,41.95804195804196
200,6,4,10,20,50,1000,16.666666666666668,4000000000,239.99999999999997
645,12,4,16,40.3125,161.25,3225,53.75,4000000000,74.4186046511628
1186,20,3,23,51.56521739130435,395.3333333333333,5930,98.83333333333333,3000000000,30.354131534569987
227,4,3,7,32.42857142857143,75.66666666666667,1135,18.916666666666668,3000000000,158.59030837004406
407,10,3,13,31.307692307692307,135.66666666666666,2035,33.916666666666664,3000000000,88.45208845208846
583,6,4,10,58.3,145.75,2915,48.583333333333336,4000000000,82.3327615780446
549,9,3,12,45.75,183,2745,45.75,3000000000,65.57377049180329
872,16,3,19,45.89473684210526,290.6666666666667,4360,72.66666666666667,3000000000,41.28440366972477
187,4,4,8,23.375,46.75,935,15.583333333333334,4000000000,256.68449197860963
735,7,3,10,73.5,245,3675,61.25,3000000000,48.9795918367347
694,15,3,18,38.55555555555556,231.33333333333334,3470,57.833333333333336,3000000000,51.87319884726225
651,15,3,18,36.166666666666664,217,3255,54.25,3000000000,55.29953917050691
673,13,3,16,42.0625,224.33333333333334,3365,56.083333333333336,3000000000,53.49182763744428
599,8,3,11,54.45454545454545,199.66666666666666,2995,49.916666666666664,3000000000,60.10016694490819
709,12,5,17,41.705882352941174,141.8,3545,59.083333333333336,5000000000,84.6262341325811
1348,17,11,28,48.142857142857146,122.54545454545455,6740,112.33333333333333,11000000000,97.92284866468844
569,8,3,11,51.72727272727273,189.66666666666666,2845,47.416666666666664,3000000000,63.26889279437611
956,12,11,23,41.56521739130435,86.9090909090909,4780,79.66666666666667,11000000000,138.0753138075314
1491,15,6,21,71,248.5,7455,124.25,6000000000,48.2897384305835
236,3,3,6,39.333333333333336,78.66666666666667,1180,19.666666666666668,3000000000,152.5423728813559
962,15,3,18,53.44444444444444,320.6666666666667,4810,80.16666666666667,3000000000,37.42203742203742
629,13,3,16,39.3125,209.66666666666666,3145,52.416666666666664,3000000000,57.233704292527825
557,7,7,14,39.785714285714285,79.57142857142857,2785,46.416666666666664,7000000000,150.80789946140035
699,8,6,14,49.92857142857143,116.5,3495,58.25,6000000000,103.00429184549355
524,15,3,18,29.11111111111111,174.66666666666666,2620,43.666666666666664,3000000000,68.70229007633587
225,3,3,6,37.5,75,1125,18.75,3000000000,160
551,13,4,17,32.411764705882355,137.75,2755,45.916666666666664,4000000000,87.11433756805808
310,3,3,6,51.666666666666664,103.33333333333333,1550,25.833333333333332,3000000000,116.12903225806453
1238,15,3,18,68.77777777777777,412.6666666666667,6190,103.16666666666667,3000000000,29.079159935379643
849,13,9,22,38.59090909090909,94.33333333333333,4245,70.75,9000000000,127.20848056537102
464,7,4,11,42.18181818181818,116,2320,38.666666666666664,4000000000,103.44827586206897
539,10,3,13,41.46153846153846,179.66666666666666,2695,44.916666666666664,3000000000,66.79035250463822
496,8,3,11,45.09090909090909,165.33333333333334,2480,41.333333333333336,3000000000,72.58064516129032
698,12,3,15,46.53333333333333,232.66666666666666,3490,58.166666666666664,3000000000,51.5759312320917
970,12,12,24,40.416666666666664,80.83333333333333,4850,80.83333333333333,12000000000,148.4536082474227
374,3,4,7,53.42857142857143,93.5,1870,31.166666666666668,4000000000,128.34224598930481
774,10,5,15,51.6,154.8,3870,64.5,5000000000,77.51937984496124
506,5,4,9,56.22222222222222,126.5,2530,42.166666666666664,4000000000,94.86166007905139
493,10,3,13,37.92307692307692,164.33333333333334,2465,41.083333333333336,3000000000,73.02231237322515
781,12,4,16,48.8125,195.25,3905,65.08333333333333,4000000000,61.45966709346992
420,13,3,16,26.25,140,2100,35,3000000000,85.71428571428572
640,7,6,13,49.23076923076923,106.66666666666667,3200,53.333333333333336,6000000000,112.5
707,13,5,18,39.27777777777778,141.4,3535,58.916666666666664,5000000000,84.86562942008486
312,11,3,14,22.285714285714285,104,1560,26,3000000000,115.38461538461539
752,12,4,16,47,188,3760,62.666666666666664,4000000000,63.829787234042556
447,8,3,11,40.63636363636363,149,2235,37.25,3000000000,80.53691275167786
605,7,5,12,50.416666666666664,121,3025,50.416666666666664,5000000000,99.17355371900827
810,10,6,16,50.625,135,4050,67.5,6000000000,88.8888888888889
580,7,3,10,58,193.33333333333334,2900,48.333333333333336,3000000000,62.068965517241374
1175,15,3,18,65.27777777777777,391.6666666666667,5875,97.91666666666667,3000000000,30.638297872340427
426,12,3,15,28.4,142,2130,35.5,3000000000,84.50704225352113
451,8,5,13,34.69230769230769,90.2,2255,37.583333333333336,5000000000,133.03769401330376
444,10,3,13,34.15384615384615,148,2220,37,3000000000,81.08108108108108
485,10,3,13,37.30769230769231,161.66666666666666,2425,40.416666666666664,3000000000,74.22680412371135
916,4,9,13,70.46153846153847,101.77777777777777,4580,76.33333333333333,9000000000,117.90393013100437
469,13,3,16,29.3125,156.33333333333334,2345,39.083333333333336,3000000000,76.75906183368869
406,8,3,11,36.90909090909091,135.33333333333334,2030,33.833333333333336,3000000000,88.66995073891624
526,3,4,7,75.14285714285714,131.5,2630,43.833333333333336,4000000000,91.25475285171102
352,11,3,14,25.142857142857142,117.33333333333333,1760,29.333333333333332,3000000000,102.27272727272728
815,16,5,21,38.80952380952381,163,4075,67.91666666666667,5000000000,73.61963190184049
560,11,3,14,40,186.66666666666666,2800,46.666666666666664,3000000000,64.28571428571429
506,5,3,8,63.25,168.66666666666666,2530,42.166666666666664,3000000000,71.14624505928855
376,9,3,12,31.333333333333332,125.33333333333333,1880,31.333333333333332,3000000000,95.74468085106383
451,7,7,14,32.214285714285715,64.42857142857143,2255,37.583333333333336,7000000000,186.25277161862525
680,6,3,9,75.55555555555556,226.66666666666666,3400,56.666666666666664,3000000000,52.94117647058824
262,6,4,10,26.2,65.5,1310,21.833333333333332,4000000000,183.206106870229
457,7,3,10,45.7,152.33333333333334,2285,38.083333333333336,3000000000,78.77461706783369
676,13,5,18,37.55555555555556,135.2,3380,56.333333333333336,5000000000,88.75739644970415
339,10,3,13,26.076923076923077,113,1695,28.25,3000000000,106.19469026548673
541,10,5,15,36.06666666666667,108.2,2705,45.083333333333336,5000000000,110.90573012939002
944,18,14,32,29.5,67.42857142857143,4720,78.66666666666667,14000000000,177.96610169491524
650,9,6,15,43.333333333333336,108.33333333333333,3250,54.166666666666664,6000000000,110.76923076923077
529,7,4,11,48.09090909090909,132.25,2645,44.083333333333336,4000000000,90.73724007561437
628,7,3,10,62.8,209.33333333333334,3140,52.333333333333336,3000000000,57.324840764331206
348,5,3,8,43.5,116,1740,29,3000000000,103.44827586206897
578,4,3,7,82.57142857142857,192.66666666666666,2890,48.166666666666664,3000000000,62.28373702422146
519,8,3,11,47.18181818181818,173,2595,43.25,3000000000,69.36416184971098
404,5,3,8,50.5,134.66666666666666,2020,33.666666666666664,3000000000,89.10891089108911
1032,18,3,21,49.142857142857146,344,5160,86,3000000000,34.883720930232556
491,12,3,15,32.733333333333334,163.66666666666666,2455,40.916666666666664,3000000000,73.31975560081467
1353,21,8,29,46.6551724137931,169.125,6765,112.75,8000000000,70.95343680709534
558,12,3,15,37.2,186,2790,46.5,3000000000,64.51612903225806
442,4,4,8,55.25,110.5,2210,36.833333333333336,4000000000,108.5972850678733
391,9,3,12,32.583333333333336,130.33333333333334,1955,32.583333333333336,3000000000,92.07161125319692
397,9,6,15,26.466666666666665,66.16666666666667,1985,33.083333333333336,6000000000,181.360201511335
554,9,3,12,46.166666666666664,184.66666666666666,2770,46.166666666666664,3000000000,64.98194945848375
468,6,3,9,52,156,2340,39,3000000000,76.92307692307693
670,16,3,19,35.26315789473684,223.33333333333334,3350,55.833333333333336,3000000000,53.731343283582085
746,3,3,6,124.33333333333333,248.66666666666666,3730,62.166666666666664,3000000000,48.2573726541555
1140,13,3,16,71.25,380,5700,95,3000000000,31.57894736842105
1049,17,3,20,52.45,349.6666666666667,5245,87.41666666666667,3000000000,34.31839847473785
442,5,4,9,49.111111111111114,110.5,2210,36.833333333333336,4000000000,108.5972850678733
688,11,7,18,38.22222222222222,98.28571428571429,3440,57.333333333333336,7000000000,122.09302325581395
302,4,4,8,37.75,75.5,1510,25.166666666666668,4000000000,158.94039735099338
400,4,4,8,50,100,2000,33.333333333333336,4000000000,119.99999999999999
1033,23,7,30,34.43333333333333,147.57142857142858,5165,86.08333333333333,7000000000,81.31655372700871
926,17,3,20,46.3,308.6666666666667,4630,77.16666666666667,3000000000,38.8768898488121
701,6,4,10,70.1,175.25,3505,58.416666666666664,4000000000,68.47360912981455
383,6,3,9,42.55555555555556,127.66666666666667,1915,31.916666666666668,3000000000,93.99477806788512
475,6,4,10,47.5,118.75,2375,39.583333333333336,4000000000,101.05263157894737
533,10,3,13,41,177.66666666666666,2665,44.416666666666664,3000000000,67.5422138836773
784,14,4,18,43.55555555555556,196,3920,65.33333333333333,4000000000,61.22448979591837
580,8,3,11,52.72727272727273,193.33333333333334,2900,48.333333333333336,3000000000,62.068965517241374
569,6,4,10,56.9,142.25,2845,47.416666666666664,4000000000,84.3585237258348
314,3,3,6,52.333333333333336,104.66666666666667,1570,26.166666666666668,3000000000,114.64968152866241
896,18,3,21,42.666666666666664,298.6666666666667,4480,74.66666666666667,3000000000,40.17857142857142
773,10,10,20,38.65,77.3,3865,64.41666666666667,10000000000,155.23932729624838
872,13,3,16,54.5,290.6666666666667,4360,72.66666666666667,3000000000,41.28440366972477
550,12,5,17,32.35294117647059,110,2750,45.833333333333336,5000000000,109.09090909090908
716,8,5,13,55.07692307692308,143.2,3580,59.666666666666664,5000000000,83.79888268156425
834,7,4,11,75.81818181818181,208.5,4170,69.5,4000000000,57.55395683453237
850,13,3,16,53.125,283.3333333333333,4250,70.83333333333333,3000000000,42.352941176470594
491,8,3,11,44.63636363636363,163.66666666666666,2455,40.916666666666664,3000000000,73.31975560081467
752,16,3,19,39.578947368421055,250.66666666666666,3760,62.666666666666664,3000000000,47.87234042553192
575,8,3,11,52.27272727272727,191.66666666666666,2875,47.916666666666664,3000000000,62.608695652173914
948,20,3,23,41.21739130434783,316,4740,79,3000000000,37.974683544303794
498,6,3,9,55.333333333333336,166,2490,41.5,3000000000,72.28915662650603
641,11,3,14,45.785714285714285,213.66666666666666,3205,53.416666666666664,3000000000,56.1622464898596
358,6,4,10,35.8,89.5,1790,29.833333333333332,4000000000,134.0782122905028
596,7,5,12,49.666666666666664,119.2,2980,49.666666666666664,5000000000,100.67114093959732
813,7,3,10,81.3,271,4065,67.75,3000000000,44.28044280442804
624,8,4,12,52,156,3120,52,4000000000,76.92307692307693
474,7,3,10,47.4,158,2370,39.5,3000000000,75.94936708860759
220,3,3,6,36.666666666666664,73.33333333333333,1100,18.333333333333332,3000000000,163.63636363636365
850,12,4,16,53.125,212.5,4250,70.83333333333333,4000000000,56.470588235294116
942,23,3,26,36.23076923076923,314,4710,78.5,3000000000,38.21656050955414
636,7,3,10,63.6,212,3180,53,3000000000,56.60377358490566
1597,19,15,34,46.970588235294116,106.46666666666667,7985,133.08333333333334,15000000000,112.71133375078271
482,10,4,14,34.42857142857143,120.5,2410,40.166666666666664,4000000000,99.5850622406639
479,8,5,13,36.84615384615385,95.8,2395,39.916666666666664,5000000000,125.26096033402925
650,11,3,14,46.42857142857143,216.66666666666666,3250,54.166666666666664,3000000000,55.38461538461539
824,9,3,12,68.66666666666667,274.6666666666667,4120,68.66666666666667,3000000000,43.68932038834951
1000,17,3,20,50,333.3333333333333,5000,83.33333333333333,3000000000,36
592,10,3,13,45.53846153846154,197.33333333333334,2960,49.333333333333336,3000000000,60.81081081081081
821,16,3,19,43.21052631578947,273.6666666666667,4105,68.41666666666667,3000000000,43.848964677222895
637,4,5,9,70.77777777777777,127.4,3185,53.083333333333336,5000000000,94.19152276295132
549,10,3,13,42.23076923076923,183,2745,45.75,3000000000,65.57377049180329
883,12,7,19,46.473684210526315,126.14285714285714,4415,73.58333333333333,7000000000,95.13023782559458
1365,19,3,22,62.04545454545455,455,6825,113.75,3000000000,26.373626373626372
170,5,3,8,21.25,56.666666666666664,850,14.166666666666666,3000000000,211.76470588235296
802,11,7,18,44.55555555555556,114.57142857142857,4010,66.83333333333333,7000000000,104.73815461346634
661,5,7,12,55.083333333333336,94.42857142857143,3305,55.083333333333336,7000000000,127.08018154311648
250,5,3,8,31.25,83.33333333333333,1250,20.833333333333332,3000000000,144
974,15,3,18,54.111111111111114,324.6666666666667,4870,81.16666666666667,3000000000,36.96098562628336
454,8,3,11,41.27272727272727,151.33333333333334,2270,37.833333333333336,3000000000,79.29515418502203
881,12,3,15,58.733333333333334,293.6666666666667,4405,73.41666666666667,3000000000,40.86265607264472
2049,31,3,34,60.26470588235294,683,10245,170.75,3000000000,17.569546120058565
655,12,4,16,40.9375,163.75,3275,54.583333333333336,4000000000,73.2824427480916
400,5,5,10,40,80,2000,33.333333333333336,5000000000,150
1010,14,3,17,59.411764705882355,336.6666666666667,5050,84.16666666666667,3000000000,35.64356435643564
513,8,4,12,42.75,128.25,2565,42.75,4000000000,93.5672514619883
546,11,3,14,39,182,2730,45.5,3000000000,65.93406593406593
356,4,3,7,50.857142857142854,118.66666666666667,1780,29.666666666666668,3000000000,101.12359550561797
356,4,5,9,39.55555555555556,71.2,1780,29.666666666666668,5000000000,168.53932584269663
473,5,3,8,59.125,157.66666666666666,2365,39.416666666666664,3000000000,76.10993657505286
665,12,3,15,44.333333333333336,221.66666666666666,3325,55.416666666666664,3000000000,54.13533834586466
534,5,9,14,38.142857142857146,59.333333333333336,2670,44.5,9000000000,202.24719101123594
630,6,3,9,70,210,3150,52.5,3000000000,57.14285714285714
821,11,3,14,58.642857142857146,273.6666666666667,4105,68.41666666666667,3000000000,43.848964677222895
499,11,3,14,35.642857142857146,166.33333333333334,2495,41.583333333333336,3000000000,72.14428857715431
575,6,3,9,63.888888888888886,191.66666666666666,2875,47.916666666666664,3000000000,62.608695652173914
878,17,8,25,35.12,109.75,4390,73.16666666666667,8000000000,109.3394077448747
507,11,3,14,36.214285714285715,169,2535,42.25,3000000000,71.0059171597633
696,9,6,15,46.4,116,3480,58,6000000000,103.44827586206897
524,11,3,14,37.42857142857143,174.66666666666666,2620,43.666666666666664,3000000000,68.70229007633587
447,7,3,10,44.7,149,2235,37.25,3000000000,80.53691275167786
539,8,5,13,41.46153846153846,107.8,2695,44.916666666666664,5000000000,111.31725417439704
510,7,3,10,51,170,2550,42.5,3000000000,70.58823529411764
496,7,3,10,49.6,165.33333333333334,2480,41.333333333333336,3000000000,72.58064516129032
241,4,3,7,34.42857142857143,80.33333333333333,1205,20.083333333333332,3000000000,149.37759336099586
1035,14,12,26,39.80769230769231,86.25,5175,86.25,12000000000,139.1304347826087
684,8,3,11,62.18181818181818,228,3420,57,3000000000,52.63157894736842
629,11,6,17,37,104.83333333333333,3145,52.416666666666664,6000000000,114.46740858505565
600,6,3,9,66.66666666666667,200,3000,50,3000000000,60
321,6,3,9,35.666666666666664,107,1605,26.75,3000000000,112.14953271028037
563,11,3,14,40.214285714285715,187.66666666666666,2815,46.916666666666664,3000000000,63.94316163410302
926,14,5,19,48.73684210526316,185.2,4630,77.16666666666667,5000000000,64.79481641468682
796,15,3,18,44.22222222222222,265.3333333333333,3980,66.33333333333333,3000000000,45.22613065326633
234,4,3,7,33.42857142857143,78,1170,19.5,3000000000,153.84615384615387
676,10,4,14,48.285714285714285,169,3380,56.333333333333336,4000000000,71.0059171597633
541,6,5,11,49.18181818181818,108.2,2705,45.083333333333336,5000000000,110.90573012939002
1542,24,8,32,48.1875,192.75,7710,128.5,8000000000,62.2568093385214
348,5,3,8,43.5,116,1740,29,3000000000,103.44827586206897
825,29,10,39,21.153846153846153,82.5,4125,68.75,10000000000,145.45454545454547
576,9,3,12,48,192,2880,48,3000000000,62.5
609,11,3,14,43.5,203,3045,50.75,3000000000,59.11330049261083
899,10,3,13,69.15384615384616,299.6666666666667,4495,74.91666666666667,3000000000,40.04449388209121
1240,16,7,23,53.91304347826087,177.14285714285714,6200,103.33333333333333,7000000000,67.74193548387098
362,6,3,9,40.22222222222222,120.66666666666667,1810,30.166666666666668,3000000000,99.4475138121547
488,9,3,12,40.666666666666664,162.66666666666666,2440,40.666666666666664,3000000000,73.7704918032787
647,9,8,17,38.05882352941177,80.875,3235,53.916666666666664,8000000000,148.3771251931994
741,12,3,15,49.4,247,3705,61.75,3000000000,48.582995951417004
886,16,6,22,40.27272727272727,147.66666666666666,4430,73.83333333333333,6000000000,81.26410835214448
424,7,3,10,42.4,141.33333333333334,2120,35.333333333333336,3000000000,84.90566037735849
465,3,5,8,58.125,93,2325,38.75,5000000000,129.03225806451613
314,9,3,12,26.166666666666668,104.66666666666667,1570,26.166666666666668,3000000000,114.64968152866241
613,10,3,13,47.15384615384615,204.33333333333334,3065,51.083333333333336,3000000000,58.727569331158236
560,7,4,11,50.90909090909091,140,2800,46.666666666666664,4000000000,85.71428571428572
1143,17,3,20,57.15,381,5715,95.25,3000000000,31.496062992125985
700,13,3,16,43.75,233.33333333333334,3500,58.333333333333336,3000000000,51.42857142857142
679,9,3,12,56.583333333333336,226.33333333333334,3395,56.583333333333336,3000000000,53.01914580265096
577,10,4,14,41.214285714285715,144.25,2885,48.083333333333336,4000000000,83.18890814558058
581,11,5,16,36.3125,116.2,2905,48.416666666666664,5000000000,103.27022375215148
674,11,3,14,48.142857142857146,224.66666666666666,3370,56.166666666666664,3000000000,53.41246290801187
747,17,3,20,37.35,249,3735,62.25,3000000000,48.192771084337345
328,6,3,9,36.44444444444444,109.33333333333333,1640,27.333333333333332,3000000000,109.7560975609756
346,7,3,10,34.6,115.33333333333333,1730,28.833333333333332,3000000000,104.04624277456647
476,9,3,12,39.666666666666664,158.66666666666666,2380,39.666666666666664,3000000000,75.63025210084035
745,14,8,22,33.86363636363637,93.125,3725,62.083333333333336,8000000000,128.85906040268455
787,15,6,21,37.476190476190474,131.16666666666666,3935,65.58333333333333,6000000000,91.4866581956798
917,17,3,20,45.85,305.6666666666667,4585,76.41666666666667,3000000000,39.25845147219193
652,14,3,17,38.35294117647059,217.33333333333334,3260,54.333333333333336,3000000000,55.214723926380366
213,5,3,8,26.625,71,1065,17.75,3000000000,169.01408450704227
395,6,3,9,43.888888888888886,131.66666666666666,1975,32.916666666666664,3000000000,91.13924050632912
563,8,9,17,33.11764705882353,62.55555555555556,2815,46.916666666666664,9000000000,191.82948490230905
265,7,3,10,26.5,88.33333333333333,1325,22.083333333333332,3000000000,135.8490566037736
805,13,3,16,50.3125,268.3333333333333,4025,67.08333333333333,3000000000,44.72049689440994
551,7,6,13,42.38461538461539,91.83333333333333,2755,45.916666666666664,6000000000,130.67150635208714
1658,31,12,43,38.55813953488372,138.16666666666666,8290,138.16666666666666,12000000000,86.85162846803378
1062,10,3,13,81.6923076923077,354,5310,88.5,3000000000,33.898305084745765
670,12,8,20,33.5,83.75,3350,55.833333333333336,8000000000,143.28358208955223
574,13,3,16,35.875,191.33333333333334,2870,47.833333333333336,3000000000,62.7177700348432
501,11,3,14,35.785714285714285,167,2505,41.75,3000000000,71.85628742514969
477,4,3,7,68.14285714285714,159,2385,39.75,3000000000,75.47169811320755
626,15,3,18,34.77777777777778,208.66666666666666,3130,52.166666666666664,3000000000,57.50798722044728
625,7,7,14,44.642857142857146,89.28571428571429,3125,52.083333333333336,7000000000,134.4
285,5,3,8,35.625,95,1425,23.75,3000000000,126.3157894736842
328,7,3,10,32.8,109.33333333333333,1640,27.333333333333332,3000000000,109.7560975609756
1306,18,3,21,62.19047619047619,435.3333333333333,6530,108.83333333333333,3000000000,27.56508422664625
698,7,3,10,69.8,232.66666666666666,3490,58.166666666666664,3000000000,51.5759312320917
423,10,3,13,32.53846153846154,141,2115,35.25,3000000000,85.1063829787234
1041,12,3,15,69.4,347,5205,86.75,3000000000,34.5821325648415
599,8,3,11,54.45454545454545,199.66666666666666,2995,49.916666666666664,3000000000,60.10016694490819
843,21,6,27,31.22222222222222,140.5,4215,70.25,6000000000,85.40925266903915
580,6,3,9,64.44444444444444,193.33333333333334,2900,48.333333333333336,3000000000,62.068965517241374
1209,12,13,25,48.36,93,6045,100.75,13000000000,129.03225806451613
325,10,3,13,25,108.33333333333333,1625,27.083333333333332,3000000000,110.76923076923077
473,12,3,15,31.533333333333335,157.66666666666666,2365,39.416666666666664,3000000000,76.10993657505286
312,4,3,7,44.57142857142857,104,1560,26,3000000000,115.38461538461539
1005,10,8,18,55.833333333333336,125.625,5025,83.75,8000000000,95.52238805970148
430,4,3,7,61.42857142857143,143.33333333333334,2150,35.833333333333336,3000000000,83.72093023255813
858,12,6,18,47.666666666666664,143,4290,71.5,6000000000,83.91608391608392
972,11,5,16,60.75,194.4,4860,81,5000000000,61.72839506172839
924,12,7,19,48.63157894736842,132,4620,77,7000000000,90.9090909090909
139,7,3,10,13.9,46.333333333333336,695,11.583333333333334,3000000000,258.9928057553957
369,4,3,7,52.714285714285715,123,1845,30.75,3000000000,97.5609756097561
696,10,3,13,53.53846153846154,232,3480,58,3000000000,51.724137931034484
838,14,5,19,44.10526315789474,167.6,4190,69.83333333333333,5000000000,71.59904534606207
755,16,8,24,31.458333333333332,94.375,3775,62.916666666666664,8000000000,127.1523178807947
820,9,7,16,51.25,117.14285714285714,4100,68.33333333333333,7000000000,102.4390243902439
776,14,7,21,36.95238095238095,110.85714285714286,3880,64.66666666666667,7000000000,108.24742268041237
430,7,3,10,43,143.33333333333334,2150,35.833333333333336,3000000000,83.72093023255813
526,7,3,10,52.6,175.33333333333334,2630,43.833333333333336,3000000000,68.44106463878326
555,9,5,14,39.642857142857146,111,2775,46.25,5000000000,108.1081081081081
570,9,3,12,47.5,190,2850,47.5,3000000000,63.1578947368421
725,9,3,12,60.416666666666664,241.66666666666666,3625,60.416666666666664,3000000000,49.6551724137931
704,8,4,12,58.666666666666664,176,3520,58.666666666666664,4000000000,68.18181818181819
951,19,3,22,43.22727272727273,317,4755,79.25,3000000000,37.85488958990537
505,8,5,13,38.84615384615385,101,2525,42.083333333333336,5000000000,118.8118811881188
1265,28,9,37,34.189189189189186,140.55555555555554,6325,105.41666666666667,9000000000,85.37549407114624
636,10,3,13,48.92307692307692,212,3180,53,3000000000,56.60377358490566
460,7,3,10,46,153.33333333333334,2300,38.333333333333336,3000000000,78.26086956521739
347,5,3,8,43.375,115.66666666666667,1735,28.916666666666668,3000000000,103.7463976945245
543,10,4,14,38.785714285714285,135.75,2715,45.25,4000000000,88.39779005524862
1524,14,13,27,56.44444444444444,117.23076923076923,7620,127,13000000000,102.36220472440945
419,9,3,12,34.916666666666664,139.66666666666666,2095,34.916666666666664,3000000000,85.91885441527447
296,3,3,6,49.333333333333336,98.66666666666667,1480,24.666666666666668,3000000000,121.62162162162161
660,15,3,18,36.666666666666664,220,3300,55,3000000000,54.54545454545455
374,7,3,10,37.4,124.66666666666667,1870,31.166666666666668,3000000000,96.2566844919786
647,14,3,17,38.05882352941177,215.66666666666666,3235,53.916666666666664,3000000000,55.64142194744977
793,13,5,18,44.05555555555556,158.6,3965,66.08333333333333,5000000000,75.66204287515764
433,10,4,14,30.928571428571427,108.25,2165,36.083333333333336,4000000000,110.85450346420322
804,10,8,18,44.666666666666664,100.5,4020,67,8000000000,119.40298507462687
678,8,3,11,61.63636363636363,226,3390,56.5,3000000000,53.097345132743364
640,13,5,18,35.55555555555556,128,3200,53.333333333333336,5000000000,93.75
637,8,3,11,57.90909090909091,212.33333333333334,3185,53.083333333333336,3000000000,56.5149136577708
666,16,5,21,31.714285714285715,133.2,3330,55.5,5000000000,90.0900900900901
739,11,8,19,38.89473684210526,92.375,3695,61.583333333333336,8000000000,129.90527740189444
367,7,3,10,36.7,122.33333333333333,1835,30.583333333333332,3000000000,98.09264305177112
528,8,3,11,48,176,2640,44,3000000000,68.18181818181819
889,14,3,17,52.294117647058826,296.3333333333333,4445,74.08333333333333,3000000000,40.49493813273341
289,4,3,7,41.285714285714285,96.33333333333333,1445,24.083333333333332,3000000000,124.56747404844292
446,4,6,10,44.6,74.33333333333333,2230,37.166666666666664,6000000000,161.43497757847535
437,6,3,9,48.55555555555556,145.66666666666666,2185,36.416666666666664,3000000000,82.37986270022884
569,7,3,10,56.9,189.66666666666666,2845,47.416666666666664,3000000000,63.26889279437611
331,8,3,11,30.09090909090909,110.33333333333333,1655,27.583333333333332,3000000000,108.76132930513594
530,14,8,22,24.09090909090909,66.25,2650,44.166666666666664,8000000000,181.13207547169813
943,12,3,15,62.86666666666667,314.3333333333333,4715,78.58333333333333,3000000000,38.17603393425239
580,7,3,10,58,193.33333333333334,2900,48.333333333333336,3000000000,62.068965517241374
434,5,3,8,54.25,144.66666666666666,2170,36.166666666666664,3000000000,82.94930875576037
660,9,3,12,55,220,3300,55,3000000000,54.54545454545455
909,19,3,22,41.31818181818182,303,4545,75.75,3000000000,39.603960396039604
324,6,4,10,32.4,81,1620,27,4000000000,148.14814814814815
502,9,4,13,38.61538461538461,125.5,2510,41.833333333333336,4000000000,95.61752988047809
431,8,3,11,39.18181818181818,143.66666666666666,2155,35.916666666666664,3000000000,83.52668213457078
1058,11,10,21,50.38095238095238,105.8,5290,88.16666666666667,10000000000,113.42155009451794
283,6,3,9,31.444444444444443,94.33333333333333,1415,23.583333333333332,3000000000,127.20848056537103
853,17,3,20,42.65,284.3333333333333,4265,71.08333333333333,3000000000,42.20398593200469
774,6,3,9,86,258,3870,64.5,3000000000,46.51162790697674
368,7,3,10,36.8,122.66666666666667,1840,30.666666666666668,3000000000,97.82608695652173
921,11,3,14,65.78571428571429,307,4605,76.75,3000000000,39.08794788273615
748,9,6,15,49.86666666666667,124.66666666666667,3740,62.333333333333336,6000000000,96.2566844919786
1046,13,6,19,55.05263157894737,174.33333333333334,5230,87.16666666666667,6000000000,68.83365200764818
552,10,5,15,36.8,110.4,2760,46,5000000000,108.69565217391305
179,3,5,8,22.375,35.8,895,14.916666666666666,5000000000,335.195530726257
1000,13,6,19,52.63157894736842,166.66666666666666,5000,83.33333333333333,6000000000,72
617,9,3,12,51.416666666666664,205.66666666666666,3085,51.416666666666664,3000000000,58.346839546191255
441,6,3,9,49,147,2205,36.75,3000000000,81.63265306122449
457,13,3,16,28.5625,152.33333333333334,2285,38.083333333333336,3000000000,78.77461706783369
546,9,3,12,45.5,182,2730,45.5,3000000000,65.93406593406593
648,9,3,12,54,216,3240,54,3000000000,55.55555555555555
654,11,4,15,43.6,163.5,3270,54.5,4000000000,73.39449541284404
950,15,9,24,39.583333333333336,105.55555555555556,4750,79.16666666666667,9000000000,113.68421052631578
864,13,3,16,54,288,4320,72,3000000000,41.666666666666664
618,13,5,18,34.333333333333336,123.6,3090,51.5,5000000000,97.08737864077669
548,10,3,13,42.15384615384615,182.66666666666666,2740,45.666666666666664,3000000000,65.69343065693431
777,13,3,16,48.5625,259,3885,64.75,3000000000,46.33204633204633
480,6,3,9,53.333333333333336,160,2400,40,3000000000,75
382,7,3,10,38.2,127.33333333333333,1910,31.833333333333332,3000000000,94.24083769633508
295,5,3,8,36.875,98.33333333333333,1475,24.583333333333332,3000000000,122.03389830508475
446,4,3,7,63.714285714285715,148.66666666666666,2230,37.166666666666664,3000000000,80.71748878923768
1060,9,5,14,75.71428571428571,212,5300,88.33333333333333,5000000000,56.60377358490566
346,6,3,9,38.44444444444444,115.33333333333333,1730,28.833333333333332,3000000000,104.04624277456647
715,12,3,15,47.666666666666664,238.33333333333334,3575,59.583333333333336,3000000000,50.34965034965035
435,7,3,10,43.5,145,2175,36.25,3000000000,82.75862068965517
633,10,3,13,48.69230769230769,211,3165,52.75,3000000000,56.87203791469194
435,6,3,9,48.333333333333336,145,2175,36.25,3000000000,82.75862068965517
891,10,9,19,46.89473684210526,99,4455,74.25,9000000000,121.21212121212122
511,13,3,16,31.9375,170.33333333333334,2555,42.583333333333336,3000000000,70.45009784735812
540,13,10,23,23.47826086956522,54,2700,45,10000000000,222.2222222222222
525,8,3,11,47.72727272727273,175,2625,43.75,3000000000,68.57142857142857
1275,17,7,24,53.125,182.14285714285714,6375,106.25,7000000000,65.88235294117648
388,7,5,12,32.333333333333336,77.6,1940,32.333333333333336,5000000000,154.63917525773195
284,9,3,12,23.666666666666668,94.66666666666667,1420,23.666666666666668,3000000000,126.76056338028168
339,4,6,10,33.9,56.5,1695,28.25,6000000000,212.38938053097345
528,5,5,10,52.8,105.6,2640,44,5000000000,113.63636363636364
356,6,3,9,39.55555555555556,118.66666666666667,1780,29.666666666666668,3000000000,101.12359550561797
1055,14,10,24,43.958333333333336,105.5,5275,87.91666666666667,10000000000,113.74407582938387
962,21,3,24,40.083333333333336,320.6666666666667,4810,80.16666666666667,3000000000,37.42203742203742
1075,23,5,28,38.392857142857146,215,5375,89.58333333333333,5000000000,55.81395348837209
502,7,3,10,50.2,167.33333333333334,2510,41.833333333333336,3000000000,71.71314741035856
665,4,6,10,66.5,110.83333333333333,3325,55.416666666666664,6000000000,108.27067669172932
738,9,3,12,61.5,246,3690,61.5,3000000000,48.78048780487805
1014,17,6,23,44.08695652173913,169,5070,84.5,6000000000,71.0059171597633
368,8,3,11,33.45454545454545,122.66666666666667,1840,30.666666666666668,3000000000,97.82608695652173
524,4,5,9,58.22222222222222,104.8,2620,43.666666666666664,5000000000,114.50381679389312
289,3,3,6,48.166666666666664,96.33333333333333,1445,24.083333333333332,3000000000,124.56747404844292
822,12,4,16,51.375,205.5,4110,68.5,4000000000,58.394160583941606
527,7,5,12,43.916666666666664,105.4,2635,43.916666666666664,5000000000,113.85199240986718
547,9,3,12,45.583333333333336,182.33333333333334,2735,45.583333333333336,3000000000,65.81352833638024
738,5,7,12,61.5,105.42857142857143,3690,61.5,7000000000,113.82113821138212
1100,14,8,22,50,137.5,5500,91.66666666666667,8000000000,87.27272727272727
728,10,8,18,40.44444444444444,91,3640,60.666666666666664,8000000000,131.86813186813188
890,8,4,12,74.16666666666667,222.5,4450,74.16666666666667,4000000000,53.93258426966292
667,8,3,11,60.63636363636363,222.33333333333334,3335,55.583333333333336,3000000000,53.973013493253376
439,8,7,15,29.266666666666666,62.714285714285715,2195,36.583333333333336,7000000000,191.34396355353076
525,9,3,12,43.75,175,2625,43.75,3000000000,68.57142857142857
796,7,8,15,53.06666666666667,99.5,3980,66.33333333333333,8000000000,120.6030150753769
907,12,3,15,60.46666666666667,302.3333333333333,4535,75.58333333333333,3000000000,39.69128996692393
727,7,7,14,51.92857142857143,103.85714285714286,3635,60.583333333333336,7000000000,115.5433287482806
986,14,3,17,58,328.6666666666667,4930,82.16666666666667,3000000000,36.511156186612574
693,9,7,16,43.3125,99,3465,57.75,7000000000,121.21212121212122
614,11,5,16,38.375,122.8,3070,51.166666666666664,5000000000,97.7198697068404
195,5,3,8,24.375,65,975,16.25,3000000000,184.6153846153846
398,8,3,11,36.18181818181818,132.66666666666666,1990,33.166666666666664,3000000000,90.45226130653266
383,5,4,9,42.55555555555556,95.75,1915,31.916666666666668,4000000000,125.32637075718016
682,18,4,22,31,170.5,3410,56.833333333333336,4000000000,70.38123167155425
236,5,3,8,29.5,78.66666666666667,1180,19.666666666666668,3000000000,152.5423728813559
429,12,8,20,21.45,53.625,2145,35.75,8000000000,223.7762237762238
570,7,4,11,51.81818181818182,142.5,2850,47.5,4000000000,84.21052631578948
544,9,3,12,45.333333333333336,181.33333333333334,2720,45.333333333333336,3000000000,66.17647058823529
572,8,3,11,52,190.66666666666666,2860,47.666666666666664,3000000000,62.93706293706294
766,13,7,20,38.3,109.42857142857143,3830,63.833333333333336,7000000000,109.66057441253263
1363,27,3,30,45.43333333333333,454.3333333333333,6815,113.58333333333333,3000000000,26.41232575201761
924,22,9,31,29.806451612903224,102.66666666666667,4620,77,9000000000,116.88311688311688
633,6,5,11,57.54545454545455,126.6,3165,52.75,5000000000,94.7867298578199
766,12,9,21,36.476190476190474,85.11111111111111,3830,63.833333333333336,9000000000,140.99216710182768
752,8,9,17,44.23529411764706,83.55555555555556,3760,62.666666666666664,9000000000,143.61702127659575
610,7,6,13,46.92307692307692,101.66666666666667,3050,50.833333333333336,6000000000,118.03278688524588
1098,14,13,27,40.666666666666664,84.46153846153847,5490,91.5,13000000000,142.07650273224044
418,10,3,13,32.15384615384615,139.33333333333334,2090,34.833333333333336,3000000000,86.1244019138756
393,5,5,10,39.3,78.6,1965,32.75,5000000000,152.67175572519085
604,11,3,14,43.142857142857146,201.33333333333334,3020,50.333333333333336,3000000000,59.602649006622514
514,10,8,18,28.555555555555557,64.25,2570,42.833333333333336,8000000000,186.7704280155642
1265,20,3,23,55,421.6666666666667,6325,105.41666666666667,3000000000,28.458498023715414
590,13,3,16,36.875,196.66666666666666,2950,49.166666666666664,3000000000,61.016949152542374
1176,15,3,18,65.33333333333333,392,5880,98,3000000000,30.612244897959183
664,5,3,8,83,221.33333333333334,3320,55.333333333333336,3000000000,54.21686746987952
292,3,6,9,32.44444444444444,48.666666666666664,1460,24.333333333333332,6000000000,246.57534246575344
499,4,7,11,45.36363636363637,71.28571428571429,2495,41.583333333333336,7000000000,168.33667334669337
939,19,7,26,36.11538461538461,134.14285714285714,4695,78.25,7000000000,89.45686900958466
687,17,5,22,31.227272727272727,137.4,3435,57.25,5000000000,87.33624454148472
490,11,3,14,35,163.33333333333334,2450,40.833333333333336,3000000000,73.46938775510203
618,8,9,17,36.35294117647059,68.66666666666667,3090,51.5,9000000000,174.75728155339806
1079,22,8,30,35.96666666666667,134.875,5395,89.91666666666667,8000000000,88.97126969416125
588,9,5,14,42,117.6,2940,49,5000000000,102.0408163265306
452,5,5,10,45.2,90.4,2260,37.666666666666664,5000000000,132.7433628318584
499,4,3,7,71.28571428571429,166.33333333333334,2495,41.583333333333336,3000000000,72.14428857715431
731,10,4,14,52.214285714285715,182.75,3655,60.916666666666664,4000000000,65.66347469220247
875,8,8,16,54.6875,109.375,4375,72.91666666666667,8000000000,109.71428571428571
290,5,3,8,36.25,96.66666666666667,1450,24.166666666666668,3000000000,124.13793103448275
495,12,3,15,33,165,2475,41.25,3000000000,72.72727272727273
915,18,3,21,43.57142857142857,305,4575,76.25,3000000000,39.34426229508197
708,13,6,19,37.26315789473684,118,3540,59,6000000000,101.69491525423729
650,12,6,18,36.111111111111114,108.33333333333333,3250,54.166666666666664,6000000000,110.76923076923077
684,13,8,21,32.57142857142857,85.5,3420,57,8000000000,140.35087719298247
585,10,3,13,45,195,2925,48.75,3000000000,61.53846153846153
465,7,3,10,46.5,155,2325,38.75,3000000000,77.41935483870968
620,7,3,10,62,206.66666666666666,3100,51.666666666666664,3000000000,58.06451612903226
710,7,5,12,59.166666666666664,142,3550,59.166666666666664,5000000000,84.50704225352113
974,16,3,19,51.26315789473684,324.6666666666667,4870,81.16666666666667,3000000000,36.96098562628336
755,12,5,17,44.411764705882355,151,3775,62.916666666666664,5000000000,79.4701986754967
767,15,3,18,42.611111111111114,255.66666666666666,3835,63.916666666666664,3000000000,46.9361147327249
137,4,3,7,19.571428571428573,45.666666666666664,685,11.416666666666666,3000000000,262.77372262773724
398,5,6,11,36.18181818181818,66.33333333333333,1990,33.166666666666664,6000000000,180.90452261306532
1023,16,7,23,44.47826086956522,146.14285714285714,5115,85.25,7000000000,82.11143695014663
495,7,4,11,45,123.75,2475,41.25,4000000000,96.96969696969697
606,5,4,9,67.33333333333333,151.5,3030,50.5,4000000000,79.20792079207921
473,8,3,11,43,157.66666666666666,2365,39.416666666666664,3000000000,76.10993657505286
1267,20,9,29,43.689655172413794,140.77777777777777,6335,105.58333333333333,9000000000,85.24072612470404
349,11,3,14,24.928571428571427,116.33333333333333,1745,29.083333333333332,3000000000,103.1518624641834
627,10,3,13,48.23076923076923,209,3135,52.25,3000000000,57.41626794258373
564,9,4,13,43.38461538461539,141,2820,47,4000000000,85.1063829787234
428,8,3,11,38.90909090909091,142.66666666666666,2140,35.666666666666664,3000000000,84.11214953271029
986,13,4,17,58,246.5,4930,82.16666666666667,4000000000,48.6815415821501
651,8,3,11,59.18181818181818,217,3255,54.25,3000000000,55.29953917050691
413,8,3,11,37.54545454545455,137.66666666666666,2065,34.416666666666664,3000000000,87.16707021791768
334,3,3,6,55.666666666666664,111.33333333333333,1670,27.833333333333332,3000000000,107.78443113772455
395,5,3,8,49.375,131.66666666666666,1975,32.916666666666664,3000000000,91.13924050632912
505,9,3,12,42.083333333333336,168.33333333333334,2525,42.083333333333336,3000000000,71.28712871287128
584,13,3,16,36.5,194.66666666666666,2920,48.666666666666664,3000000000,61.64383561643836
801,10,3,13,61.61538461538461,267,4005,66.75,3000000000,44.9438202247191
616,10,3,13,47.38461538461539,205.33333333333334,3080,51.333333333333336,3000000000,58.441558441558435
767,13,3,16,47.9375,255.66666666666666,3835,63.916666666666664,3000000000,46.9361147327249
499,7,3,10,49.9,166.33333333333334,2495,41.583333333333336,3000000000,72.14428857715431
894,13,7,20,44.7,127.71428571428571,4470,74.5,7000000000,93.95973154362416
403,7,3,10,40.3,134.33333333333334,2015,33.583333333333336,3000000000,89.33002481389578
567,10,3,13,43.61538461538461,189,2835,47.25,3000000000,63.492063492063494
431,6,3,9,47.888888888888886,143.66666666666666,2155,35.916666666666664,3000000000,83.52668213457078
1413,21,3,24,58.875,471,7065,117.75,3000000000,25.477707006369428
387,9,4,13,29.76923076923077,96.75,1935,32.25,4000000000,124.03100775193799
543,7,3,10,54.3,181,2715,45.25,3000000000,66.29834254143647
782,8,3,11,71.0909090909091,260.6666666666667,3910,65.16666666666667,3000000000,46.03580562659846
656,10,4,14,46.857142857142854,164,3280,54.666666666666664,4000000000,73.17073170731707
180,3,3,6,30,60,900,15,3000000000,200
539,7,4,11,49,134.75,2695,44.916666666666664,4000000000,89.05380333951763
348,9,6,15,23.2,58,1740,29,6000000000,206.89655172413794
373,4,3,7,53.285714285714285,124.33333333333333,1865,31.083333333333332,3000000000,96.514745308311
648,7,3,10,64.8,216,3240,54,3000000000,55.55555555555555
829,15,3,18,46.05555555555556,276.3333333333333,4145,69.08333333333333,3000000000,43.42581423401689
604,12,5,17,35.529411764705884,120.8,3020,50.333333333333336,5000000000,99.33774834437085
545,12,3,15,36.333333333333336,181.66666666666666,2725,45.416666666666664,3000000000,66.05504587155963
1102,21,8,29,38,137.75,5510,91.83333333333333,8000000000,87.11433756805808
1216,19,11,30,40.53333333333333,110.54545454545455,6080,101.33333333333333,11000000000,108.55263157894738
1445,13,11,24,60.208333333333336,131.36363636363637,7225,120.41666666666667,11000000000,91.34948096885812
558,7,4,11,50.72727272727273,139.5,2790,46.5,4000000000,86.02150537634408
375,7,3,10,37.5,125,1875,31.25,3000000000,96
343,5,3,8,42.875,114.33333333333333,1715,28.583333333333332,3000000000,104.95626822157435
730,10,3,13,56.15384615384615,243.33333333333334,3650,60.833333333333336,3000000000,49.31506849315068
376,6,3,9,41.77777777777778,125.33333333333333,1880,31.333333333333332,3000000000,95.74468085106383
925,14,5,19,48.68421052631579,185,4625,77.08333333333333,5000000000,64.86486486486487
386,4,4,8,48.25,96.5,1930,32.166666666666664,4000000000,124.35233160621762
858,12,3,15,57.2,286,4290,71.5,3000000000,41.95804195804196
1481,19,8,27,54.851851851851855,185.125,7405,123.41666666666667,8000000000,64.82106684672519
621,10,3,13,47.76923076923077,207,3105,51.75,3000000000,57.971014492753625
731,11,9,20,36.55,81.22222222222223,3655,60.916666666666664,9000000000,147.74281805745554
634,17,3,20,31.7,211.33333333333334,3170,52.833333333333336,3000000000,56.78233438485804
238,4,3,7,34,79.33333333333333,1190,19.833333333333332,3000000000,151.2605042016807
473,6,7,13,36.38461538461539,67.57142857142857,2365,39.416666666666664,7000000000,177.5898520084567
549,11,4,15,36.6,137.25,2745,45.75,4000000000,87.43169398907104
463,6,3,9,51.44444444444444,154.33333333333334,2315,38.583333333333336,3000000000,77.7537796976242
461,7,7,14,32.92857142857143,65.85714285714286,2305,38.416666666666664,7000000000,182.2125813449024
861,10,3,13,66.23076923076923,287,4305,71.75,3000000000,41.811846689895475
362,4,4,8,45.25,90.5,1810,30.166666666666668,4000000000,132.59668508287294
1277,16,10,26,49.11538461538461,127.7,6385,106.41666666666667,10000000000,93.97024275646044
540,8,6,14,38.57142857142857,90,2700,45,6000000000,133.33333333333331
479,10,3,13,36.84615384615385,159.66666666666666,2395,39.916666666666664,3000000000,75.15657620041755
474,7,3,10,47.4,158,2370,39.5,3000000000,75.94936708860759
610,7,5,12,50.833333333333336,122,3050,50.833333333333336,5000000000,98.36065573770492
1316,18,3,21,62.666666666666664,438.6666666666667,6580,109.66666666666667,3000000000,27.35562310030395
504,6,4,10,50.4,126,2520,42,4000000000,95.23809523809524
959,11,6,17,56.411764705882355,159.83333333333334,4795,79.91666666666667,6000000000,75.07820646506778
306,7,3,10,30.6,102,1530,25.5,3000000000,117.6470588235294
995,11,3,14,71.07142857142857,331.6666666666667,4975,82.91666666666667,3000000000,36.18090452261306
509,12,4,16,31.8125,127.25,2545,42.416666666666664,4000000000,94.30255402750493
463,7,3,10,46.3,154.33333333333334,2315,38.583333333333336,3000000000,77.7537796976242
611,10,3,13,47,203.66666666666666,3055,50.916666666666664,3000000000,58.91980360065467
302,6,3,9,33.55555555555556,100.66666666666667,1510,25.166666666666668,3000000000,119.20529801324503
701,12,6,18,38.94444444444444,116.83333333333333,3505,58.416666666666664,6000000000,102.71041369472184
273,5,3,8,34.125,91,1365,22.75,3000000000,131.86813186813185
492,7,3,10,49.2,164,2460,41,3000000000,73.17073170731707
515,8,6,14,36.785714285714285,85.83333333333333,2575,42.916666666666664,6000000000,139.80582524271847
361,4,3,7,51.57142857142857,120.33333333333333,1805,30.083333333333332,3000000000,99.7229916897507
526,8,6,14,37.57142857142857,87.66666666666667,2630,43.833333333333336,6000000000,136.88212927756652
687,6,5,11,62.45454545454545,137.4,3435,57.25,5000000000,87.33624454148472
744,12,3,15,49.6,248,3720,62,3000000000,48.387096774193544
507,9,5,14,36.214285714285715,101.4,2535,42.25,5000000000,118.34319526627219
454,6,3,9,50.44444444444444,151.33333333333334,2270,37.833333333333336,3000000000,79.29515418502203
515,7,3,10,51.5,171.66666666666666,2575,42.916666666666664,3000000000,69.90291262135923
782,12,3,15,52.13333333333333,260.6666666666667,3910,65.16666666666667,3000000000,46.03580562659846
521,15,3,18,28.944444444444443,173.66666666666666,2605,43.416666666666664,3000000000,69.0978886756238
391,4,3,7,55.857142857142854,130.33333333333334,1955,32.583333333333336,3000000000,92.07161125319692
535,7,3,10,53.5,178.33333333333334,2675,44.583333333333336,3000000000,67.28971962616822
608,12,3,15,40.53333333333333,202.66666666666666,3040,50.666666666666664,3000000000,59.21052631578947
490,9,4,13,37.69230769230769,122.5,2450,40.833333333333336,4000000000,97.95918367346938
1042,19,3,22,47.36363636363637,347.3333333333333,5210,86.83333333333333,3000000000,34.5489443378119
238,7,3,10,23.8,79.33333333333333,1190,19.833333333333332,3000000000,151.2605042016807
295,9,3,12,24.583333333333332,98.33333333333333,1475,24.583333333333332,3000000000,122.03389830508475
571,10,3,13,43.92307692307692,190.33333333333334,2855,47.583333333333336,3000000000,63.047285464098074
531,5,3,8,66.375,177,2655,44.25,3000000000,67.79661016949153
772,12,5,17,45.411764705882355,154.4,3860,64.33333333333333,5000000000,77.72020725388602
591,9,3,12,49.25,197,2955,49.25,3000000000,60.91370558375634
532,8,3,11,48.36363636363637,177.33333333333334,2660,44.333333333333336,3000000000,67.66917293233082
468,6,5,11,42.54545454545455,93.6,2340,39,5000000000,128.2051282051282
930,8,6,14,66.42857142857143,155,4650,77.5,6000000000,77.41935483870968
458,7,4,11,41.63636363636363,114.5,2290,38.166666666666664,4000000000,104.80349344978167
637,6,5,11,57.90909090909091,127.4,3185,53.083333333333336,5000000000,94.19152276295132
492,8,4,12,41,123,2460,41,4000000000,97.5609756097561
455,6,3,9,50.55555555555556,151.66666666666666,2275,37.916666666666664,3000000000,79.12087912087912
530,6,3,9,58.888888888888886,176.66666666666666,2650,44.166666666666664,3000000000,67.9245283018868
217,7,4,11,19.727272727272727,54.25,1085,18.083333333333332,4000000000,221.19815668202767
768,14,3,17,45.1764705882353,256,3840,64,3000000000,46.875
546,10,3,13,42,182,2730,45.5,3000000000,65.93406593406593
481,14,3,17,28.294117647058822,160.33333333333334,2405,40.083333333333336,3000000000,74.84407484407484
424,6,5,11,38.54545454545455,84.8,2120,35.333333333333336,5000000000,141.50943396226415
688,11,3,14,49.142857142857146,229.33333333333334,3440,57.333333333333336,3000000000,52.325581395348834
537,9,6,15,35.8,89.5,2685,44.75,6000000000,134.0782122905028
820,17,3,20,41,273.3333333333333,4100,68.33333333333333,3000000000,43.90243902439025
835,14,9,23,36.30434782608695,92.77777777777777,4175,69.58333333333333,9000000000,129.34131736526948
819,10,5,15,54.6,163.8,4095,68.25,5000000000,73.26007326007326
313,7,4,11,28.454545454545453,78.25,1565,26.083333333333332,4000000000,153.3546325878594
478,5,3,8,59.75,159.33333333333334,2390,39.833333333333336,3000000000,75.31380753138075
469,7,3,10,46.9,156.33333333333334,2345,39.083333333333336,3000000000,76.75906183368869
684,7,6,13,52.61538461538461,114,3420,57,6000000000,105.26315789473684
481,5,5,10,48.1,96.2,2405,40.083333333333336,5000000000,124.74012474012473
350,6,3,9,38.888888888888886,116.66666666666667,1750,29.166666666666668,3000000000,102.85714285714285
516,7,3,10,51.6,172,2580,43,3000000000,69.76744186046511
536,6,5,11,48.72727272727273,107.2,2680,44.666666666666664,5000000000,111.9402985074627
383,9,3,12,31.916666666666668,127.66666666666667,1915,31.916666666666668,3000000000,93.99477806788512
637,11,8,19,33.526315789473685,79.625,3185,53.083333333333336,8000000000,150.70643642072213
604,8,3,11,54.90909090909091,201.33333333333334,3020,50.333333333333336,3000000000,59.602649006622514
880,19,7,26,33.84615384615385,125.71428571428571,4400,73.33333333333333,7000000000,95.45454545454547
346,3,3,6,57.666666666666664,115.33333333333333,1730,28.833333333333332,3000000000,104.04624277456647
463,7,3,10,46.3,154.33333333333334,2315,38.583333333333336,3000000000,77.7537796976242
337,8,3,11,30.636363636363637,112.33333333333333,1685,28.083333333333332,3000000000,106.82492581602374
297,3,3,6,49.5,99,1485,24.75,3000000000,121.21212121212122
632,16,3,19,33.26315789473684,210.66666666666666,3160,52.666666666666664,3000000000,56.9620253164557
614,10,3,13,47.23076923076923,204.66666666666666,3070,51.166666666666664,3000000000,58.63192182410423
517,8,3,11,47,172.33333333333334,2585,43.083333333333336,3000000000,69.63249516441006
690,8,4,12,57.5,172.5,3450,57.5,4000000000,69.56521739130434
648,11,3,14,46.285714285714285,216,3240,54,3000000000,55.55555555555555
422,10,3,13,32.46153846153846,140.66666666666666,2110,35.166666666666664,3000000000,85.30805687203792
925,13,5,18,51.388888888888886,185,4625,77.08333333333333,5000000000,64.86486486486487
480,4,8,12,40,60,2400,40,8000000000,200
664,9,3,12,55.333333333333336,221.33333333333334,3320,55.333333333333336,3000000000,54.21686746987952
1496,21,13,34,44,115.07692307692308,7480,124.66666666666667,13000000000,104.27807486631015
217,4,4,8,27.125,54.25,1085,18.083333333333332,4000000000,221.19815668202767
483,8,6,14,34.5,80.5,2415,40.25,6000000000,149.06832298136646
904,16,4,20,45.2,226,4520,75.33333333333333,4000000000,53.097345132743364
488,9,3,12,40.666666666666664,162.66666666666666,2440,40.666666666666664,3000000000,73.7704918032787
571,6,6,12,47.583333333333336,95.16666666666667,2855,47.583333333333336,6000000000,126.09457092819615
859,10,3,13,66.07692307692308,286.3333333333333,4295,71.58333333333333,3000000000,41.909196740395814
589,11,3,14,42.07142857142857,196.33333333333334,2945,49.083333333333336,3000000000,61.120543293718164
680,7,5,12,56.666666666666664,136,3400,56.666666666666664,5000000000,88.23529411764707
820,8,3,11,74.54545454545455,273.3333333333333,4100,68.33333333333333,3000000000,43.90243902439025
625,12,3,15,41.666666666666664,208.33333333333334,3125,52.083333333333336,3000000000,57.6
385,6,4,10,38.5,96.25,1925,32.083333333333336,4000000000,124.67532467532466
771,9,3,12,64.25,257,3855,64.25,3000000000,46.69260700389105
1019,17,3,20,50.95,339.6666666666667,5095,84.91666666666667,3000000000,35.328753680078506
265,3,3,6,44.166666666666664,88.33333333333333,1325,22.083333333333332,3000000000,135.8490566037736
474,8,3,11,43.09090909090909,158,2370,39.5,3000000000,75.94936708860759
1088,11,4,15,72.53333333333333,272,5440,90.66666666666667,4000000000,44.11764705882353
215,6,3,9,23.88888888888889,71.66666666666667,1075,17.916666666666668,3000000000,167.44186046511626
507,8,3,11,46.09090909090909,169,2535,42.25,3000000000,71.0059171597633
377,6,5,11,34.27272727272727,75.4,1885,31.416666666666668,5000000000,159.15119363395226
782,13,3,16,48.875,260.6666666666667,3910,65.16666666666667,3000000000,46.03580562659846
546,8,3,11,49.63636363636363,182,2730,45.5,3000000000,65.93406593406593
563,10,3,13,43.30769230769231,187.66666666666666,2815,46.916666666666664,3000000000,63.94316163410302
763,13,3,16,47.6875,254.33333333333334,3815,63.583333333333336,3000000000,47.18217562254259
556,12,8,20,27.8,69.5,2780,46.333333333333336,8000000000,172.6618705035971
428,4,3,7,61.142857142857146,142.66666666666666,2140,35.666666666666664,3000000000,84.11214953271029
677,11,5,16,42.3125,135.4,3385,56.416666666666664,5000000000,88.62629246676515
738,14,3,17,43.411764705882355,246,3690,61.5,3000000000,48.78048780487805
456,5,3,8,57,152,2280,38,3000000000,78.94736842105263
968,14,7,21,46.095238095238095,138.28571428571428,4840,80.66666666666667,7000000000,86.77685950413223
600,6,6,12,50,100,3000,50,6000000000,120
666,7,3,10,66.6,222,3330,55.5,3000000000,54.05405405405405
1080,17,3,20,54,360,5400,90,3000000000,33.33333333333333
458,11,3,14,32.714285714285715,152.66666666666666,2290,38.166666666666664,3000000000,78.60262008733625
531,9,5,14,37.92857142857143,106.2,2655,44.25,5000000000,112.99435028248587
414,10,3,13,31.846153846153847,138,2070,34.5,3000000000,86.95652173913044
490,7,3,10,49,163.33333333333334,2450,40.833333333333336,3000000000,73.46938775510203
338,6,3,9,37.55555555555556,112.66666666666667,1690,28.166666666666668,3000000000,106.50887573964496
683,10,5,15,45.53333333333333,136.6,3415,56.916666666666664,5000000000,87.84773060029283
320,6,4,10,32,80,1600,26.666666666666668,4000000000,150
634,6,3,9,70.44444444444444,211.33333333333334,3170,52.833333333333336,3000000000,56.78233438485804
410,4,4,8,51.25,102.5,2050,34.166666666666664,4000000000,117.07317073170732
394,8,4,12,32.833333333333336,98.5,1970,32.833333333333336,4000000000,121.82741116751268
512,16,4,20,25.6,128,2560,42.666666666666664,4000000000,93.75
483,9,3,12,40.25,161,2415,40.25,3000000000,74.53416149068323
715,15,3,18,39.72222222222222,238.33333333333334,3575,59.583333333333336,3000000000,50.34965034965035
602,11,5,16,37.625,120.4,3010,50.166666666666664,5000000000,99.66777408637874
588,8,3,11,53.45454545454545,196,2940,49,3000000000,61.224489795918366
936,11,6,17,55.05882352941177,156,4680,78,6000000000,76.92307692307693
1048,16,6,22,47.63636363636363,174.66666666666666,5240,87.33333333333333,6000000000,68.70229007633587
630,11,4,15,42,157.5,3150,52.5,4000000000,76.19047619047619
776,10,3,13,59.69230769230769,258.6666666666667,3880,64.66666666666667,3000000000,46.391752577319586
432,8,3,11,39.27272727272727,144,2160,36,3000000000,83.33333333333333
471,5,3,8,58.875,157,2355,39.25,3000000000,76.43312101910828
504,8,3,11,45.81818181818182,168,2520,42,3000000000,71.42857142857143
954,18,3,21,45.42857142857143,318,4770,79.5,3000000000,37.735849056603776
757,10,3,13,58.23076923076923,252.33333333333334,3785,63.083333333333336,3000000000,47.556142668428
283,6,3,9,31.444444444444443,94.33333333333333,1415,23.583333333333332,3000000000,127.20848056537103
452,9,4,13,34.76923076923077,113,2260,37.666666666666664,4000000000,106.19469026548673
910,14,4,18,50.55555555555556,227.5,4550,75.83333333333333,4000000000,52.747252747252745
394,8,4,12,32.833333333333336,98.5,1970,32.833333333333336,4000000000,121.82741116751268
232,4,3,7,33.142857142857146,77.33333333333333,1160,19.333333333333332,3000000000,155.17241379310346
686,7,3,10,68.6,228.66666666666666,3430,57.166666666666664,3000000000,52.478134110787174
619,5,9,14,44.214285714285715,68.77777777777777,3095,51.583333333333336,9000000000,174.47495961227787
657,5,3,8,82.125,219,3285,54.75,3000000000,54.79452054794521
332,4,4,8,41.5,83,1660,27.666666666666668,4000000000,144.57831325301203
853,12,3,15,56.86666666666667,284.3333333333333,4265,71.08333333333333,3000000000,42.20398593200469
738,17,10,27,27.333333333333332,73.8,3690,61.5,10000000000,162.60162601626018
802,12,3,15,53.46666666666667,267.3333333333333,4010,66.83333333333333,3000000000,44.887780548628434
498,10,3,13,38.30769230769231,166,2490,41.5,3000000000,72.28915662650603
678,9,3,12,56.5,226,3390,56.5,3000000000,53.097345132743364
1042,25,6,31,33.61290322580645,173.66666666666666,5210,86.83333333333333,6000000000,69.0978886756238
520,10,3,13,40,173.33333333333334,2600,43.333333333333336,3000000000,69.23076923076923
572,7,5,12,47.666666666666664,114.4,2860,47.666666666666664,5000000000,104.8951048951049
1009,24,12,36,28.02777777777778,84.08333333333333,5045,84.08333333333333,12000000000,142.7155599603568
262,9,3,12,21.833333333333332,87.33333333333333,1310,21.833333333333332,3000000000,137.40458015267174
387,10,5,15,25.8,77.4,1935,32.25,5000000000,155.03875968992247
666,11,3,14,47.57142857142857,222,3330,55.5,3000000000,54.05405405405405
274,4,5,9,30.444444444444443,54.8,1370,22.833333333333332,5000000000,218.97810218978103
730,18,3,21,34.76190476190476,243.33333333333334,3650,60.833333333333336,3000000000,49.31506849315068
604,15,3,18,33.55555555555556,201.33333333333334,3020,50.333333333333336,3000000000,59.602649006622514
745,16,3,19,39.21052631578947,248.33333333333334,3725,62.083333333333336,3000000000,48.32214765100671
589,5,3,8,73.625,196.33333333333334,2945,49.083333333333336,3000000000,61.120543293718164
502,8,5,13,38.61538461538461,100.4,2510,41.833333333333336,5000000000,119.5219123505976
269,5,3,8,33.625,89.66666666666667,1345,22.416666666666668,3000000000,133.82899628252787
587,12,4,16,36.6875,146.75,2935,48.916666666666664,4000000000,81.77172061328791
514,8,4,12,42.833333333333336,128.5,2570,42.833333333333336,4000000000,93.3852140077821
866,13,5,18,48.111111111111114,173.2,4330,72.16666666666667,5000000000,69.284064665127
639,10,3,13,49.15384615384615,213,3195,53.25,3000000000,56.33802816901408
522,6,3,9,58,174,2610,43.5,3000000000,68.9655172413793
387,6,9,15,25.8,43,1935,32.25,9000000000,279.06976744186045
566,17,3,20,28.3,188.66666666666666,2830,47.166666666666664,3000000000,63.60424028268552
387,7,3,10,38.7,129,1935,32.25,3000000000,93.02325581395348
479,6,3,9,53.22222222222222,159.66666666666666,2395,39.916666666666664,3000000000,75.15657620041755
364,5,3,8,45.5,121.33333333333333,1820,30.333333333333332,3000000000,98.9010989010989
428,4,4,8,53.5,107,2140,35.666666666666664,4000000000,112.14953271028038
580,12,3,15,38.666666666666664,193.33333333333334,2900,48.333333333333336,3000000000,62.068965517241374
1094,14,13,27,40.51851851851852,84.15384615384616,5470,91.16666666666667,13000000000,142.5959780621572
758,12,9,21,36.095238095238095,84.22222222222223,3790,63.166666666666664,9000000000,142.4802110817942
486,11,3,14,34.714285714285715,162,2430,40.5,3000000000,74.07407407407408
471,9,3,12,39.25,157,2355,39.25,3000000000,76.43312101910828
736,12,11,23,32,66.9090909090909,3680,61.333333333333336,11000000000,179.3478260869565
311,4,4,8,38.875,77.75,1555,25.916666666666668,4000000000,154.34083601286173
395,8,3,11,35.90909090909091,131.66666666666666,1975,32.916666666666664,3000000000,91.13924050632912
1004,17,6,23,43.65217391304348,167.33333333333334,5020,83.66666666666667,6000000000,71.71314741035856
286,5,3,8,35.75,95.33333333333333,1430,23.833333333333332,3000000000,125.87412587412588
684,13,5,18,38,136.8,3420,57,5000000000,87.71929824561404
617,13,7,20,30.85,88.14285714285714,3085,51.416666666666664,7000000000,136.1426256077796
424,8,5,13,32.61538461538461,84.8,2120,35.333333333333336,5000000000,141.50943396226415
575,9,3,12,47.916666666666664,191.66666666666666,2875,47.916666666666664,3000000000,62.608695652173914
820,13,5,18,45.55555555555556,164,4100,68.33333333333333,5000000000,73.17073170731709
1219,21,8,29,42.03448275862069,152.375,6095,101.58333333333333,8000000000,78.75307629204266
667,8,5,13,51.30769230769231,133.4,3335,55.583333333333336,5000000000,89.95502248875562
504,6,3,9,56,168,2520,42,3000000000,71.42857142857143
588,13,3,16,36.75,196,2940,49,3000000000,61.224489795918366
504,12,3,15,33.6,168,2520,42,3000000000,71.42857142857143
445,5,4,9,49.44444444444444,111.25,2225,37.083333333333336,4000000000,107.86516853932584
749,14,3,17,44.05882352941177,249.66666666666666,3745,62.416666666666664,3000000000,48.06408544726302
323,7,3,10,32.3,107.66666666666667,1615,26.916666666666668,3000000000,111.45510835913312
1074,15,9,24,44.75,119.33333333333333,5370,89.5,9000000000,100.55865921787709
532,8,3,11,48.36363636363637,177.33333333333334,2660,44.333333333333336,3000000000,67.66917293233082
505,5,3,8,63.125,168.33333333333334,2525,42.083333333333336,3000000000,71.28712871287128
725,13,5,18,40.27777777777778,145,3625,60.416666666666664,5000000000,82.75862068965517
471,5,3,8,58.875,157,2355,39.25,3000000000,76.43312101910828
358,7,3,10,35.8,119.33333333333333,1790,29.833333333333332,3000000000,100.5586592178771
544,9,3,12,45.333333333333336,181.33333333333334,2720,45.333333333333336,3000000000,66.17647058823529
651,6,4,10,65.1,162.75,3255,54.25,4000000000,73.73271889400922
345,5,4,9,38.333333333333336,86.25,1725,28.75,4000000000,139.1304347826087
312,5,3,8,39,104,1560,26,3000000000,115.38461538461539
425,3,3,6,70.83333333333333,141.66666666666666,2125,35.416666666666664,3000000000,84.70588235294119
560,10,3,13,43.07692307692308,186.66666666666666,2800,46.666666666666664,3000000000,64.28571428571429
272,7,3,10,27.2,90.66666666666667,1360,22.666666666666668,3000000000,132.35294117647058
535,8,3,11,48.63636363636363,178.33333333333334,2675,44.583333333333336,3000000000,67.28971962616822
328,6,3,9,36.44444444444444,109.33333333333333,1640,27.333333333333332,3000000000,109.7560975609756
1031,13,7,20,51.55,147.28571428571428,5155,85.91666666666667,7000000000,81.47429679922405
432,8,3,11,39.27272727272727,144,2160,36,3000000000,83.33333333333333
336,4,3,7,48,112,1680,28,3000000000,107.14285714285715
1011,16,3,19,53.21052631578947,337,5055,84.25,3000000000,35.60830860534125
238,4,3,7,34,79.33333333333333,1190,19.833333333333332,3000000000,151.2605042016807
423,6,3,9,47,141,2115,35.25,3000000000,85.1063829787234
605,11,3,14,43.214285714285715,201.66666666666666,3025,50.416666666666664,3000000000,59.50413223140496
642,11,4,15,42.8,160.5,3210,53.5,4000000000,74.76635514018692
991,25,3,28,35.392857142857146,330.3333333333333,4955,82.58333333333333,3000000000,36.326942482341074
829,8,10,18,46.05555555555556,82.9,4145,69.08333333333333,10000000000,144.75271411338963
612,12,3,15,40.8,204,3060,51,3000000000,58.8235294117647
530,11,3,14,37.857142857142854,176.66666666666666,2650,44.166666666666664,3000000000,67.9245283018868
701,14,4,18,38.94444444444444,175.25,3505,58.416666666666664,4000000000,68.47360912981455
1023,10,3,13,78.6923076923077,341,5115,85.25,3000000000,35.19061583577712
834,12,9,21,39.714285714285715,92.66666666666667,4170,69.5,9000000000,129.49640287769785
764,9,4,13,58.76923076923077,191,3820,63.666666666666664,4000000000,62.827225130890056
594,9,4,13,45.69230769230769,148.5,2970,49.5,4000000000,80.8080808080808
446,8,3,11,40.54545454545455,148.66666666666666,2230,37.166666666666664,3000000000,80.71748878923768
653,6,3,9,72.55555555555556,217.66666666666666,3265,54.416666666666664,3000000000,55.1301684532925
319,7,4,11,29,79.75,1595,26.583333333333332,4000000000,150.47021943573668
585,9,3,12,48.75,195,2925,48.75,3000000000,61.53846153846153
728,9,7,16,45.5,104,3640,60.666666666666664,7000000000,115.38461538461539
929,12,3,15,61.93333333333333,309.6666666666667,4645,77.41666666666667,3000000000,38.751345532830996
324,7,6,13,24.923076923076923,54,1620,27,6000000000,222.2222222222222
806,12,3,15,53.733333333333334,268.6666666666667,4030,67.16666666666667,3000000000,44.66501240694789
586,11,4,15,39.06666666666667,146.5,2930,48.833333333333336,4000000000,81.91126279863481
819,8,4,12,68.25,204.75,4095,68.25,4000000000,58.608058608058606
465,8,3,11,42.27272727272727,155,2325,38.75,3000000000,77.41935483870968
429,10,3,13,33,143,2145,35.75,3000000000,83.91608391608392
681,15,3,18,37.833333333333336,227,3405,56.75,3000000000,52.86343612334802
218,6,3,9,24.22222222222222,72.66666666666667,1090,18.166666666666668,3000000000,165.13761467889907
692,8,7,15,46.13333333333333,98.85714285714286,3460,57.666666666666664,7000000000,121.38728323699422
533,6,3,9,59.22222222222222,177.66666666666666,2665,44.416666666666664,3000000000,67.5422138836773
821,8,4,12,68.41666666666667,205.25,4105,68.41666666666667,4000000000,58.465286236297196
514,10,4,14,36.714285714285715,128.5,2570,42.833333333333336,4000000000,93.3852140077821
415,8,5,13,31.923076923076923,83,2075,34.583333333333336,5000000000,144.57831325301203
519,5,3,8,64.875,173,2595,43.25,3000000000,69.36416184971098
384,7,3,10,38.4,128,1920,32,3000000000,93.75
678,12,3,15,45.2,226,3390,56.5,3000000000,53.097345132743364
585,9,3,12,48.75,195,2925,48.75,3000000000,61.53846153846153
551,9,3,12,45.916666666666664,183.66666666666666,2755,45.916666666666664,3000000000,65.33575317604357
643,5,3,8,80.375,214.33333333333334,3215,53.583333333333336,3000000000,55.987558320373246
973,16,3,19,51.21052631578947,324.3333333333333,4865,81.08333333333333,3000000000,36.99897225077081
807,10,4,14,57.642857142857146,201.75,4035,67.25,4000000000,59.479553903345725
867,8,4,12,72.25,216.75,4335,72.25,4000000000,55.363321799307954
1072,25,3,28,38.285714285714285,357.3333333333333,5360,89.33333333333333,3000000000,33.582089552238806
992,9,7,16,62,141.71428571428572,4960,82.66666666666667,7000000000,84.6774193548387
369,5,3,8,46.125,123,1845,30.75,3000000000,97.5609756097561
1716,30,3,33,52,572,8580,143,3000000000,20.97902097902098
846,14,6,20,42.3,141,4230,70.5,6000000000,85.1063829787234
680,15,3,18,37.77777777777778,226.66666666666666,3400,56.666666666666664,3000000000,52.94117647058824
342,4,3,7,48.857142857142854,114,1710,28.5,3000000000,105.26315789473684
1086,16,3,19,57.1578947368421,362,5430,90.5,3000000000,33.149171270718234
487,13,4,17,28.647058823529413,121.75,2435,40.583333333333336,4000000000,98.56262833675565
425,9,3,12,35.416666666666664,141.66666666666666,2125,35.416666666666664,3000000000,84.70588235294119
659,13,3,16,41.1875,219.66666666666666,3295,54.916666666666664,3000000000,54.628224582701066
759,10,3,13,58.38461538461539,253,3795,63.25,3000000000,47.430830039525695
978,15,3,18,54.333333333333336,326,4890,81.5,3000000000,36.809815950920246
490,11,4,15,32.666666666666664,122.5,2450,40.833333333333336,4000000000,97.95918367346938
750,17,7,24,31.25,107.14285714285714,3750,62.5,7000000000,112
682,11,3,14,48.714285714285715,227.33333333333334,3410,56.833333333333336,3000000000,52.785923753665685
655,8,7,15,43.666666666666664,93.57142857142857,3275,54.583333333333336,7000000000,128.24427480916032
600,11,5,16,37.5,120,3000,50,5000000000,100
537,9,3,12,44.75,179,2685,44.75,3000000000,67.0391061452514
1107,17,6,23,48.130434782608695,184.5,5535,92.25,6000000000,65.04065040650407
495,6,3,9,55,165,2475,41.25,3000000000,72.72727272727273
546,6,3,9,60.666666666666664,182,2730,45.5,3000000000,65.93406593406593
907,12,7,19,47.73684210526316,129.57142857142858,4535,75.58333333333333,7000000000,92.613009922822485
413,13,3,16,25.8125,137.66666666666666,2065,34.416666666666664,3000000000,87.16707021791768
876,20,3,23,38.08695652173913,292,4380,73,3000000000,41.0958904109589
725,15,3,18,40.27777777777778,241.66666666666666,3625,60.416666666666664,3000000000,49.6551724137931
944,11,3,14,67.42857142857143,314.6666666666667,4720,78.66666666666667,3000000000,38.135593220338976
448,10,3,13,34.46153846153846,149.33333333333334,2240,37.333333333333336,3000000000,80.35714285714285
396,6,3,9,44,132,1980,33,3000000000,90.9090909090909
1654,31,10,41,40.34146341463415,165.4,8270,137.83333333333334,10000000000,72.55139056831922
595,4,4,8,74.375,148.75,2975,49.583333333333336,4000000000,80.67226890756302
732,18,3,21,34.857142857142854,244,3660,61,3000000000,49.18032786885246
522,5,3,8,65.25,174,2610,43.5,3000000000,68.9655172413793
745,12,3,15,49.666666666666664,248.33333333333334,3725,62.083333333333336,3000000000,48.32214765100671
353,9,3,12,29.416666666666668,117.66666666666667,1765,29.416666666666668,3000000000,101.98300283286119
508,8,3,11,46.18181818181818,169.33333333333334,2540,42.333333333333336,3000000000,70.86614173228345
833,10,6,16,52.0625,138.83333333333334,4165,69.41666666666667,6000000000,86.4345738295318
681,10,3,13,52.38461538461539,227,3405,56.75,3000000000,52.86343612334802
300,4,3,7,42.857142857142854,100,1500,25,3000000000,120
624,12,3,15,41.6,208,3120,52,3000000000,57.69230769230769
186,3,3,6,31,62,930,15.5,3000000000,193.54838709677418
393,10,3,13,30.23076923076923,131,1965,32.75,3000000000,91.6030534351145
473,11,3,14,33.785714285714285,157.66666666666666,2365,39.416666666666664,3000000000,76.10993657505286
743,11,7,18,41.27777777777778,106.14285714285714,3715,61.916666666666664,7000000000,113.05518169582773
451,5,4,9,50.111111111111114,112.75,2255,37.583333333333336,4000000000,106.43015521064301
813,9,3,12,67.75,271,4065,67.75,3000000000,44.28044280442804
607,9,3,12,50.583333333333336,202.33333333333334,3035,50.583333333333336,3000000000,59.308072487644154
530,9,4,13,40.76923076923077,132.5,2650,44.166666666666664,4000000000,90.56603773584906
596,9,3,12,49.666666666666664,198.66666666666666,2980,49.666666666666664,3000000000,60.4026845637584
533,8,5,13,41,106.6,2665,44.416666666666664,5000000000,112.5703564727955
616,12,3,15,41.06666666666667,205.33333333333334,3080,51.333333333333336,3000000000,58.441558441558435
569,7,3,10,56.9,189.66666666666666,2845,47.416666666666664,3000000000,63.26889279437611
420,4,4,8,52.5,105,2100,35,4000000000,114.28571428571428
730,8,7,15,48.666666666666664,104.28571428571429,3650,60.833333333333336,7000000000,115.06849315068493
310,9,3,12,25.833333333333332,103.33333333333333,1550,25.833333333333332,3000000000,116.12903225806453
865,15,3,18,48.05555555555556,288.3333333333333,4325,72.08333333333333,3000000000,41.61849710982659
555,6,5,11,50.45454545454545,111,2775,46.25,5000000000,108.1081081081081
901,12,4,16,56.3125,225.25,4505,75.08333333333333,4000000000,53.274139844617096
442,9,3,12,36.833333333333336,147.33333333333334,2210,36.833333333333336,3000000000,81.44796380090497
595,10,8,18,33.05555555555556,74.375,2975,49.583333333333336,8000000000,161.34453781512605
809,20,3,23,35.17391304347826,269.6666666666667,4045,67.41666666666667,3000000000,44.499381953028426
413,11,5,16,25.8125,82.6,2065,34.416666666666664,5000000000,145.27845036319613
721,10,5,15,48.06666666666667,144.2,3605,60.083333333333336,5000000000,83.21775312066575
857,10,3,13,65.92307692307692,285.6666666666667,4285,71.41666666666667,3000000000,42.00700116686114
334,9,3,12,27.833333333333332,111.33333333333333,1670,27.833333333333332,3000000000,107.78443113772455
430,4,5,9,47.77777777777778,86,2150,35.833333333333336,5000000000,139.53488372093022
435,7,3,10,43.5,145,2175,36.25,3000000000,82.75862068965517
599,13,4,17,35.23529411764706,149.75,2995,49.916666666666664,4000000000,80.13355592654425
591,10,3,13,45.46153846153846,197,2955,49.25,3000000000,60.91370558375634
594,8,3,11,54,198,2970,49.5,3000000000,60.60606060606061
902,17,5,22,41,180.4,4510,75.16666666666667,5000000000,66.51884700665188
666,13,3,16,41.625,222,3330,55.5,3000000000,54.05405405405405
881,9,3,12,73.41666666666667,293.6666666666667,4405,73.41666666666667,3000000000,40.86265607264472
562,11,5,16,35.125,112.4,2810,46.833333333333336,5000000000,106.76156583629893
585,12,3,15,39,195,2925,48.75,3000000000,61.53846153846153
550,8,4,12,45.833333333333336,137.5,2750,45.833333333333336,4000000000,87.27272727272727
739,8,3,11,67.18181818181819,246.33333333333334,3695,61.583333333333336,3000000000,48.71447902571042
502,13,3,16,31.375,167.33333333333334,2510,41.833333333333336,3000000000,71.71314741035856
392,4,5,9,43.55555555555556,78.4,1960,32.666666666666664,5000000000,153.06122448979593
221,5,3,8,27.625,73.66666666666667,1105,18.416666666666668,3000000000,162.89592760180994
452,5,6,11,41.09090909090909,75.33333333333333,2260,37.666666666666664,6000000000,159.2920353982301
509,5,3,8,63.625,169.66666666666666,2545,42.416666666666664,3000000000,70.7269155206287
1162,18,3,21,55.333333333333336,387.3333333333333,5810,96.83333333333333,3000000000,30.98106712564544
378,4,3,7,54,126,1890,31.5,3000000000,95.23809523809524
664,12,5,17,39.05882352941177,132.8,3320,55.333333333333336,5000000000,90.36144578313252
483,10,4,14,34.5,120.75,2415,40.25,4000000000,99.37888198757764
487,11,3,14,34.785714285714285,162.33333333333334,2435,40.583333333333336,3000000000,73.92197125256672
439,6,3,9,48.77777777777778,146.33333333333334,2195,36.583333333333336,3000000000,82.00455580865604
374,6,3,9,41.55555555555556,124.66666666666667,1870,31.166666666666668,3000000000,96.2566844919786
545,6,3,9,60.55555555555556,181.66666666666666,2725,45.416666666666664,3000000000,66.05504587155963
720,7,3,10,72,240,3600,60,3000000000,50
1001,15,5,20,50.05,200.2,5005,83.41666666666667,5000000000,59.94005994005994
518,7,5,12,43.166666666666664,103.6,2590,43.166666666666664,5000000000,115.83011583011584
590,9,3,12,49.166666666666664,196.66666666666666,2950,49.166666666666664,3000000000,61.016949152542374
770,9,4,13,59.23076923076923,192.5,3850,64.16666666666667,4000000000,62.33766233766233
670,15,3,18,37.22222222222222,223.33333333333334,3350,55.833333333333336,3000000000,53.731343283582085
361,5,3,8,45.125,120.33333333333333,1805,30.083333333333332,3000000000,99.7229916897507
685,13,3,16,42.8125,228.33333333333334,3425,57.083333333333336,3000000000,52.55474452554744
533,11,4,15,35.53333333333333,133.25,2665,44.416666666666664,4000000000,90.0562851782364
710,9,3,12,59.166666666666664,236.66666666666666,3550,59.166666666666664,3000000000,50.70422535211268
652,10,3,13,50.15384615384615,217.33333333333334,3260,54.333333333333336,3000000000,55.214723926380366
873,12,3,15,58.2,291,4365,72.75,3000000000,41.23711340206186
449,6,3,9,49.888888888888886,149.66666666666666,2245,37.416666666666664,3000000000,80.1781737193764
849,16,3,19,44.68421052631579,283,4245,70.75,3000000000,42.40282685512368
828,12,3,15,55.2,276,4140,69,3000000000,43.47826086956522
1217,25,12,37,32.891891891891895,101.41666666666667,6085,101.41666666666667,12000000000,118.32374691865242
640,24,3,27,23.703703703703702,213.33333333333334,3200,53.333333333333336,3000000000,56.25
1323,19,8,27,49,165.375,6615,110.25,8000000000,72.56235827664399
372,7,3,10,37.2,124,1860,31,3000000000,96.77419354838709
741,11,3,14,52.92857142857143,247,3705,61.75,3000000000,48.582995951417004
579,10,3,13,44.53846153846154,193,2895,48.25,3000000000,62.17616580310881
561,8,3,11,51,187,2805,46.75,3000000000,64.171122994652407
894,14,10,24,37.25,89.4,4470,74.5,10000000000,134.2281879194631
975,13,8,21,46.42857142857143,121.875,4875,81.25,8000000000,98.46153846153847
237,3,4,7,33.857142857142854,59.25,1185,19.75,4000000000,202.53164556962025
856,12,10,22,38.90909090909091,85.6,4280,71.33333333333333,10000000000,140.18691588785046
991,15,3,18,55.05555555555556,330.3333333333333,4955,82.58333333333333,3000000000,36.326942482341074
682,20,3,23,29.652173913043477,227.33333333333334,3410,56.833333333333336,3000000000,52.785923753665685
503,6,3,9,55.888888888888886,167.66666666666666,2515,41.916666666666664,3000000000,71.57057654075547
876,17,3,20,43.8,292,4380,73,3000000000,41.0958904109589
291,4,6,10,29.1,48.5,1455,24.25,6000000000,247.42268041237114
1577,13,3,16,98.5625,525.6666666666666,7885,131.41666666666666,3000000000,22.8281547241598
545,15,3,18,30.27777777777778,181.66666666666666,2725,45.416666666666664,3000000000,66.05504587155963
717,11,8,19,37.73684210526316,89.625,3585,59.75,8000000000,133.89121338912133
562,16,3,19,29.57894736842105,187.33333333333334,2810,46.833333333333336,3000000000,64.05693950177935
719,8,7,15,47.93333333333333,102.71428571428571,3595,59.916666666666664,7000000000,116.8289290681502
963,12,4,16,60.1875,240.75,4815,80.25,4000000000,49.84423676012461
1431,23,9,32,44.71875,159,7155,119.25,9000000000,75.47169811320755
699,10,4,14,49.92857142857143,174.75,3495,58.25,4000000000,68.6695278969957
958,10,3,13,73.6923076923077,319.3333333333333,4790,79.83333333333333,3000000000,37.57828810020877
418,8,3,11,38,139.33333333333334,2090,34.833333333333336,3000000000,86.1244019138756
427,5,3,8,53.375,142.33333333333334,2135,35.583333333333336,3000000000,84.30913348946135
426,8,3,11,38.72727272727273,142,2130,35.5,3000000000,84.50704225352113
743,15,3,18,41.27777777777778,247.66666666666666,3715,61.916666666666664,3000000000,48.45222072678331
797,16,4,20,39.85,199.25,3985,66.41666666666667,4000000000,60.2258469259724
423,6,6,12,35.25,70.5,2115,35.25,6000000000,170.2127659574468
558,7,9,16,34.875,62,2790,46.5,9000000000,193.54838709677418
1003,14,3,17,59,334.3333333333333,5015,83.58333333333333,3000000000,35.89232303090728
810,10,3,13,62.30769230769231,270,4050,67.5,3000000000,44.44444444444445
477,10,3,13,36.69230769230769,159,2385,39.75,3000000000,75.47169811320755
692,20,3,23,30.08695652173913,230.66666666666666,3460,57.666666666666664,3000000000,52.02312138728323
482,6,3,9,53.55555555555556,160.66666666666666,2410,40.166666666666664,3000000000,74.68879668049793
939,9,3,12,78.25,313,4695,78.25,3000000000,38.33865814696485
227,4,3,7,32.42857142857143,75.66666666666667,1135,18.916666666666668,3000000000,158.59030837004406
638,7,7,14,45.57142857142857,91.14285714285714,3190,53.166666666666664,7000000000,131.6614420062696
810,10,4,14,57.857142857142854,202.5,4050,67.5,4000000000,59.25925925925926
594,5,3,8,74.25,198,2970,49.5,3000000000,60.60606060606061
659,15,9,24,27.458333333333332,73.22222222222223,3295,54.916666666666664,9000000000,163.8846737481032
627,7,4,11,57,156.75,3135,52.25,4000000000,76.55502392344498
1204,20,11,31,38.83870967741935,109.45454545454545,6020,100.33333333333333,11000000000,109.63455149501662
329,6,3,9,36.55555555555556,109.66666666666667,1645,27.416666666666668,3000000000,109.4224924012158
532,9,3,12,44.333333333333336,177.33333333333334,2660,44.333333333333336,3000000000,67.66917293233082
829,13,5,18,46.05555555555556,165.8,4145,69.08333333333333,5000000000,72.37635705669481
1064,15,8,23,46.26086956521739,133,5320,88.66666666666667,8000000000,90.22556390977444
285,3,3,6,47.5,95,1425,23.75,3000000000,126.3157894736842
1118,23,3,26,43,372.6666666666667,5590,93.16666666666667,3000000000,32.200357781753134
674,7,5,12,56.166666666666664,134.8,3370,56.166666666666664,5000000000,89.02077151335313
595,5,8,13,45.76923076923077,74.375,2975,49.583333333333336,8000000000,161.34453781512605
673,13,4,17,39.588235294117645,168.25,3365,56.083333333333336,4000000000,71.3224368499257
578,15,3,18,32.111111111111114,192.66666666666666,2890,48.166666666666664,3000000000,62.28373702422146
287,4,3,7,41,95.66666666666667,1435,23.916666666666668,3000000000,125.4355400696864
484,4,3,7,69.14285714285714,161.33333333333334,2420,40.333333333333336,3000000000,74.3801652892562
301,11,4,15,20.066666666666666,75.25,1505,25.083333333333332,4000000000,159.468438538206
484,9,3,12,40.333333333333336,161.33333333333334,2420,40.333333333333336,3000000000,74.3801652892562
911,16,5,21,43.38095238095238,182.2,4555,75.91666666666667,5000000000,65.86169045005488
523,9,5,14,37.357142857142854,104.6,2615,43.583333333333336,5000000000,114.72275334608031
731,12,6,18,40.611111111111114,121.83333333333333,3655,60.916666666666664,6000000000,98.4952120383037
206,3,4,7,29.428571428571427,51.5,1030,17.166666666666668,4000000000,233.00970873786406
560,9,3,12,46.666666666666664,186.66666666666666,2800,46.666666666666664,3000000000,64.28571428571429
507,8,6,14,36.214285714285715,84.5,2535,42.25,6000000000,142.0118343195266
332,3,3,6,55.333333333333336,110.66666666666667,1660,27.666666666666668,3000000000,108.43373493975903
468,6,5,11,42.54545454545455,93.6,2340,39,5000000000,128.2051282051282
623,6,3,9,69.22222222222223,207.66666666666666,3115,51.916666666666664,3000000000,57.784911717495994
796,10,5,15,53.06666666666667,159.2,3980,66.33333333333333,5000000000,75.37688442211056
557,8,8,16,34.8125,69.625,2785,46.416666666666664,8000000000,172.35188509874328
702,7,3,10,70.2,234,3510,58.5,3000000000,51.28205128205128
289,6,3,9,32.111111111111114,96.33333333333333,1445,24.083333333333332,3000000000,124.56747404844292
442,9,3,12,36.833333333333336,147.33333333333334,2210,36.833333333333336,3000000000,81.44796380090497
1052,11,6,17,61.88235294117647,175.33333333333334,5260,87.66666666666667,6000000000,68.44106463878326
436,7,3,10,43.6,145.33333333333334,2180,36.333333333333336,3000000000,82.56880733944953
620,10,7,17,36.470588235294116,88.57142857142857,3100,51.666666666666664,7000000000,135.48387096774195
571,9,3,12,47.583333333333336,190.33333333333334,2855,47.583333333333336,3000000000,63.047285464098074
504,8,4,12,42,126,2520,42,4000000000,95.23809523809524
1000,16,3,19,52.63157894736842,333.3333333333333,5000,83.33333333333333,3000000000,36
1075,17,3,20,53.75,358.3333333333333,5375,89.58333333333333,3000000000,33.48837209302326
531,4,4,8,66.375,132.75,2655,44.25,4000000000,90.3954802259887
863,11,5,16,53.9375,172.6,4315,71.91666666666667,5000000000,69.52491309385863
200,3,3,6,33.333333333333336,66.66666666666667,1000,16.666666666666668,3000000000,180
655,18,5,23,28.47826086956522,131,3275,54.583333333333336,5000000000,91.6030534351145
656,6,3,9,72.88888888888889,218.66666666666666,3280,54.666666666666664,3000000000,54.8780487804878
428,11,3,14,30.571428571428573,142.66666666666666,2140,35.666666666666664,3000000000,84.11214953271029
789,7,9,16,49.3125,87.66666666666667,3945,65.75,9000000000,136.88212927756655
871,16,3,19,45.8421052631579,290.3333333333333,4355,72.58333333333333,3000000000,41.33180252583238
289,4,3,7,41.285714285714285,96.33333333333333,1445,24.083333333333332,3000000000,124.56747404844292
951,10,3,13,73.15384615384616,317,4755,79.25,3000000000,37.85488958990537
997,13,7,20,49.85,142.42857142857142,4985,83.08333333333333,7000000000,84.25275827482449
589,12,3,15,39.266666666666666,196.33333333333334,2945,49.083333333333336,3000000000,61.120543293718164
623,9,3,12,51.916666666666664,207.66666666666666,3115,51.916666666666664,3000000000,57.784911717495994
698,13,3,16,43.625,232.66666666666666,3490,58.166666666666664,3000000000,51.5759312320917
781,10,3,13,60.07692307692308,260.3333333333333,3905,65.08333333333333,3000000000,46.09475032010244
765,12,6,18,42.5,127.5,3825,63.75,6000000000,94.11764705882352
851,17,3,20,42.55,283.6666666666667,4255,70.91666666666667,3000000000,42.30317273795535
798,13,3,16,49.875,266,3990,66.5,3000000000,45.11278195488722
361,4,5,9,40.111111111111114,72.2,1805,30.083333333333332,5000000000,166.2049861495845
598,10,3,13,46,199.33333333333334,2990,49.833333333333336,3000000000,60.20066889632107
1256,15,11,26,48.30769230769231,114.18181818181819,6280,104.66666666666667,11000000000,105.09554140127388
791,9,3,12,65.91666666666667,263.6666666666667,3955,65.91666666666667,3000000000,45.51201011378002
1179,15,10,25,47.16,117.9,5895,98.25,10000000000,101.78117048346056
307,5,3,8,38.375,102.33333333333333,1535,25.583333333333332,3000000000,117.26384364820846
501,6,3,9,55.666666666666664,167,2505,41.75,3000000000,71.85628742514969
549,5,5,10,54.9,109.8,2745,45.75,5000000000,109.2896174863388
233,9,3,12,19.416666666666668,77.66666666666667,1165,19.416666666666668,3000000000,154.50643776824035
1321,24,11,35,37.74285714285714,120.0909090909091,6605,110.08333333333333,11000000000,99.92429977289933
878,12,3,15,58.53333333333333,292.6666666666667,4390,73.16666666666667,3000000000,41.00227790432802
522,13,4,17,30.705882352941178,130.5,2610,43.5,4000000000,91.95402298850576
432,4,5,9,48,86.4,2160,36,5000000000,138.88888888888889
590,8,3,11,53.63636363636363,196.66666666666666,2950,49.166666666666664,3000000000,61.016949152542374
244,4,3,7,34.857142857142854,81.33333333333333,1220,20.333333333333332,3000000000,147.5409836065574
837,13,5,18,46.5,167.4,4185,69.75,5000000000,71.68458781362007
665,10,4,14,47.5,166.25,3325,55.416666666666664,4000000000,72.18045112781955
503,11,3,14,35.92857142857143,167.66666666666666,2515,41.916666666666664,3000000000,71.57057654075547
533,8,4,12,44.416666666666664,133.25,2665,44.416666666666664,4000000000,90.0562851782364
425,12,3,15,28.333333333333332,141.66666666666666,2125,35.416666666666664,3000000000,84.70588235294119
609,9,3,12,50.75,203,3045,50.75,3000000000,59.11330049261083
407,5,3,8,50.875,135.66666666666666,2035,33.916666666666664,3000000000,88.45208845208846
515,11,3,14,36.785714285714285,171.66666666666666,2575,42.916666666666664,3000000000,69.90291262135923
358,5,4,9,39.77777777777778,89.5,1790,29.833333333333332,4000000000,134.0782122905028
710,13,3,16,44.375,236.66666666666666,3550,59.166666666666664,3000000000,50.70422535211268
382,10,3,13,29.384615384615383,127.33333333333333,1910,31.833333333333332,3000000000,94.24083769633508
593,10,3,13,45.61538461538461,197.66666666666666,2965,49.416666666666664,3000000000,60.708263069139974
839,14,3,17,49.35294117647059,279.6666666666667,4195,69.91666666666667,3000000000,42.908224076281286
444,9,3,12,37,148,2220,37,3000000000,81.08108108108108
1202,14,6,20,60.1,200.33333333333334,6010,100.16666666666667,6000000000,59.90016638935108
740,15,3,18,41.111111111111114,246.66666666666666,3700,61.666666666666664,3000000000,48.64864864864865
231,4,3,7,33,77,1155,19.25,3000000000,155.84415584415584
936,8,6,14,66.85714285714286,156,4680,78,6000000000,76.92307692307693
439,4,4,8,54.875,109.75,2195,36.583333333333336,4000000000,109.3394077448747
213,5,3,8,26.625,71,1065,17.75,3000000000,169.01408450704227
894,17,3,20,44.7,298,4470,74.5,3000000000,40.26845637583893
683,14,7,21,32.523809523809526,97.57142857142857,3415,56.916666666666664,7000000000,122.98682284040997
192,6,3,9,21.333333333333332,64,960,16,3000000000,187.5
1241,16,3,19,65.3157894736842,413.6666666666667,6205,103.41666666666667,3000000000,29.0088638195004
964,11,4,15,64.26666666666667,241,4820,80.33333333333333,4000000000,49.79253112033195
424,7,3,10,42.4,141.33333333333334,2120,35.333333333333336,3000000000,84.90566037735849
559,4,3,7,79.85714285714286,186.33333333333334,2795,46.583333333333336,3000000000,64.40071556350627
379,6,3,9,42.111111111111114,126.33333333333333,1895,31.583333333333332,3000000000,94.9868073878628
751,9,4,13,57.76923076923077,187.75,3755,62.583333333333336,4000000000,63.91478029294274
737,13,7,20,36.85,105.28571428571429,3685,61.416666666666664,7000000000,113.97557666214382
1037,14,4,18,57.611111111111114,259.25,5185,86.41666666666667,4000000000,46.287367405978785
466,7,3,10,46.6,155.33333333333334,2330,38.833333333333336,3000000000,77.25321888412017
711,6,4,10,71.1,177.75,3555,59.25,4000000000,67.51054852320675
763,11,7,18,42.388888888888886,109,3815,63.583333333333336,7000000000,110.09174311926604
645,9,3,12,53.75,215,3225,53.75,3000000000,55.81395348837209
535,8,4,12,44.583333333333336,133.75,2675,44.583333333333336,4000000000,89.7196261682243
957,14,3,17,56.294117647058826,319,4785,79.75,3000000000,37.61755485893417
199,3,3,6,33.166666666666664,66.33333333333333,995,16.583333333333332,3000000000,180.90452261306532
604,7,3,10,60.4,201.33333333333334,3020,50.333333333333336,3000000000,59.602649006622514
997,14,10,24,41.541666666666664,99.7,4985,83.08333333333333,10000000000,120.36108324974926
444,4,3,7,63.42857142857143,148,2220,37,3000000000,81.08108108108108
587,11,3,14,41.92857142857143,195.66666666666666,2935,48.916666666666664,3000000000,61.32879045996593
1183,16,6,22,53.77272727272727,197.16666666666666,5915,98.58333333333333,6000000000,60.862214708368555
593,10,3,13,45.61538461538461,197.66666666666666,2965,49.416666666666664,3000000000,60.708263069139974
633,13,3,16,39.5625,211,3165,52.75,3000000000,56.87203791469194
529,7,3,10,52.9,176.33333333333334,2645,44.083333333333336,3000000000,68.05293005671076
819,18,3,21,39,273,4095,68.25,3000000000,43.956043956043956
524,9,3,12,43.666666666666664,174.66666666666666,2620,43.666666666666664,3000000000,68.70229007633587
1160,19,4,23,50.43478260869565,290,5800,96.66666666666667,4000000000,41.37931034482759
556,9,3,12,46.333333333333336,185.33333333333334,2780,46.333333333333336,3000000000,64.74820143884892
894,16,3,19,47.05263157894737,298,4470,74.5,3000000000,40.26845637583893
603,16,4,20,30.15,150.75,3015,50.25,4000000000,79.60199004975124
506,8,3,11,46,168.66666666666666,2530,42.166666666666664,3000000000,71.14624505928855
366,9,3,12,30.5,122,1830,30.5,3000000000,98.36065573770492
642,11,5,16,40.125,128.4,3210,53.5,5000000000,93.45794392523365
1046,11,6,17,61.529411764705884,174.33333333333334,5230,87.16666666666667,6000000000,68.83365200764818
559,13,3,16,34.9375,186.33333333333334,2795,46.583333333333336,3000000000,64.40071556350627
529,7,3,10,52.9,176.33333333333334,2645,44.083333333333336,3000000000,68.05293005671076
517,10,3,13,39.76923076923077,172.33333333333334,2585,43.083333333333336,3000000000,69.63249516441006
1454,26,3,29,50.13793103448276,484.6666666666667,7270,121.16666666666667,3000000000,24.759284731774414
868,12,8,20,43.4,108.5,4340,72.33333333333333,8000000000,110.59907834101384
956,15,3,18,53.111111111111114,318.6666666666667,4780,79.66666666666667,3000000000,37.65690376569037
320,9,4,13,24.615384615384617,80,1600,26.666666666666668,4000000000,150
661,9,3,12,55.083333333333336,220.33333333333334,3305,55.083333333333336,3000000000,54.462934947049924
375,3,3,6,62.5,125,1875,31.25,3000000000,96
602,12,5,17,35.411764705882355,120.4,3010,50.166666666666664,5000000000,99.66777408637874
992,19,4,23,43.130434782608695,248,4960,82.66666666666667,4000000000,48.387096774193544
673,8,4,12,56.083333333333336,168.25,3365,56.083333333333336,4000000000,71.3224368499257
477,5,4,9,53,119.25,2385,39.75,4000000000,100.62893081761007
975,13,3,16,60.9375,325,4875,81.25,3000000000,36.92307692307692
843,13,3,16,52.6875,281,4215,70.25,3000000000,42.704626334519574
666,7,3,10,66.6,222,3330,55.5,3000000000,54.05405405405405
273,7,3,10,27.3,91,1365,22.75,3000000000,131.86813186813185
731,13,8,21,34.80952380952381,91.375,3655,60.916666666666664,8000000000,131.32694938440494
455,8,3,11,41.36363636363637,151.66666666666666,2275,37.916666666666664,3000000000,79.12087912087912
354,3,3,6,59,118,1770,29.5,3000000000,101.69491525423729
398,7,3,10,39.8,132.66666666666666,1990,33.166666666666664,3000000000,90.45226130653266
657,8,3,11,59.72727272727273,219,3285,54.75,3000000000,54.79452054794521
421,9,4,13,32.38461538461539,105.25,2105,35.083333333333336,4000000000,114.01425178147268
419,3,3,6,69.83333333333333,139.66666666666666,2095,34.916666666666664,3000000000,85.91885441527447
1028,12,10,22,46.72727272727273,102.8,5140,85.66666666666667,10000000000,116.73151750972762
255,6,4,10,25.5,63.75,1275,21.25,4000000000,188.23529411764704
522,10,8,18,29,65.25,2610,43.5,8000000000,183.9080459770115
1084,11,12,23,47.130434782608695,90.33333333333333,5420,90.33333333333333,12000000000,132.84132841328415
785,12,4,16,49.0625,196.25,3925,65.41666666666667,4000000000,61.146496815286625
213,4,3,7,30.428571428571427,71,1065,17.75,3000000000,169.01408450704227
1025,21,5,26,39.42307692307692,205,5125,85.41666666666667,5000000000,58.536585365853654
579,4,3,7,82.71428571428571,193,2895,48.25,3000000000,62.17616580310881
172,3,3,6,28.666666666666668,57.333333333333336,860,14.333333333333334,3000000000,209.30232558139534
678,12,4,16,42.375,169.5,3390,56.5,4000000000,70.79646017699115
768,12,3,15,51.2,256,3840,64,3000000000,46.875
453,9,3,12,37.75,151,2265,37.75,3000000000,79.47019867549669
811,8,7,15,54.06666666666667,115.85714285714286,4055,67.58333333333333,7000000000,103.57583230579533
292,6,3,9,32.44444444444444,97.33333333333333,1460,24.333333333333332,3000000000,123.28767123287672
431,5,3,8,53.875,143.66666666666666,2155,35.916666666666664,3000000000,83.52668213457078
570,7,6,13,43.84615384615385,95,2850,47.5,6000000000,126.3157894736842
287,5,3,8,35.875,95.66666666666667,1435,23.916666666666668,3000000000,125.4355400696864
227,5,3,8,28.375,75.66666666666667,1135,18.916666666666668,3000000000,158.59030837004406
519,9,5,14,37.07142857142857,103.8,2595,43.25,5000000000,115.60693641618498
573,9,8,17,33.705882352941174,71.625,2865,47.75,8000000000,167.5392670157068
1133,23,3,26,43.57692307692308,377.6666666666667,5665,94.41666666666667,3000000000,31.77405119152692
1202,15,7,22,54.63636363636363,171.71428571428572,6010,100.16666666666667,7000000000,69.88352745424292
604,7,3,10,60.4,201.33333333333334,3020,50.333333333333336,3000000000,59.602649006622514
379,10,3,13,29.153846153846153,126.33333333333333,1895,31.583333333333332,3000000000,94.9868073878628
567,8,5,13,43.61538461538461,113.4,2835,47.25,5000000000,105.82010582010582
1495,22,11,33,45.303030303030305,135.9090909090909,7475,124.58333333333333,11000000000,88.2943143812709
1046,14,4,18,58.111111111111114,261.5,5230,87.16666666666667,4000000000,45.88910133843212
618,7,3,10,61.8,206,3090,51.5,3000000000,58.25242718446602
482,8,3,11,43.81818181818182,160.66666666666666,2410,40.166666666666664,3000000000,74.68879668049793
1067,15,6,21,50.80952380952381,177.83333333333334,5335,88.91666666666667,6000000000,67.47891283973757
484,3,3,6,80.66666666666667,161.33333333333334,2420,40.333333333333336,3000000000,74.3801652892562
369,7,3,10,36.9,123,1845,30.75,3000000000,97.5609756097561
620,9,3,12,51.666666666666664,206.66666666666666,3100,51.666666666666664,3000000000,58.06451612903226
638,10,3,13,49.07692307692308,212.66666666666666,3190,53.166666666666664,3000000000,56.426332288401255
325,7,8,15,21.666666666666668,40.625,1625,27.083333333333332,8000000000,295.3846153846154
872,19,10,29,30.06896551724138,87.2,4360,72.66666666666667,10000000000,137.61467889908258
831,15,6,21,39.57142857142857,138.5,4155,69.25,6000000000,86.64259927797835
708,9,7,16,44.25,101.14285714285714,3540,59,7000000000,118.64406779661017
731,13,3,16,45.6875,243.66666666666666,3655,60.916666666666664,3000000000,49.24760601915185
444,10,3,13,34.15384615384615,148,2220,37,3000000000,81.08108108108108
989,10,5,15,65.93333333333334,197.8,4945,82.41666666666667,5000000000,60.66734074823053
757,16,3,19,39.8421052631579,252.33333333333334,3785,63.083333333333336,3000000000,47.556142668428
518,8,3,11,47.09090909090909,172.66666666666666,2590,43.166666666666664,3000000000,69.4980694980695
226,5,3,8,28.25,75.33333333333333,1130,18.833333333333332,3000000000,159.2920353982301
376,4,4,8,47,94,1880,31.333333333333332,4000000000,127.65957446808511
507,9,3,12,42.25,169,2535,42.25,3000000000,71.0059171597633
355,4,4,8,44.375,88.75,1775,29.583333333333332,4000000000,135.2112676056338
496,8,3,11,45.09090909090909,165.33333333333334,2480,41.333333333333336,3000000000,72.58064516129032
346,9,3,12,28.833333333333332,115.33333333333333,1730,28.833333333333332,3000000000,104.04624277456647
295,6,3,9,32.77777777777778,98.33333333333333,1475,24.583333333333332,3000000000,122.03389830508475
440,9,3,12,36.666666666666664,146.66666666666666,2200,36.666666666666664,3000000000,81.81818181818183
451,9,3,12,37.583333333333336,150.33333333333334,2255,37.583333333333336,3000000000,79.82261640798227
310,6,3,9,34.44444444444444,103.33333333333333,1550,25.833333333333332,3000000000,116.12903225806453
456,6,3,9,50.666666666666664,152,2280,38,3000000000,78.94736842105263
337,6,3,9,37.44444444444444,112.33333333333333,1685,28.083333333333332,3000000000,106.82492581602374
835,15,3,18,46.388888888888886,278.3333333333333,4175,69.58333333333333,3000000000,43.11377245508982
817,16,3,19,43,272.3333333333333,4085,68.08333333333333,3000000000,44.06364749082008
573,11,3,14,40.92857142857143,191,2865,47.75,3000000000,62.82722513089005
1104,17,6,23,48,184,5520,92,6000000000,65.21739130434783
514,9,3,12,42.833333333333336,171.33333333333334,2570,42.833333333333336,3000000000,70.03891050583658
477,14,3,17,28.058823529411764,159,2385,39.75,3000000000,75.47169811320755
810,8,6,14,57.857142857142854,135,4050,67.5,6000000000,88.8888888888889
910,5,6,11,82.72727272727273,151.66666666666666,4550,75.83333333333333,6000000000,79.12087912087912
459,7,3,10,45.9,153,2295,38.25,3000000000,78.4313725490196
825,18,3,21,39.285714285714285,275,4125,68.75,3000000000,43.63636363636363
517,12,3,15,34.46666666666667,172.33333333333334,2585,43.083333333333336,3000000000,69.63249516441006
614,15,3,18,34.111111111111114,204.66666666666666,3070,51.166666666666664,3000000000,58.63192182410423
217,3,3,6,36.166666666666664,72.33333333333333,1085,18.083333333333332,3000000000,165.89861751152074
394,7,3,10,39.4,131.33333333333334,1970,32.833333333333336,3000000000,91.3705583756345
625,9,9,18,34.72222222222222,69.44444444444444,3125,52.083333333333336,9000000000,172.8
1038,11,10,21,49.42857142857143,103.8,5190,86.5,10000000000,115.60693641618498
1078,19,8,27,39.925925925925924,134.75,5390,89.83333333333333,8000000000,89.05380333951763
737,10,3,13,56.69230769230769,245.66666666666666,3685,61.416666666666664,3000000000,48.846675712347356
290,7,3,10,29,96.66666666666667,1450,24.166666666666668,3000000000,124.13793103448275
592,4,4,8,74,148,2960,49.333333333333336,4000000000,81.08108108108108
1124,15,9,24,46.833333333333336,124.88888888888889,5620,93.66666666666667,9000000000,96.08540925266904
613,14,3,17,36.05882352941177,204.33333333333334,3065,51.083333333333336,3000000000,58.727569331158236
776,6,6,12,64.66666666666667,129.33333333333334,3880,64.66666666666667,6000000000,92.78350515463917
143,4,3,7,20.428571428571427,47.666666666666664,715,11.916666666666666,3000000000,251.74825174825176
507,12,3,15,33.8,169,2535,42.25,3000000000,71.0059171597633
280,6,5,11,25.454545454545453,56,1400,23.333333333333332,5000000000,214.2857142857143
585,15,3,18,32.5,195,2925,48.75,3000000000,61.53846153846153
677,9,3,12,56.416666666666664,225.66666666666666,3385,56.416666666666664,3000000000,53.17577548005909
833,13,9,22,37.86363636363637,92.55555555555556,4165,69.41666666666667,9000000000,129.65186074429772
1532,27,11,38,40.31578947368421,139.27272727272728,7660,127.66666666666667,11000000000,86.16187989556136
785,14,5,19,41.31578947368421,157,3925,65.41666666666667,5000000000,76.43312101910828
743,12,8,20,37.15,92.875,3715,61.916666666666664,8000000000,129.20592193808884
573,6,3,9,63.666666666666664,191,2865,47.75,3000000000,62.82722513089005
436,5,8,13,33.53846153846154,54.5,2180,36.333333333333336,8000000000,220.18348623853208
822,10,6,16,51.375,137,4110,68.5,6000000000,87.59124087591242
766,7,6,13,58.92307692307692,127.66666666666667,3830,63.833333333333336,6000000000,93.99477806788512
364,6,3,9,40.44444444444444,121.33333333333333,1820,30.333333333333332,3000000000,98.9010989010989
662,10,3,13,50.92307692307692,220.66666666666666,3310,55.166666666666664,3000000000,54.38066465256797
530,11,3,14,37.857142857142854,176.66666666666666,2650,44.166666666666664,3000000000,67.9245283018868
552,7,3,10,55.2,184,2760,46,3000000000,65.21739130434783
464,9,3,12,38.666666666666664,154.66666666666666,2320,38.666666666666664,3000000000,77.58620689655173
1181,20,3,23,51.34782608695652,393.6666666666667,5905,98.41666666666667,3000000000,30.482641828958506
470,5,3,8,58.75,156.66666666666666,2350,39.166666666666664,3000000000,76.59574468085107
212,3,3,6,35.333333333333336,70.66666666666667,1060,17.666666666666668,3000000000,169.81132075471697
898,11,10,21,42.76190476190476,89.8,4490,74.83333333333333,10000000000,133.630289532294
816,13,8,21,38.857142857142854,102,4080,68,8000000000,117.6470588235294
765,11,3,14,54.642857142857146,255,3825,63.75,3000000000,47.05882352941176
485,5,3,8,60.625,161.66666666666666,2425,40.416666666666664,3000000000,74.22680412371135
996,11,6,17,58.588235294117645,166,4980,83,6000000000,72.28915662650603
421,8,3,11,38.27272727272727,140.33333333333334,2105,35.083333333333336,3000000000,85.5106888361045
446,7,3,10,44.6,148.66666666666666,2230,37.166666666666664,3000000000,80.71748878923768
764,14,3,17,44.94117647058823,254.66666666666666,3820,63.666666666666664,3000000000,47.12041884816754
263,6,3,9,29.22222222222222,87.66666666666667,1315,21.916666666666668,3000000000,136.88212927756652
608,5,9,14,43.42857142857143,67.55555555555556,3040,50.666666666666664,9000000000,177.63157894736844
602,12,3,15,40.13333333333333,200.66666666666666,3010,50.166666666666664,3000000000,59.800664451827245
1059,13,11,24,44.125,96.27272727272727,5295,88.25,11000000000,124.64589235127478
662,14,6,20,33.1,110.33333333333333,3310,55.166666666666664,6000000000,108.76132930513594
694,6,3,9,77.11111111111111,231.33333333333334,3470,57.833333333333336,3000000000,51.87319884726225
544,12,3,15,36.266666666666666,181.33333333333334,2720,45.333333333333336,3000000000,66.17647058823529
770,7,5,12,64.16666666666667,154,3850,64.16666666666667,5000000000,77.9220779220779
297,5,3,8,37.125,99,1485,24.75,3000000000,121.21212121212122
624,6,3,9,69.33333333333333,208,3120,52,3000000000,57.69230769230769
305,5,3,8,38.125,101.66666666666667,1525,25.416666666666668,3000000000,118.03278688524588
546,9,5,14,39,109.2,2730,45.5,5000000000,109.8901098901099
795,12,3,15,53,265,3975,66.25,3000000000,45.283018867924525
502,9,3,12,41.833333333333336,167.33333333333334,2510,41.833333333333336,3000000000,71.71314741035856
728,10,3,13,56,242.66666666666666,3640,60.666666666666664,3000000000,49.45054945054945
595,7,3,10,59.5,198.33333333333334,2975,49.583333333333336,3000000000,60.50420168067227
524,8,5,13,40.30769230769231,104.8,2620,43.666666666666664,5000000000,114.50381679389312
1059,20,5,25,42.36,211.8,5295,88.25,5000000000,56.657223796033996
544,14,3,17,32,181.33333333333334,2720,45.333333333333336,3000000000,66.17647058823529
662,9,5,14,47.285714285714285,132.4,3310,55.166666666666664,5000000000,90.6344410876133
595,8,7,15,39.666666666666664,85,2975,49.583333333333336,7000000000,141.17647058823528
461,6,3,9,51.22222222222222,153.66666666666666,2305,38.416666666666664,3000000000,78.09110629067246
572,8,3,11,52,190.66666666666666,2860,47.666666666666664,3000000000,62.93706293706294
383,7,3,10,38.3,127.66666666666667,1915,31.916666666666668,3000000000,93.99477806788512
633,12,5,17,37.23529411764706,126.6,3165,52.75,5000000000,94.7867298578199
517,5,3,8,64.625,172.33333333333334,2585,43.083333333333336,3000000000,69.63249516441006
833,13,5,18,46.27777777777778,166.6,4165,69.41666666666667,5000000000,72.02881152460984
650,9,6,15,43.333333333333336,108.33333333333333,3250,54.166666666666664,6000000000,110.76923076923077
488,8,3,11,44.36363636363637,162.66666666666666,2440,40.666666666666664,3000000000,73.7704918032787
326,7,5,12,27.166666666666668,65.2,1630,27.166666666666668,5000000000,184.04907975460122
504,8,3,11,45.81818181818182,168,2520,42,3000000000,71.42857142857143
544,8,3,11,49.45454545454545,181.33333333333334,2720,45.333333333333336,3000000000,66.17647058823529
546,13,3,16,34.125,182,2730,45.5,3000000000,65.93406593406593
728,11,3,14,52,242.66666666666666,3640,60.666666666666664,3000000000,49.45054945054945
379,3,5,8,47.375,75.8,1895,31.583333333333332,5000000000,158.311345646438
553,10,4,14,39.5,138.25,2765,46.083333333333336,4000000000,86.79927667269439
389,7,4,11,35.36363636363637,97.25,1945,32.416666666666664,4000000000,123.39331619537276
493,6,3,9,54.77777777777778,164.33333333333334,2465,41.083333333333336,3000000000,73.02231237322515
472,13,4,17,27.764705882352942,118,2360,39.333333333333336,4000000000,101.69491525423727
325,6,3,9,36.111111111111114,108.33333333333333,1625,27.083333333333332,3000000000,110.76923076923077
330,8,3,11,30,110,1650,27.5,3000000000,109.0909090909091
378,4,3,7,54,126,1890,31.5,3000000000,95.23809523809524
516,4,5,9,57.333333333333336,103.2,2580,43,5000000000,116.27906976744185
925,9,11,20,46.25,84.0909090909091,4625,77.08333333333333,11000000000,142.7027027027027
1282,15,9,24,53.416666666666664,142.44444444444446,6410,106.83333333333333,9000000000,84.2433697347894
625,14,4,18,34.72222222222222,156.25,3125,52.083333333333336,4000000000,76.8
387,5,3,8,48.375,129,1935,32.25,3000000000,93.02325581395348
799,11,3,14,57.07142857142857,266.3333333333333,3995,66.58333333333333,3000000000,45.056320400500624
513,9,4,13,39.46153846153846,128.25,2565,42.75,4000000000,93.5672514619883
571,10,3,13,43.92307692307692,190.33333333333334,2855,47.583333333333336,3000000000,63.047285464098074
1555,21,10,31,50.16129032258065,155.5,7775,129.58333333333334,10000000000,77.17041800643086
522,6,5,11,47.45454545454545,104.4,2610,43.5,5000000000,114.94252873563218
741,12,5,17,43.588235294117645,148.2,3705,61.75,5000000000,80.97165991902834
334,5,3,8,41.75,111.33333333333333,1670,27.833333333333332,3000000000,107.78443113772455
884,8,3,11,80.36363636363636,294.6666666666667,4420,73.66666666666667,3000000000,40.723981900452486
360,5,5,10,36,72,1800,30,5000000000,166.66666666666666
890,14,3,17,52.35294117647059,296.6666666666667,4450,74.16666666666667,3000000000,40.44943820224719
845,8,6,14,60.357142857142854,140.83333333333334,4225,70.41666666666667,6000000000,85.20710059171597
475,7,3,10,47.5,158.33333333333334,2375,39.583333333333336,3000000000,75.78947368421052
757,6,3,9,84.11111111111111,252.33333333333334,3785,63.083333333333336,3000000000,47.556142668428
742,13,4,17,43.64705882352941,185.5,3710,61.833333333333336,4000000000,64.6900269541779
912,20,3,23,39.65217391304348,304,4560,76,3000000000,39.473684210526315
492,4,3,7,70.28571428571429,164,2460,41,3000000000,73.17073170731707
716,10,3,13,55.07692307692308,238.66666666666666,3580,59.666666666666664,3000000000,50.27932960893855
495,6,4,10,49.5,123.75,2475,41.25,4000000000,96.96969696969697
590,5,3,8,73.75,196.66666666666666,2950,49.166666666666664,3000000000,61.016949152542374
351,6,3,9,39,117,1755,29.25,3000000000,102.56410256410255
594,10,5,15,39.6,118.8,2970,49.5,5000000000,101.01010101010101
658,13,4,17,38.705882352941174,164.5,3290,54.833333333333336,4000000000,72.9483282674772
516,8,3,11,46.90909090909091,172,2580,43,3000000000,69.76744186046511
833,8,10,18,46.27777777777778,83.3,4165,69.41666666666667,10000000000,144.05762304921967
503,4,4,8,62.875,125.75,2515,41.916666666666664,4000000000,95.42743538767395
557,10,3,13,42.84615384615385,185.66666666666666,2785,46.416666666666664,3000000000,64.63195691202873
824,16,6,22,37.45454545454545,137.33333333333334,4120,68.66666666666667,6000000000,87.37864077669902
377,5,3,8,47.125,125.66666666666667,1885,31.416666666666668,3000000000,95.49071618037135
651,9,5,14,46.5,130.2,3255,54.25,5000000000,92.16589861751153
755,12,3,15,50.333333333333336,251.66666666666666,3775,62.916666666666664,3000000000,47.682119205298015
950,15,3,18,52.77777777777778,316.6666666666667,4750,79.16666666666667,3000000000,37.89473684210526
233,3,3,6,38.833333333333336,77.66666666666667,1165,19.416666666666668,3000000000,154.50643776824035
613,8,3,11,55.72727272727273,204.33333333333334,3065,51.083333333333336,3000000000,58.727569331158236
456,8,3,11,41.45454545454545,152,2280,38,3000000000,78.94736842105263
591,7,3,10,59.1,197,2955,49.25,3000000000,60.91370558375634
841,5,4,9,93.44444444444444,210.25,4205,70.08333333333333,4000000000,57.07491082045185
255,7,3,10,25.5,85,1275,21.25,3000000000,141.17647058823528
687,12,3,15,45.8,229,3435,57.25,3000000000,52.40174672489083
1236,35,6,41,30.146341463414632,206,6180,103,6000000000,58.25242718446602
559,7,3,10,55.9,186.33333333333334,2795,46.583333333333336,3000000000,64.40071556350627
842,16,3,19,44.31578947368421,280.6666666666667,4210,70.16666666666667,3000000000,42.75534441805225
506,9,3,12,42.166666666666664,168.66666666666666,2530,42.166666666666664,3000000000,71.14624505928855
744,9,7,16,46.5,106.28571428571429,3720,62,7000000000,112.90322580645162
405,5,3,8,50.625,135,2025,33.75,3000000000,88.8888888888889
619,9,3,12,51.583333333333336,206.33333333333334,3095,51.583333333333336,3000000000,58.158319870759286
959,20,3,23,41.69565217391305,319.6666666666667,4795,79.91666666666667,3000000000,37.53910323253389
343,4,4,8,42.875,85.75,1715,28.583333333333332,4000000000,139.94169096209913
600,9,3,12,50,200,3000,50,3000000000,60
543,7,5,12,45.25,108.6,2715,45.25,5000000000,110.49723756906077
680,8,5,13,52.30769230769231,136,3400,56.666666666666664,5000000000,88.23529411764707
627,8,3,11,57,209,3135,52.25,3000000000,57.41626794258373
337,4,3,7,48.142857142857146,112.33333333333333,1685,28.083333333333332,3000000000,106.82492581602374
372,10,4,14,26.571428571428573,93,1860,31,4000000000,129.03225806451613
136,3,3,6,22.666666666666668,45.333333333333336,680,11.333333333333334,3000000000,264.70588235294116
1110,15,3,18,61.666666666666664,370,5550,92.5,3000000000,32.432432432432435
446,6,7,13,34.30769230769231,63.714285714285715,2230,37.166666666666664,7000000000,188.34080717488789
266,6,3,9,29.555555555555557,88.66666666666667,1330,22.166666666666668,3000000000,135.33834586466165
460,6,3,9,51.111111111111114,153.33333333333334,2300,38.333333333333336,3000000000,78.26086956521739
1119,17,3,20,55.95,373,5595,93.25,3000000000,32.171581769437
444,6,3,9,49.333333333333336,148,2220,37,3000000000,81.08108108108108
447,8,3,11,40.63636363636363,149,2235,37.25,3000000000,80.53691275167786
556,7,5,12,46.333333333333336,111.2,2780,46.333333333333336,5000000000,107.91366906474819
221,5,4,9,24.555555555555557,55.25,1105,18.416666666666668,4000000000,217.1945701357466
474,9,7,16,29.625,67.71428571428571,2370,39.5,7000000000,177.21518987341773
713,11,3,14,50.92857142857143,237.66666666666666,3565,59.416666666666664,3000000000,50.490883590462836
680,13,4,17,40,170,3400,56.666666666666664,4000000000,70.58823529411764
576,8,3,11,52.36363636363637,192,2880,48,3000000000,62.5
99,4,3,7,14.142857142857142,33,495,8.25,3000000000,363.6363636363636
403,8,3,11,36.63636363636363,134.33333333333334,2015,33.583333333333336,3000000000,89.33002481389578
602,8,9,17,35.411764705882355,66.88888888888889,3010,50.166666666666664,9000000000,179.40199335548175
721,19,4,23,31.347826086956523,180.25,3605,60.083333333333336,4000000000,66.57420249653259
545,10,5,15,36.333333333333336,109,2725,45.416666666666664,5000000000,110.09174311926607
212,6,3,9,23.555555555555557,70.66666666666667,1060,17.666666666666668,3000000000,169.81132075471697
386,5,3,8,48.25,128.66666666666666,1930,32.166666666666664,3000000000,93.26424870466322
594,8,3,11,54,198,2970,49.5,3000000000,60.60606060606061
1028,8,4,12,85.66666666666667,257,5140,85.66666666666667,4000000000,46.69260700389105
226,5,3,8,28.25,75.33333333333333,1130,18.833333333333332,3000000000,159.2920353982301
271,7,3,10,27.1,90.33333333333333,1355,22.583333333333332,3000000000,132.84132841328415
656,9,5,14,46.857142857142854,131.2,3280,54.666666666666664,5000000000,91.46341463414635
617,5,3,8,77.125,205.66666666666666,3085,51.416666666666664,3000000000,58.346839546191255
594,8,5,13,45.69230769230769,118.8,2970,49.5,5000000000,101.01010101010101
572,17,3,20,28.6,190.66666666666666,2860,47.666666666666664,3000000000,62.93706293706294
489,4,3,7,69.85714285714286,163,2445,40.75,3000000000,73.61963190184049
543,12,3,15,36.2,181,2715,45.25,3000000000,66.29834254143647
476,5,3,8,59.5,158.66666666666666,2380,39.666666666666664,3000000000,75.63025210084035
761,11,7,18,42.27777777777778,108.71428571428571,3805,63.416666666666664,7000000000,110.38107752956637
707,9,5,14,50.5,141.4,3535,58.916666666666664,5000000000,84.86562942008486
717,10,5,15,47.8,143.4,3585,59.75,5000000000,83.68200836820084
643,8,4,12,53.583333333333336,160.75,3215,53.583333333333336,4000000000,74.65007776049767
892,14,3,17,52.470588235294116,297.3333333333333,4460,74.33333333333333,3000000000,40.35874439461884
658,8,3,11,59.81818181818182,219.33333333333334,3290,54.833333333333336,3000000000,54.7112462006079
1057,22,3,25,42.28,352.3333333333333,5285,88.08333333333333,3000000000,34.058656575212865
789,17,3,20,39.45,263,3945,65.75,3000000000,45.62737642585551
758,18,3,21,36.095238095238095,252.66666666666666,3790,63.166666666666664,3000000000,47.4934036939314
756,7,3,10,75.6,252,3780,63,3000000000,47.61904761904762
519,12,5,17,30.529411764705884,103.8,2595,43.25,5000000000,115.60693641618498
720,11,3,14,51.42857142857143,240,3600,60,3000000000,50
368,10,3,13,28.307692307692307,122.66666666666667,1840,30.666666666666668,3000000000,97.82608695652173
1028,12,13,25,41.12,79.07692307692308,5140,85.66666666666667,13000000000,151.7509727626459
307,3,3,6,51.166666666666664,102.33333333333333,1535,25.583333333333332,3000000000,117.26384364820846
561,8,3,11,51,187,2805,46.75,3000000000,64.171122994652407
875,16,8,24,36.458333333333336,109.375,4375,72.91666666666667,8000000000,109.71428571428571
997,7,8,15,66.46666666666667,124.625,4985,83.08333333333333,8000000000,96.2888665997994
990,15,5,20,49.5,198,4950,82.5,5000000000,60.60606060606061
675,10,3,13,51.92307692307692,225,3375,56.25,3000000000,53.333333333333336
680,13,5,18,37.77777777777778,136,3400,56.666666666666664,5000000000,88.23529411764707
638,9,3,12,53.166666666666664,212.66666666666666,3190,53.166666666666664,3000000000,56.426332288401255
616,8,6,14,44,102.66666666666667,3080,51.333333333333336,6000000000,116.88311688311687
838,12,3,15,55.86666666666667,279.3333333333333,4190,69.83333333333333,3000000000,42.95942720763723
805,12,3,15,53.666666666666664,268.3333333333333,4025,67.08333333333333,3000000000,44.72049689440994
1224,20,3,23,53.21739130434783,408,6120,102,3000000000,29.41176470588235
701,14,3,17,41.23529411764706,233.66666666666666,3505,58.416666666666664,3000000000,51.35520684736092
367,7,4,11,33.36363636363637,91.75,1835,30.583333333333332,4000000000,130.79019073569484
630,6,5,11,57.27272727272727,126,3150,52.5,5000000000,95.23809523809524
843,16,6,22,38.31818181818182,140.5,4215,70.25,6000000000,85.40925266903915
743,18,3,21,35.38095238095238,247.66666666666666,3715,61.916666666666664,3000000000,48.45222072678331
1072,14,3,17,63.05882352941177,357.3333333333333,5360,89.33333333333333,3000000000,33.582089552238806
631,7,3,10,63.1,210.33333333333334,3155,52.583333333333336,3000000000,57.05229793977813
903,13,3,16,56.4375,301,4515,75.25,3000000000,39.8671096345515
684,16,3,19,36,228,3420,57,3000000000,52.63157894736842
412,5,8,13,31.692307692307693,51.5,2060,34.333333333333336,8000000000,233.00970873786406
299,6,3,9,33.22222222222222,99.66666666666667,1495,24.916666666666668,3000000000,120.40133779264214
296,5,3,8,37,98.66666666666667,1480,24.666666666666668,3000000000,121.62162162162161
680,15,6,21,32.38095238095238,113.33333333333333,3400,56.666666666666664,6000000000,105.88235294117648
1225,13,10,23,53.26086956521739,122.5,6125,102.08333333333333,10000000000,97.9591836734694
584,11,5,16,36.5,116.8,2920,48.666666666666664,5000000000,102.73972602739725
688,17,7,24,28.666666666666668,98.28571428571429,3440,57.333333333333336,7000000000,122.09302325581395
492,6,3,9,54.666666666666664,164,2460,41,3000000000,73.17073170731707
728,14,7,21,34.666666666666664,104,3640,60.666666666666664,7000000000,115.38461538461539
657,8,7,15,43.8,93.85714285714286,3285,54.75,7000000000,127.85388127853881
927,17,13,30,30.9,71.3076923076923,4635,77.25,13000000000,168.28478964401296
796,6,3,9,88.44444444444444,265.3333333333333,3980,66.33333333333333,3000000000,45.22613065326633
397,6,3,9,44.111111111111114,132.33333333333334,1985,33.083333333333336,3000000000,90.6801007556675
572,6,4,10,57.2,143,2860,47.666666666666664,4000000000,83.91608391608392
524,9,3,12,43.666666666666664,174.66666666666666,2620,43.666666666666664,3000000000,68.70229007633587
596,11,3,14,42.57142857142857,198.66666666666666,2980,49.666666666666664,3000000000,60.4026845637584
232,6,3,9,25.77777777777778,77.33333333333333,1160,19.333333333333332,3000000000,155.17241379310346
477,8,3,11,43.36363636363637,159,2385,39.75,3000000000,75.47169811320755
620,12,7,19,32.63157894736842,88.57142857142857,3100,51.666666666666664,7000000000,135.48387096774195
378,7,3,10,37.8,126,1890,31.5,3000000000,95.23809523809524
491,8,5,13,37.76923076923077,98.2,2455,40.916666666666664,5000000000,122.19959266802445
320,5,3,8,40,106.66666666666667,1600,26.666666666666668,3000000000,112.5
1357,22,15,37,36.67567567567568,90.46666666666667,6785,113.08333333333333,15000000000,132.64554163596168
710,10,5,15,47.333333333333336,142,3550,59.166666666666664,5000000000,84.50704225352113
430,6,5,11,39.09090909090909,86,2150,35.833333333333336,5000000000,139.53488372093022
640,10,5,15,42.666666666666664,128,3200,53.333333333333336,5000000000,93.75
598,10,3,13,46,199.33333333333334,2990,49.833333333333336,3000000000,60.20066889632107
412,9,3,12,34.333333333333336,137.33333333333334,2060,34.333333333333336,3000000000,87.37864077669902
1224,11,5,16,76.5,244.8,6120,102,5000000000,49.01960784313726
477,10,6,16,29.8125,79.5,2385,39.75,6000000000,150.9433962264151
217,3,3,6,36.166666666666664,72.33333333333333,1085,18.083333333333332,3000000000,165.89861751152074
630,7,3,10,63,210,3150,52.5,3000000000,57.14285714285714
548,8,5,13,42.15384615384615,109.6,2740,45.666666666666664,5000000000,109.48905109489051
778,11,9,20,38.9,86.44444444444444,3890,64.83333333333333,9000000000,138.81748071979436
754,12,3,15,50.266666666666666,251.33333333333334,3770,62.833333333333336,3000000000,47.745358090185675
1044,15,9,24,43.5,116,5220,87,9000000000,103.44827586206897
453,5,3,8,56.625,151,2265,37.75,3000000000,79.47019867549669
784,12,6,18,43.55555555555556,130.66666666666666,3920,65.33333333333333,6000000000,91.83673469387756
864,9,10,19,45.473684210526315,86.4,4320,72,10000000000,138.88888888888889
663,9,3,12,55.25,221,3315,55.25,3000000000,54.29864253393665
917,7,8,15,61.13333333333333,114.625,4585,76.41666666666667,8000000000,104.68920392584515
486,6,3,9,54,162,2430,40.5,3000000000,74.07407407407408
620,11,6,17,36.470588235294116,103.33333333333333,3100,51.666666666666664,6000000000,116.12903225806453
1484,10,9,19,78.10526315789474,164.88888888888889,7420,123.66666666666667,9000000000,72.77628032345014
501,8,5,13,38.53846153846154,100.2,2505,41.75,5000000000,119.76047904191616
301,6,3,9,33.44444444444444,100.33333333333333,1505,25.083333333333332,3000000000,119.60132890365449
660,9,5,14,47.142857142857146,132,3300,55,5000000000,90.9090909090909
355,8,4,12,29.583333333333332,88.75,1775,29.583333333333332,4000000000,135.2112676056338
1082,26,3,29,37.310344827586206,360.6666666666667,5410,90.16666666666667,3000000000,33.271719038817004
739,11,3,14,52.785714285714285,246.33333333333334,3695,61.583333333333336,3000000000,48.71447902571042
473,13,3,16,29.5625,157.66666666666666,2365,39.416666666666664,3000000000,76.10993657505286
949,8,8,16,59.3125,118.625,4745,79.08333333333333,8000000000,101.15911485774501
618,8,3,11,56.18181818181818,206,3090,51.5,3000000000,58.25242718446602
814,9,3,12,67.83333333333333,271.3333333333333,4070,67.83333333333333,3000000000,44.22604422604423
610,8,6,14,43.57142857142857,101.66666666666667,3050,50.833333333333336,6000000000,118.03278688524588
1442,27,3,30,48.06666666666667,480.6666666666667,7210,120.16666666666667,3000000000,24.965325936199722
596,8,3,11,54.18181818181818,198.66666666666666,2980,49.666666666666664,3000000000,60.4026845637584
514,18,3,21,24.476190476190474,171.33333333333334,2570,42.833333333333336,3000000000,70.03891050583658
512,9,3,12,42.666666666666664,170.66666666666666,2560,42.666666666666664,3000000000,70.3125
1480,26,3,29,51.03448275862069,493.3333333333333,7400,123.33333333333333,3000000000,24.324324324324326
1218,15,6,21,58,203,6090,101.5,6000000000,59.11330049261083
1022,15,3,18,56.77777777777778,340.6666666666667,5110,85.16666666666667,3000000000,35.22504892367906
588,5,3,8,73.5,196,2940,49,3000000000,61.224489795918366
388,4,3,7,55.42857142857143,129.33333333333334,1940,32.333333333333336,3000000000,92.78350515463917
711,18,9,27,26.333333333333332,79,3555,59.25,9000000000,151.89873417721518
403,4,3,7,57.57142857142857,134.33333333333334,2015,33.583333333333336,3000000000,89.33002481389578
986,12,7,19,51.89473684210526,140.85714285714286,4930,82.16666666666667,7000000000,85.19269776876268
1331,26,3,29,45.89655172413793,443.6666666666667,6655,110.91666666666667,3000000000,27.047332832456796
638,7,3,10,63.8,212.66666666666666,3190,53.166666666666664,3000000000,56.426332288401255
260,6,3,9,28.88888888888889,86.66666666666667,1300,21.666666666666668,3000000000,138.46153846153845
1147,15,7,22,52.13636363636363,163.85714285714286,5735,95.58333333333333,7000000000,73.23452484742808
509,8,5,13,39.15384615384615,101.8,2545,42.416666666666664,5000000000,117.87819253438116
337,3,3,6,56.166666666666664,112.33333333333333,1685,28.083333333333332,3000000000,106.82492581602374
500,9,3,12,41.666666666666664,166.66666666666666,2500,41.666666666666664,3000000000,72
707,7,3,10,70.7,235.66666666666666,3535,58.916666666666664,3000000000,50.91937765205092
561,6,5,11,51,112.2,2805,46.75,5000000000,106.951871657754
540,11,3,14,38.57142857142857,180,2700,45,3000000000,66.66666666666666
726,13,3,16,45.375,242,3630,60.5,3000000000,49.586776859504134
843,15,3,18,46.833333333333336,281,4215,70.25,3000000000,42.704626334519574
914,12,3,15,60.93333333333333,304.6666666666667,4570,76.16666666666667,3000000000,39.387308533916844
958,13,3,16,59.875,319.3333333333333,4790,79.83333333333333,3000000000,37.57828810020877
740,7,5,12,61.666666666666664,148,3700,61.666666666666664,5000000000,81.08108108108108
579,10,3,13,44.53846153846154,193,2895,48.25,3000000000,62.17616580310881
378,8,3,11,34.36363636363637,126,1890,31.5,3000000000,95.23809523809524
661,11,3,14,47.214285714285715,220.33333333333334,3305,55.083333333333336,3000000000,54.462934947049924
621,10,5,15,41.4,124.2,3105,51.75,5000000000,96.6183574879227
487,5,4,9,54.111111111111114,121.75,2435,40.583333333333336,4000000000,98.56262833675565
645,11,6,17,37.94117647058823,107.5,3225,53.75,6000000000,111.62790697674419
594,3,3,6,99,198,2970,49.5,3000000000,60.60606060606061
468,11,3,14,33.42857142857143,156,2340,39,3000000000,76.92307692307693
576,8,5,13,44.30769230769231,115.2,2880,48,5000000000,104.16666666666667
826,9,3,12,68.83333333333333,275.3333333333333,4130,68.83333333333333,3000000000,43.58353510895884
388,8,3,11,35.27272727272727,129.33333333333334,1940,32.333333333333336,3000000000,92.78350515463917
628,6,3,9,69.77777777777777,209.33333333333334,3140,52.333333333333336,3000000000,57.324840764331206
442,8,3,11,40.18181818181818,147.33333333333334,2210,36.833333333333336,3000000000,81.44796380090497
401,6,3,9,44.55555555555556,133.66666666666666,2005,33.416666666666664,3000000000,89.77556109725687
510,6,3,9,56.666666666666664,170,2550,42.5,3000000000,70.58823529411764
738,8,5,13,56.76923076923077,147.6,3690,61.5,5000000000,81.30081300813009
433,6,6,12,36.083333333333336,72.16666666666667,2165,36.083333333333336,6000000000,166.28175519630483
206,5,3,8,25.75,68.66666666666667,1030,17.166666666666668,3000000000,174.75728155339803
791,14,7,21,37.666666666666664,113,3955,65.91666666666667,7000000000,106.19469026548671
682,8,3,11,62,227.33333333333334,3410,56.833333333333336,3000000000,52.785923753665685
204,4,3,7,29.142857142857142,68,1020,17,3000000000,176.47058823529412
458,9,3,12,38.166666666666664,152.66666666666666,2290,38.166666666666664,3000000000,78.60262008733625
835,6,7,13,64.23076923076923,119.28571428571429,4175,69.58333333333333,7000000000,100.59880239520957
305,7,5,12,25.416666666666668,61,1525,25.416666666666668,5000000000,196.72131147540983
1413,26,6,32,44.15625,235.5,7065,117.75,6000000000,50.955414012738856
635,11,3,14,45.357142857142854,211.66666666666666,3175,52.916666666666664,3000000000,56.69291338582677
418,3,3,6,69.66666666666667,139.33333333333334,2090,34.833333333333336,3000000000,86.1244019138756
1027,16,7,23,44.65217391304348,146.71428571428572,5135,85.58333333333333,7000000000,81.79162609542357
268,5,3,8,33.5,89.33333333333333,1340,22.333333333333332,3000000000,134.32835820895522
587,8,3,11,53.36363636363637,195.66666666666666,2935,48.916666666666664,3000000000,61.32879045996593
593,8,3,11,53.90909090909091,197.66666666666666,2965,49.416666666666664,3000000000,60.708263069139974
759,9,3,12,63.25,253,3795,63.25,3000000000,47.430830039525695
538,8,8,16,33.625,67.25,2690,44.833333333333336,8000000000,178.43866171003717
431,11,3,14,30.785714285714285,143.66666666666666,2155,35.916666666666664,3000000000,83.52668213457078
589,11,11,22,26.772727272727273,53.54545454545455,2945,49.083333333333336,11000000000,224.10865874363327
459,11,3,14,32.785714285714285,153,2295,38.25,3000000000,78.4313725490196
950,9,5,14,67.85714285714286,190,4750,79.16666666666667,5000000000,63.1578947368421
554,6,3,9,61.55555555555556,184.66666666666666,2770,46.166666666666664,3000000000,64.98194945848375
789,15,8,23,34.30434782608695,98.625,3945,65.75,8000000000,121.67300380228137
347,7,3,10,34.7,115.66666666666667,1735,28.916666666666668,3000000000,103.7463976945245
750,17,4,21,35.714285714285715,187.5,3750,62.5,4000000000,64
501,7,3,10,50.1,167,2505,41.75,3000000000,71.85628742514969
388,4,3,7,55.42857142857143,129.33333333333334,1940,32.333333333333336,3000000000,92.78350515463917
1046,18,10,28,37.357142857142854,104.6,5230,87.16666666666667,10000000000,114.72275334608031
1532,22,9,31,49.41935483870968,170.22222222222223,7660,127.66666666666667,9000000000,70.49608355091384
292,9,3,12,24.333333333333332,97.33333333333333,1460,24.333333333333332,3000000000,123.28767123287672
517,11,3,14,36.92857142857143,172.33333333333334,2585,43.083333333333336,3000000000,69.63249516441006
389,3,6,9,43.22222222222222,64.83333333333333,1945,32.416666666666664,6000000000,185.08997429305913
1205,13,3,16,75.3125,401.6666666666667,6025,100.41666666666667,3000000000,29.875518672199167
717,11,3,14,51.214285714285715,239,3585,59.75,3000000000,50.2092050209205
660,9,3,12,55,220,3300,55,3000000000,54.54545454545455
600,12,6,18,33.333333333333336,100,3000,50,6000000000,120
462,8,4,12,38.5,115.5,2310,38.5,4000000000,103.8961038961039
841,10,12,22,38.22727272727273,70.08333333333333,4205,70.08333333333333,12000000000,171.22473246135553
654,6,3,9,72.66666666666667,218,3270,54.5,3000000000,55.04587155963302
440,3,5,8,55,88,2200,36.666666666666664,5000000000,136.36363636363637
355,4,4,8,44.375,88.75,1775,29.583333333333332,4000000000,135.2112676056338
673,11,5,16,42.0625,134.6,3365,56.083333333333336,5000000000,89.15304606240713
571,18,4,22,25.954545454545453,142.75,2855,47.583333333333336,4000000000,84.0630472854641
551,5,4,9,61.22222222222222,137.75,2755,45.916666666666664,4000000000,87.11433756805808
947,14,3,17,55.705882352941174,315.6666666666667,4735,78.91666666666667,3000000000,38.01478352692713
848,11,6,17,49.88235294117647,141.33333333333334,4240,70.66666666666667,6000000000,84.90566037735849
343,6,3,9,38.111111111111114,114.33333333333333,1715,28.583333333333332,3000000000,104.95626822157435
783,6,8,14,55.92857142857143,97.875,3915,65.25,8000000000,122.60536398467434
1004,14,3,17,59.05882352941177,334.6666666666667,5020,83.66666666666667,3000000000,35.85657370517928
340,4,3,7,48.57142857142857,113.33333333333333,1700,28.333333333333332,3000000000,105.88235294117648
1174,14,3,17,69.05882352941177,391.3333333333333,5870,97.83333333333333,3000000000,30.664395229982965
598,10,4,14,42.714285714285715,149.5,2990,49.833333333333336,4000000000,80.2675585284281
436,11,4,15,29.066666666666666,109,2180,36.333333333333336,4000000000,110.09174311926604
717,9,4,13,55.15384615384615,179.25,3585,59.75,4000000000,66.94560669456067
548,9,3,12,45.666666666666664,182.66666666666666,2740,45.666666666666664,3000000000,65.69343065693431
639,6,5,11,58.09090909090909,127.8,3195,53.25,5000000000,93.89671361502347
479,8,4,12,39.916666666666664,119.75,2395,39.916666666666664,4000000000,100.20876826722339
203,6,3,9,22.555555555555557,67.66666666666667,1015,16.916666666666668,3000000000,177.33990147783248
942,17,5,22,42.81818181818182,188.4,4710,78.5,5000000000,63.69426751592357
528,11,3,14,37.714285714285715,176,2640,44,3000000000,68.18181818181819
797,12,3,15,53.13333333333333,265.6666666666667,3985,66.41666666666667,3000000000,45.1693851944793
877,14,8,22,39.86363636363637,109.625,4385,73.08333333333333,8000000000,109.46408209806158
914,17,3,20,45.7,304.6666666666667,4570,76.16666666666667,3000000000,39.387308533916844
496,6,3,9,55.111111111111114,165.33333333333334,2480,41.333333333333336,3000000000,72.58064516129032
724,12,3,15,48.266666666666666,241.33333333333334,3620,60.333333333333336,3000000000,49.72375690607735
976,7,10,17,57.411764705882355,97.6,4880,81.33333333333333,10000000000,122.95081967213115
284,3,5,8,35.5,56.8,1420,23.666666666666668,5000000000,211.2676056338028
357,3,3,6,59.5,119,1785,29.75,3000000000,100.84033613445379
865,13,5,18,48.05555555555556,173,4325,72.08333333333333,5000000000,69.36416184971098
304,3,3,6,50.666666666666664,101.33333333333333,1520,25.333333333333332,3000000000,118.42105263157895
381,9,3,12,31.75,127,1905,31.75,3000000000,94.48818897637796
303,7,3,10,30.3,101,1515,25.25,3000000000,118.81188118811882
785,7,3,10,78.5,261.6666666666667,3925,65.41666666666667,3000000000,45.859872611464965
485,6,8,14,34.642857142857146,60.625,2425,40.416666666666664,8000000000,197.93814432989691
574,8,3,11,52.18181818181818,191.33333333333334,2870,47.833333333333336,3000000000,62.7177700348432
398,8,3,11,36.18181818181818,132.66666666666666,1990,33.166666666666664,3000000000,90.45226130653266
398,9,3,12,33.166666666666664,132.66666666666666,1990,33.166666666666664,3000000000,90.45226130653266
356,3,3,6,59.333333333333336,118.66666666666667,1780,29.666666666666668,3000000000,101.12359550561797
509,14,5,19,26.789473684210527,101.8,2545,42.416666666666664,5000000000,117.87819253438116
296,8,3,11,26.90909090909091,98.66666666666667,1480,24.666666666666668,3000000000,121.62162162162161
796,13,4,17,46.8235294117647,199,3980,66.33333333333333,4000000000,60.30150753768845
360,14,3,17,21.176470588235293,120,1800,30,3000000000,100
542,8,5,13,41.69230769230769,108.4,2710,45.166666666666664,5000000000,110.70110701107012
554,12,3,15,36.93333333333333,184.66666666666666,2770,46.166666666666664,3000000000,64.98194945848375
900,12,6,18,50,150,4500,75,6000000000,80
675,9,3,12,56.25,225,3375,56.25,3000000000,53.333333333333336
1049,17,4,21,49.95238095238095,262.25,5245,87.41666666666667,4000000000,45.75786463298379
400,5,3,8,50,133.33333333333334,2000,33.333333333333336,3000000000,90
1053,15,6,21,50.142857142857146,175.5,5265,87.75,6000000000,68.37606837606839
730,9,5,14,52.142857142857146,146,3650,60.833333333333336,5000000000,82.1917808219178
321,4,4,8,40.125,80.25,1605,26.75,4000000000,149.53271028037383
821,11,3,14,58.642857142857146,273.6666666666667,4105,68.41666666666667,3000000000,43.848964677222895
538,7,3,10,53.8,179.33333333333334,2690,44.833333333333336,3000000000,66.91449814126393
748,11,3,14,53.42857142857143,249.33333333333334,3740,62.333333333333336,3000000000,48.1283422459893
308,7,3,10,30.8,102.66666666666667,1540,25.666666666666668,3000000000,116.88311688311687
246,3,3,6,41,82,1230,20.5,3000000000,146.34146341463415
513,7,3,10,51.3,171,2565,42.75,3000000000,70.17543859649123
750,13,4,17,44.11764705882353,187.5,3750,62.5,4000000000,64
904,16,3,19,47.578947368421055,301.3333333333333,4520,75.33333333333333,3000000000,39.823008849557525
361,8,3,11,32.81818181818182,120.33333333333333,1805,30.083333333333332,3000000000,99.7229916897507
690,11,3,14,49.285714285714285,230,3450,57.5,3000000000,52.17391304347826
716,10,3,13,55.07692307692308,238.66666666666666,3580,59.666666666666664,3000000000,50.27932960893855
478,5,3,8,59.75,159.33333333333334,2390,39.833333333333336,3000000000,75.31380753138075
344,5,5,10,34.4,68.8,1720,28.666666666666668,5000000000,174.41860465116278
304,4,3,7,43.42857142857143,101.33333333333333,1520,25.333333333333332,3000000000,118.42105263157895
614,4,4,8,76.75,153.5,3070,51.166666666666664,4000000000,78.17589576547232
268,4,3,7,38.285714285714285,89.33333333333333,1340,22.333333333333332,3000000000,134.32835820895522
378,12,3,15,25.2,126,1890,31.5,3000000000,95.23809523809524
1042,17,3,20,52.1,347.3333333333333,5210,86.83333333333333,3000000000,34.5489443378119
776,18,3,21,36.95238095238095,258.6666666666667,3880,64.66666666666667,3000000000,46.391752577319586
425,5,3,8,53.125,141.66666666666666,2125,35.416666666666664,3000000000,84.70588235294119
327,4,3,7,46.714285714285715,109,1635,27.25,3000000000,110.09174311926604
509,6,5,11,46.27272727272727,101.8,2545,42.416666666666664,5000000000,117.87819253438116
492,13,6,19,25.894736842105264,82,2460,41,6000000000,146.34146341463415
506,8,3,11,46,168.66666666666666,2530,42.166666666666664,3000000000,71.14624505928855
490,9,4,13,37.69230769230769,122.5,2450,40.833333333333336,4000000000,97.95918367346938
651,7,7,14,46.5,93,3255,54.25,7000000000,129.03225806451613
604,8,3,11,54.90909090909091,201.33333333333334,3020,50.333333333333336,3000000000,59.602649006622514
596,8,3,11,54.18181818181818,198.66666666666666,2980,49.666666666666664,3000000000,60.4026845637584
338,5,3,8,42.25,112.66666666666667,1690,28.166666666666668,3000000000,106.50887573964496
816,11,3,14,58.285714285714285,272,4080,68,3000000000,44.11764705882353
705,8,3,11,64.0909090909091,235,3525,58.75,3000000000,51.06382978723405
575,10,3,13,44.23076923076923,191.66666666666666,2875,47.916666666666664,3000000000,62.608695652173914
650,9,7,16,40.625,92.85714285714286,3250,54.166666666666664,7000000000,129.23076923076923
1220,20,3,23,53.04347826086956,406.6666666666667,6100,101.66666666666667,3000000000,29.50819672131147
972,11,3,14,69.42857142857143,324,4860,81,3000000000,37.03703703703704
771,13,5,18,42.833333333333336,154.2,3855,64.25,5000000000,77.82101167315174
424,8,3,11,38.54545454545455,141.33333333333334,2120,35.333333333333336,3000000000,84.90566037735849
495,8,3,11,45,165,2475,41.25,3000000000,72.72727272727273
682,7,3,10,68.2,227.33333333333334,3410,56.833333333333336,3000000000,52.785923753665685
797,5,3,8,99.625,265.6666666666667,3985,66.41666666666667,3000000000,45.1693851944793
554,5,4,9,61.55555555555556,138.5,2770,46.166666666666664,4000000000,86.64259927797835
1062,6,8,14,75.85714285714286,132.75,5310,88.5,8000000000,90.3954802259887
345,8,4,12,28.75,86.25,1725,28.75,4000000000,139.1304347826087
670,12,3,15,44.666666666666664,223.33333333333334,3350,55.833333333333336,3000000000,53.731343283582085
318,7,3,10,31.8,106,1590,26.5,3000000000,113.20754716981132
833,16,3,19,43.8421052631579,277.6666666666667,4165,69.41666666666667,3000000000,43.2172869147659
823,5,6,11,74.81818181818181,137.16666666666666,4115,68.58333333333333,6000000000,87.48481166464155
843,13,4,17,49.588235294117645,210.75,4215,70.25,4000000000,56.93950177935943
580,11,3,14,41.42857142857143,193.33333333333334,2900,48.333333333333336,3000000000,62.068965517241374
1016,12,4,16,63.5,254,5080,84.66666666666667,4000000000,47.24409448818898
562,8,3,11,51.09090909090909,187.33333333333334,2810,46.833333333333336,3000000000,64.05693950177935
1011,12,4,16,63.1875,252.75,5055,84.25,4000000000,47.47774480712167
632,9,3,12,52.666666666666664,210.66666666666666,3160,52.666666666666664,3000000000,56.9620253164557
652,13,6,19,34.31578947368421,108.66666666666667,3260,54.333333333333336,6000000000,110.42944785276073
775,13,4,17,45.588235294117645,193.75,3875,64.58333333333333,4000000000,61.935483870967744
575,7,4,11,52.27272727272727,143.75,2875,47.916666666666664,4000000000,83.47826086956522
661,7,4,11,60.09090909090909,165.25,3305,55.083333333333336,4000000000,72.61724659606656
416,5,3,8,52,138.66666666666666,2080,34.666666666666664,3000000000,86.53846153846155
898,20,3,23,39.04347826086956,299.3333333333333,4490,74.83333333333333,3000000000,40.0890868596882
819,13,3,16,51.1875,273,4095,68.25,3000000000,43.956043956043956
827,13,10,23,35.95652173913044,82.7,4135,68.91666666666667,10000000000,145.10278113663844
1102,16,3,19,58,367.3333333333333,5510,91.83333333333333,3000000000,32.667876588021784
596,9,4,13,45.84615384615385,149,2980,49.666666666666664,4000000000,80.53691275167786
794,12,3,15,52.93333333333333,264.6666666666667,3970,66.16666666666667,3000000000,45.34005037783375
812,14,8,22,36.90909090909091,101.5,4060,67.66666666666667,8000000000,118.22660098522167
581,6,3,9,64.55555555555556,193.66666666666666,2905,48.416666666666664,3000000000,61.96213425129088
978,14,3,17,57.529411764705884,326,4890,81.5,3000000000,36.809815950920246
538,8,3,11,48.90909090909091,179.33333333333334,2690,44.833333333333336,3000000000,66.91449814126393
856,14,4,18,47.55555555555556,214,4280,71.33333333333333,4000000000,56.07476635514019
1141,27,3,30,38.03333333333333,380.3333333333333,5705,95.08333333333333,3000000000,31.551270815074496
1168,7,12,19,61.473684210526315,97.33333333333333,5840,97.33333333333333,12000000000,123.28767123287672
556,9,3,12,46.333333333333336,185.33333333333334,2780,46.333333333333336,3000000000,64.74820143884892
674,16,3,19,35.473684210526315,224.66666666666666,3370,56.166666666666664,3000000000,53.41246290801187
602,13,3,16,37.625,200.66666666666666,3010,50.166666666666664,3000000000,59.800664451827245
726,12,3,15,48.4,242,3630,60.5,3000000000,49.586776859504134
848,16,4,20,42.4,212,4240,70.66666666666667,4000000000,56.60377358490565
486,11,4,15,32.4,121.5,2430,40.5,4000000000,98.76543209876543
410,7,3,10,41,136.66666666666666,2050,34.166666666666664,3000000000,87.8048780487805
485,6,4,10,48.5,121.25,2425,40.416666666666664,4000000000,98.96907216494846
1088,22,3,25,43.52,362.6666666666667,5440,90.66666666666667,3000000000,33.088235294117645
517,9,3,12,43.083333333333336,172.33333333333334,2585,43.083333333333336,3000000000,69.63249516441006
671,15,3,18,37.27777777777778,223.66666666666666,3355,55.916666666666664,3000000000,53.65126676602087
937,8,7,15,62.46666666666667,133.85714285714286,4685,78.08333333333333,7000000000,89.64781216648879
630,9,3,12,52.5,210,3150,52.5,3000000000,57.14285714285714
196,3,4,7,28,49,980,16.333333333333332,4000000000,244.8979591836735
1047,16,4,20,52.35,261.75,5235,87.25,4000000000,45.845272206303726
855,19,3,22,38.86363636363637,285,4275,71.25,3000000000,42.10526315789474
487,6,3,9,54.111111111111114,162.33333333333334,2435,40.583333333333336,3000000000,73.92197125256672
910,15,3,18,50.55555555555556,303.3333333333333,4550,75.83333333333333,3000000000,39.56043956043956
747,11,8,19,39.31578947368421,93.375,3735,62.25,8000000000,128.5140562248996
686,13,3,16,42.875,228.66666666666666,3430,57.166666666666664,3000000000,52.478134110787174
942,15,9,24,39.25,104.66666666666667,4710,78.5,9000000000,114.64968152866241
438,5,4,9,48.666666666666664,109.5,2190,36.5,4000000000,109.58904109589042
989,21,5,26,38.03846153846154,197.8,4945,82.41666666666667,5000000000,60.66734074823053
372,8,4,12,31,93,1860,31,4000000000,129.03225806451613
501,8,3,11,45.54545454545455,167,2505,41.75,3000000000,71.85628742514969
392,5,3,8,49,130.66666666666666,1960,32.666666666666664,3000000000,91.83673469387756
591,14,6,20,29.55,98.5,2955,49.25,6000000000,121.82741116751268
768,9,3,12,64,256,3840,64,3000000000,46.875
565,7,3,10,56.5,188.33333333333334,2825,47.083333333333336,3000000000,63.716814159292035
764,18,8,26,29.384615384615383,95.5,3820,63.666666666666664,8000000000,125.65445026178011
484,4,3,7,69.14285714285714,161.33333333333334,2420,40.333333333333336,3000000000,74.3801652892562
820,11,4,15,54.666666666666664,205,4100,68.33333333333333,4000000000,58.53658536585366
627,10,7,17,36.88235294117647,89.57142857142857,3135,52.25,7000000000,133.9712918660287
399,5,5,10,39.9,79.8,1995,33.25,5000000000,150.37593984962407
1148,22,11,33,34.78787878787879,104.36363636363636,5740,95.66666666666667,11000000000,114.98257839721254
691,9,9,18,38.388888888888886,76.77777777777777,3455,57.583333333333336,9000000000,156.29522431259045
403,6,4,10,40.3,100.75,2015,33.583333333333336,4000000000,119.10669975186103
364,6,5,11,33.09090909090909,72.8,1820,30.333333333333332,5000000000,164.83516483516485
702,12,3,15,46.8,234,3510,58.5,3000000000,51.28205128205128
382,6,3,9,42.44444444444444,127.33333333333333,1910,31.833333333333332,3000000000,94.24083769633508
262,4,3,7,37.42857142857143,87.33333333333333,1310,21.833333333333332,3000000000,137.40458015267174
501,12,4,16,31.3125,125.25,2505,41.75,4000000000,95.80838323353294
729,6,4,10,72.9,182.25,3645,60.75,4000000000,65.84362139917695
939,17,9,26,36.11538461538461,104.33333333333333,4695,78.25,9000000000,115.01597444089457
472,13,3,16,29.5,157.33333333333334,2360,39.333333333333336,3000000000,76.27118644067795
759,17,3,20,37.95,253,3795,63.25,3000000000,47.430830039525695
897,12,9,21,42.714285714285715,99.66666666666667,4485,74.75,9000000000,120.40133779264215
726,12,3,15,48.4,242,3630,60.5,3000000000,49.586776859504134
885,11,3,14,63.214285714285715,295,4425,73.75,3000000000,40.67796610169491
594,6,3,9,66,198,2970,49.5,3000000000,60.60606060606061
510,7,3,10,51,170,2550,42.5,3000000000,70.58823529411764
988,21,3,24,41.166666666666664,329.3333333333333,4940,82.33333333333333,3000000000,36.43724696356276
444,14,3,17,26.11764705882353,148,2220,37,3000000000,81.08108108108108
1559,25,3,28,55.67857142857143,519.6666666666666,7795,129.91666666666666,3000000000,23.091725465041694
380,4,3,7,54.285714285714285,126.66666666666667,1900,31.666666666666668,3000000000,94.73684210526316
1778,22,3,25,71.12,592.6666666666666,8890,148.16666666666666,3000000000,20.247469066366705
355,7,3,10,35.5,118.33333333333333,1775,29.583333333333332,3000000000,101.40845070422536
388,6,3,9,43.111111111111114,129.33333333333334,1940,32.333333333333336,3000000000,92.78350515463917
275,3,5,8,34.375,55,1375,22.916666666666668,5000000000,218.18181818181816
313,4,3,7,44.714285714285715,104.33333333333333,1565,26.083333333333332,3000000000,115.01597444089457
554,4,3,7,79.14285714285714,184.66666666666666,2770,46.166666666666664,3000000000,64.98194945848375
295,9,3,12,24.583333333333332,98.33333333333333,1475,24.583333333333332,3000000000,122.03389830508475
605,19,3,22,27.5,201.66666666666666,3025,50.416666666666664,3000000000,59.50413223140496
480,5,3,8,60,160,2400,40,3000000000,75
206,6,3,9,22.88888888888889,68.66666666666667,1030,17.166666666666668,3000000000,174.75728155339803
660,14,3,17,38.8235294117647,220,3300,55,3000000000,54.54545454545455
279,6,3,9,31,93,1395,23.25,3000000000,129.03225806451613
344,8,3,11,31.272727272727273,114.66666666666667,1720,28.666666666666668,3000000000,104.65116279069767
763,13,3,16,47.6875,254.33333333333334,3815,63.583333333333336,3000000000,47.18217562254259
377,6,5,11,34.27272727272727,75.4,1885,31.416666666666668,5000000000,159.15119363395226
531,7,3,10,53.1,177,2655,44.25,3000000000,67.79661016949153
592,6,6,12,49.333333333333336,98.66666666666667,2960,49.333333333333336,6000000000,121.62162162162161
664,9,6,15,44.266666666666666,110.66666666666667,3320,55.333333333333336,6000000000,108.43373493975903
991,11,5,16,61.9375,198.2,4955,82.58333333333333,5000000000,60.54490413723512
603,7,3,10,60.3,201,3015,50.25,3000000000,59.701492537313435
1081,11,3,14,77.21428571428571,360.3333333333333,5405,90.08333333333333,3000000000,33.30249768732655
355,8,3,11,32.27272727272727,118.33333333333333,1775,29.583333333333332,3000000000,101.40845070422536
622,7,3,10,62.2,207.33333333333334,3110,51.833333333333336,3000000000,57.877813504823145
573,6,3,9,63.666666666666664,191,2865,47.75,3000000000,62.82722513089005
316,4,4,8,39.5,79,1580,26.333333333333332,4000000000,151.89873417721518
585,13,3,16,36.5625,195,2925,48.75,3000000000,61.53846153846153
758,12,5,17,44.588235294117645,151.6,3790,63.166666666666664,5000000000,79.155672823219
620,11,3,14,44.285714285714285,206.66666666666666,3100,51.666666666666664,3000000000,58.06451612903226
422,5,3,8,52.75,140.66666666666666,2110,35.166666666666664,3000000000,85.30805687203792
359,7,3,10,35.9,119.66666666666667,1795,29.916666666666668,3000000000,100.27855153203343
610,12,3,15,40.666666666666664,203.33333333333334,3050,50.833333333333336,3000000000,59.01639344262294
521,9,3,12,43.416666666666664,173.66666666666666,2605,43.416666666666664,3000000000,69.0978886756238
438,6,4,10,43.8,109.5,2190,36.5,4000000000,109.58904109589042
875,13,3,16,54.6875,291.6666666666667,4375,72.91666666666667,3000000000,41.14285714285714
862,9,3,12,71.83333333333333,287.3333333333333,4310,71.83333333333333,3000000000,41.76334106728539
705,12,4,16,44.0625,176.25,3525,58.75,4000000000,68.08510638297872
526,8,3,11,47.81818181818182,175.33333333333334,2630,43.833333333333336,3000000000,68.44106463878326
455,3,3,6,75.83333333333333,151.66666666666666,2275,37.916666666666664,3000000000,79.12087912087912
481,5,3,8,60.125,160.33333333333334,2405,40.083333333333336,3000000000,74.84407484407484
519,3,5,8,64.875,103.8,2595,43.25,5000000000,115.60693641618498
544,10,5,15,36.266666666666666,108.8,2720,45.333333333333336,5000000000,110.29411764705881
786,10,3,13,60.46153846153846,262,3930,65.5,3000000000,45.80152671755725
888,8,6,14,63.42857142857143,148,4440,74,6000000000,81.08108108108108
320,7,3,10,32,106.66666666666667,1600,26.666666666666668,3000000000,112.5
662,10,3,13,50.92307692307692,220.66666666666666,3310,55.166666666666664,3000000000,54.38066465256797
741,11,8,19,39,92.625,3705,61.75,8000000000,129.55465587044534
555,7,3,10,55.5,185,2775,46.25,3000000000,64.86486486486487
1160,16,6,22,52.72727272727273,193.33333333333334,5800,96.66666666666667,6000000000,62.068965517241374
508,13,4,17,29.88235294117647,127,2540,42.333333333333336,4000000000,94.48818897637796
784,8,8,16,49,98,3920,65.33333333333333,8000000000,122.44897959183675
671,6,4,10,67.1,167.75,3355,55.916666666666664,4000000000,71.53502235469449
542,7,3,10,54.2,180.66666666666666,2710,45.166666666666664,3000000000,66.42066420664207
437,5,5,10,43.7,87.4,2185,36.416666666666664,5000000000,137.29977116704808
778,15,3,18,43.22222222222222,259.3333333333333,3890,64.83333333333333,3000000000,46.27249357326478
499,13,3,16,31.1875,166.33333333333334,2495,41.583333333333336,3000000000,72.14428857715431
596,8,4,12,49.666666666666664,149,2980,49.666666666666664,4000000000,80.53691275167786
332,8,3,11,30.181818181818183,110.66666666666667,1660,27.666666666666668,3000000000,108.43373493975903
1037,17,14,31,33.45161290322581,74.07142857142857,5185,86.41666666666667,14000000000,162.00578592092575
587,12,3,15,39.13333333333333,195.66666666666666,2935,48.916666666666664,3000000000,61.32879045996593
488,14,3,17,28.705882352941178,162.66666666666666,2440,40.666666666666664,3000000000,73.7704918032787
698,12,5,17,41.05882352941177,139.6,3490,58.166666666666664,5000000000,85.95988538681948
387,6,3,9,43,129,1935,32.25,3000000000,93.02325581395348
935,17,3,20,46.75,311.6666666666667,4675,77.91666666666667,3000000000,38.50267379679144
1146,13,5,18,63.666666666666664,229.2,5730,95.5,5000000000,52.35602094240838
925,16,3,19,48.68421052631579,308.3333333333333,4625,77.08333333333333,3000000000,38.91891891891892
272,7,3,10,27.2,90.66666666666667,1360,22.666666666666668,3000000000,132.35294117647058
328,6,3,9,36.44444444444444,109.33333333333333,1640,27.333333333333332,3000000000,109.7560975609756
800,8,8,16,50,100,4000,66.66666666666667,8000000000,119.99999999999999
693,7,3,10,69.3,231,3465,57.75,3000000000,51.94805194805195
388,6,3,9,43.111111111111114,129.33333333333334,1940,32.333333333333336,3000000000,92.78350515463917
665,10,3,13,51.15384615384615,221.66666666666666,3325,55.416666666666664,3000000000,54.13533834586466
664,9,3,12,55.333333333333336,221.33333333333334,3320,55.333333333333336,3000000000,54.21686746987952
770,9,8,17,45.294117647058826,96.25,3850,64.16666666666667,8000000000,124.67532467532466
1012,14,5,19,53.26315789473684,202.4,5060,84.33333333333333,5000000000,59.28853754940712
859,17,3,20,42.95,286.3333333333333,4295,71.58333333333333,3000000000,41.909196740395814
585,7,4,11,53.18181818181818,146.25,2925,48.75,4000000000,82.05128205128204
372,3,4,7,53.142857142857146,93,1860,31,4000000000,129.03225806451613
409,10,3,13,31.46153846153846,136.33333333333334,2045,34.083333333333336,3000000000,88.01955990220048
861,24,3,27,31.88888888888889,287,4305,71.75,3000000000,41.811846689895475
1346,25,10,35,38.457142857142856,134.6,6730,112.16666666666667,10000000000,89.15304606240713
1289,15,7,22,58.59090909090909,184.14285714285714,6445,107.41666666666667,7000000000,65.166795965865
461,6,4,10,46.1,115.25,2305,38.416666666666664,4000000000,104.12147505422995
906,16,3,19,47.68421052631579,302,4530,75.5,3000000000,39.735099337748345
203,4,4,8,25.375,50.75,1015,16.916666666666668,4000000000,236.45320197044333
518,5,4,9,57.55555555555556,129.5,2590,43.166666666666664,4000000000,92.66409266409268
595,7,3,10,59.5,198.33333333333334,2975,49.583333333333336,3000000000,60.50420168067227
715,11,3,14,51.07142857142857,238.33333333333334,3575,59.583333333333336,3000000000,50.34965034965035
1055,6,8,14,75.35714285714286,131.875,5275,87.91666666666667,8000000000,90.99526066350711
1101,10,9,19,57.94736842105263,122.33333333333333,5505,91.75,9000000000,98.09264305177112
417,6,3,9,46.333333333333336,139,2085,34.75,3000000000,86.33093525179855
750,14,3,17,44.11764705882353,250,3750,62.5,3000000000,48
812,14,3,17,47.76470588235294,270.6666666666667,4060,67.66666666666667,3000000000,44.33497536945812
541,13,3,16,33.8125,180.33333333333334,2705,45.083333333333336,3000000000,66.54343807763401
518,4,3,7,74,172.66666666666666,2590,43.166666666666664,3000000000,69.4980694980695
717,10,3,13,55.15384615384615,239,3585,59.75,3000000000,50.2092050209205
867,14,5,19,45.63157894736842,173.4,4335,72.25,5000000000,69.20415224913495
585,8,3,11,53.18181818181818,195,2925,48.75,3000000000,61.53846153846153
1311,19,3,22,59.59090909090909,437,6555,109.25,3000000000,27.45995423340961
520,8,3,11,47.27272727272727,173.33333333333334,2600,43.333333333333336,3000000000,69.23076923076923
1413,14,9,23,61.43478260869565,157,7065,117.75,9000000000,76.43312101910828
535,13,3,16,33.4375,178.33333333333334,2675,44.583333333333336,3000000000,67.28971962616822
267,4,3,7,38.142857142857146,89,1335,22.25,3000000000,134.83146067415728
402,5,6,11,36.54545454545455,67,2010,33.5,6000000000,179.1044776119403
441,11,4,15,29.4,110.25,2205,36.75,4000000000,108.843537414966
563,9,3,12,46.916666666666664,187.66666666666666,2815,46.916666666666664,3000000000,63.94316163410302
670,14,3,17,39.411764705882355,223.33333333333334,3350,55.833333333333336,3000000000,53.731343283582085
729,10,5,15,48.6,145.8,3645,60.75,5000000000,82.3045267489712
531,6,3,9,59,177,2655,44.25,3000000000,67.79661016949153
796,6,5,11,72.36363636363636,159.2,3980,66.33333333333333,5000000000,75.37688442211056
449,7,5,12,37.416666666666664,89.8,2245,37.416666666666664,5000000000,133.630289532294
286,9,3,12,23.833333333333332,95.33333333333333,1430,23.833333333333332,3000000000,125.87412587412588
751,13,3,16,46.9375,250.33333333333334,3755,62.583333333333336,3000000000,47.93608521970706
700,18,9,27,25.925925925925927,77.77777777777777,3500,58.333333333333336,9000000000,154.28571428571428
802,8,3,11,72.9090909090909,267.3333333333333,4010,66.83333333333333,3000000000,44.887780548628434
802,8,3,11,72.9090909090909,267.3333333333333,4010,66.83333333333333,3000000000,44.887780548628434
745,19,3,22,33.86363636363637,248.33333333333334,3725,62.083333333333336,3000000000,48.32214765100671
848,13,10,23,36.869565217391305,84.8,4240,70.66666666666667,10000000000,141.50943396226415
1159,16,3,19,61,386.3333333333333,5795,96.58333333333333,3000000000,31.06125970664366
831,16,4,20,41.55,207.75,4155,69.25,4000000000,57.761732851985556
825,15,3,18,45.833333333333336,275,4125,68.75,3000000000,43.63636363636363
449,8,3,11,40.81818181818182,149.66666666666666,2245,37.416666666666664,3000000000,80.1781737193764
712,10,3,13,54.76923076923077,237.33333333333334,3560,59.333333333333336,3000000000,50.561797752808985
369,4,6,10,36.9,61.5,1845,30.75,6000000000,195.1219512195122
715,11,5,16,44.6875,143,3575,59.583333333333336,5000000000,83.91608391608392
482,12,3,15,32.13333333333333,160.66666666666666,2410,40.166666666666664,3000000000,74.68879668049793
1123,19,4,23,48.82608695652174,280.75,5615,93.58333333333333,4000000000,42.742653606411395
1010,10,15,25,40.4,67.33333333333333,5050,84.16666666666667,15000000000,178.2178217821782
457,9,3,12,38.083333333333336,152.33333333333334,2285,38.083333333333336,3000000000,78.77461706783369
1131,13,9,22,51.40909090909091,125.66666666666667,5655,94.25,9000000000,95.49071618037136
829,9,6,15,55.266666666666666,138.16666666666666,4145,69.08333333333333,6000000000,86.85162846803378
731,11,3,14,52.214285714285715,243.66666666666666,3655,60.916666666666664,3000000000,49.24760601915185
492,9,6,15,32.8,82,2460,41,6000000000,146.34146341463415
727,10,5,15,48.46666666666667,145.4,3635,60.583333333333336,5000000000,82.53094910591471
958,11,3,14,68.42857142857143,319.3333333333333,4790,79.83333333333333,3000000000,37.57828810020877
934,16,7,23,40.608695652173914,133.42857142857142,4670,77.83333333333333,7000000000,89.93576017130623
571,9,5,14,40.785714285714285,114.2,2855,47.583333333333336,5000000000,105.07880910683012
388,7,4,11,35.27272727272727,97,1940,32.333333333333336,4000000000,123.71134020618557
634,14,3,17,37.294117647058826,211.33333333333334,3170,52.833333333333336,3000000000,56.78233438485804
552,8,3,11,50.18181818181818,184,2760,46,3000000000,65.21739130434783
493,7,5,12,41.083333333333336,98.6,2465,41.083333333333336,5000000000,121.70385395537524
463,8,3,11,42.09090909090909,154.33333333333334,2315,38.583333333333336,3000000000,77.7537796976242
356,4,3,7,50.857142857142854,118.66666666666667,1780,29.666666666666668,3000000000,101.12359550561797
842,13,11,24,35.083333333333336,76.54545454545455,4210,70.16666666666667,11000000000,156.76959619952493
389,5,3,8,48.625,129.66666666666666,1945,32.416666666666664,3000000000,92.54498714652956
1089,11,5,16,68.0625,217.8,5445,90.75,5000000000,55.09641873278237
733,12,3,15,48.86666666666667,244.33333333333334,3665,61.083333333333336,3000000000,49.113233287858115
657,12,3,15,43.8,219,3285,54.75,3000000000,54.79452054794521
1205,18,3,21,57.38095238095238,401.6666666666667,6025,100.41666666666667,3000000000,29.875518672199167
512,13,3,16,32,170.66666666666666,2560,42.666666666666664,3000000000,70.3125
374,9,3,12,31.166666666666668,124.66666666666667,1870,31.166666666666668,3000000000,96.2566844919786
1206,15,13,28,43.07142857142857,92.76923076923077,6030,100.5,13000000000,129.35323383084577
1149,15,6,21,54.714285714285715,191.5,5745,95.75,6000000000,62.66318537859008
514,6,7,13,39.53846153846154,73.42857142857143,2570,42.833333333333336,7000000000,163.42412451361866
1025,19,8,27,37.96296296296296,128.125,5125,85.41666666666667,8000000000,93.65853658536585
800,19,6,25,32,133.33333333333334,4000,66.66666666666667,6000000000,90
879,10,8,18,48.833333333333336,109.875,4395,73.25,8000000000,109.2150170648464
511,8,6,14,36.5,85.16666666666667,2555,42.583333333333336,6000000000,140.90019569471625
825,18,4,22,37.5,206.25,4125,68.75,4000000000,58.18181818181818
615,9,6,15,41,102.5,3075,51.25,6000000000,117.07317073170732
481,12,4,16,30.0625,120.25,2405,40.083333333333336,4000000000,99.79209979209979
1079,14,5,19,56.78947368421053,215.8,5395,89.91666666666667,5000000000,55.60704355885079
781,16,6,22,35.5,130.16666666666666,3905,65.08333333333333,6000000000,92.18950064020488
954,9,3,12,79.5,318,4770,79.5,3000000000,37.735849056603776
312,7,3,10,31.2,104,1560,26,3000000000,115.38461538461539
999,10,3,13,76.84615384615384,333,4995,83.25,3000000000,36.03603603603604
588,11,4,15,39.2,147,2940,49,4000000000,81.63265306122449
197,4,3,7,28.142857142857142,65.66666666666667,985,16.416666666666668,3000000000,182.741116751269
887,11,6,17,52.1764705882353,147.83333333333334,4435,73.91666666666667,6000000000,81.17249154453212
352,10,3,13,27.076923076923077,117.33333333333333,1760,29.333333333333332,3000000000,102.27272727272728
1251,18,8,26,48.11538461538461,156.375,6255,104.25,8000000000,76.73860911270984
1202,21,3,24,50.083333333333336,400.6666666666667,6010,100.16666666666667,3000000000,29.95008319467554
852,11,3,14,60.857142857142854,284,4260,71,3000000000,42.25352112676057
863,9,3,12,71.91666666666667,287.6666666666667,4315,71.91666666666667,3000000000,41.71494785631517
519,6,6,12,43.25,86.5,2595,43.25,6000000000,138.72832369942196
1104,22,3,25,44.16,368,5520,92,3000000000,32.608695652173914
659,11,6,17,38.76470588235294,109.83333333333333,3295,54.916666666666664,6000000000,109.25644916540213
736,9,3,12,61.333333333333336,245.33333333333334,3680,61.333333333333336,3000000000,48.91304347826087
402,9,3,12,33.5,134,2010,33.5,3000000000,89.55223880597015
758,10,3,13,58.30769230769231,252.66666666666666,3790,63.166666666666664,3000000000,47.4934036939314
363,6,4,10,36.3,90.75,1815,30.25,4000000000,132.23140495867767
1209,14,3,17,71.11764705882354,403,6045,100.75,3000000000,29.776674937965257
713,12,8,20,35.65,89.125,3565,59.416666666666664,8000000000,134.6423562412342
486,5,3,8,60.75,162,2430,40.5,3000000000,74.07407407407408
878,16,7,23,38.17391304347826,125.42857142857143,4390,73.16666666666667,7000000000,95.67198177676538
517,8,5,13,39.76923076923077,103.4,2585,43.083333333333336,5000000000,116.05415860735009
305,7,3,10,30.5,101.66666666666667,1525,25.416666666666668,3000000000,118.03278688524588
228,5,4,9,25.333333333333332,57,1140,19,4000000000,210.52631578947367
479,8,3,11,43.54545454545455,159.66666666666666,2395,39.916666666666664,3000000000,75.15657620041755
325,5,3,8,40.625,108.33333333333333,1625,27.083333333333332,3000000000,110.76923076923077
1307,18,13,31,42.16129032258065,100.53846153846153,6535,108.91666666666667,13000000000,119.35730680948737
536,13,4,17,31.529411764705884,134,2680,44.666666666666664,4000000000,89.55223880597015
451,7,6,13,34.69230769230769,75.16666666666667,2255,37.583333333333336,6000000000,159.64523281596453
376,7,3,10,37.6,125.33333333333333,1880,31.333333333333332,3000000000,95.74468085106383
898,15,3,18,49.888888888888886,299.3333333333333,4490,74.83333333333333,3000000000,40.0890868596882
744,14,3,17,43.76470588235294,248,3720,62,3000000000,48.387096774193544
785,15,5,20,39.25,157,3925,65.41666666666667,5000000000,76.43312101910828
717,11,6,17,42.1764705882353,119.5,3585,59.75,6000000000,100.418410041841
610,9,8,17,35.88235294117647,76.25,3050,50.833333333333336,8000000000,157.37704918032787
515,4,3,7,73.57142857142857,171.66666666666666,2575,42.916666666666664,3000000000,69.90291262135923
577,9,3,12,48.083333333333336,192.33333333333334,2885,48.083333333333336,3000000000,62.39168110918544
425,5,3,8,53.125,141.66666666666666,2125,35.416666666666664,3000000000,84.70588235294119
657,7,3,10,65.7,219,3285,54.75,3000000000,54.79452054794521
665,18,6,24,27.708333333333332,110.83333333333333,3325,55.416666666666664,6000000000,108.27067669172932
479,8,3,11,43.54545454545455,159.66666666666666,2395,39.916666666666664,3000000000,75.15657620041755
651,5,4,9,72.33333333333333,162.75,3255,54.25,4000000000,73.73271889400922
573,10,4,14,40.92857142857143,143.25,2865,47.75,4000000000,83.7696335078534
691,14,6,20,34.55,115.16666666666667,3455,57.583333333333336,6000000000,104.19681620839363
503,5,6,11,45.72727272727273,83.83333333333333,2515,41.916666666666664,6000000000,143.14115308151094
1048,9,5,14,74.85714285714286,209.6,5240,87.33333333333333,5000000000,57.25190839694656
736,15,7,22,33.45454545454545,105.14285714285714,3680,61.333333333333336,7000000000,114.13043478260869
540,11,3,14,38.57142857142857,180,2700,45,3000000000,66.66666666666666
706,8,3,11,64.18181818181819,235.33333333333334,3530,58.833333333333336,3000000000,50.991501416430594
358,8,3,11,32.54545454545455,119.33333333333333,1790,29.833333333333332,3000000000,100.5586592178771
398,4,5,9,44.22222222222222,79.6,1990,33.166666666666664,5000000000,150.75376884422113
583,8,5,13,44.84615384615385,116.6,2915,48.583333333333336,5000000000,102.91595197255575
509,7,3,10,50.9,169.66666666666666,2545,42.416666666666664,3000000000,70.7269155206287
592,14,3,17,34.8235294117647,197.33333333333334,2960,49.333333333333336,3000000000,60.81081081081081
378,5,3,8,47.25,126,1890,31.5,3000000000,95.23809523809524
253,3,3,6,42.166666666666664,84.33333333333333,1265,21.083333333333332,3000000000,142.2924901185771
811,20,13,33,24.575757575757574,62.38461538461539,4055,67.58333333333333,13000000000,192.35511713933417
725,12,3,15,48.333333333333336,241.66666666666666,3625,60.416666666666664,3000000000,49.6551724137931
633,9,5,14,45.214285714285715,126.6,3165,52.75,5000000000,94.7867298578199
754,5,4,9,83.77777777777777,188.5,3770,62.833333333333336,4000000000,63.6604774535809
470,6,3,9,52.22222222222222,156.66666666666666,2350,39.166666666666664,3000000000,76.59574468085107
805,11,3,14,57.5,268.3333333333333,4025,67.08333333333333,3000000000,44.72049689440994
769,11,8,19,40.473684210526315,96.125,3845,64.08333333333333,8000000000,124.83745123537062
526,7,5,12,43.833333333333336,105.2,2630,43.833333333333336,5000000000,114.06844106463878
192,4,3,7,27.428571428571427,64,960,16,3000000000,187.5
343,8,3,11,31.181818181818183,114.33333333333333,1715,28.583333333333332,3000000000,104.95626822157435
753,11,3,14,53.785714285714285,251,3765,62.75,3000000000,47.808764940239044
383,5,3,8,47.875,127.66666666666667,1915,31.916666666666668,3000000000,93.99477806788512
841,12,3,15,56.06666666666667,280.3333333333333,4205,70.08333333333333,3000000000,42.80618311533888
585,12,3,15,39,195,2925,48.75,3000000000,61.53846153846153
427,6,3,9,47.44444444444444,142.33333333333334,2135,35.583333333333336,3000000000,84.30913348946135
416,5,3,8,52,138.66666666666666,2080,34.666666666666664,3000000000,86.53846153846155
932,5,6,11,84.72727272727273,155.33333333333334,4660,77.66666666666667,6000000000,77.25321888412017
385,7,3,10,38.5,128.33333333333334,1925,32.083333333333336,3000000000,93.5064935064935
366,11,3,14,26.142857142857142,122,1830,30.5,3000000000,98.36065573770492
602,5,6,11,54.72727272727273,100.33333333333333,3010,50.166666666666664,6000000000,119.60132890365449
325,4,5,9,36.111111111111114,65,1625,27.083333333333332,5000000000,184.61538461538464
222,3,3,6,37,74,1110,18.5,3000000000,162.16216216216216
872,6,3,9,96.88888888888889,290.6666666666667,4360,72.66666666666667,3000000000,41.28440366972477
604,8,6,14,43.142857142857146,100.66666666666667,3020,50.333333333333336,6000000000,119.20529801324503
578,6,4,10,57.8,144.5,2890,48.166666666666664,4000000000,83.04498269896195
561,6,10,16,35.0625,56.1,2805,46.75,10000000000,213.903743315508
614,11,3,14,43.857142857142854,204.66666666666666,3070,51.166666666666664,3000000000,58.63192182410423
281,4,3,7,40.142857142857146,93.66666666666667,1405,23.416666666666668,3000000000,128.1138790035587
682,13,3,16,42.625,227.33333333333334,3410,56.833333333333336,3000000000,52.785923753665685
383,8,3,11,34.81818181818182,127.66666666666667,1915,31.916666666666668,3000000000,93.99477806788512
1040,12,3,15,69.33333333333333,346.6666666666667,5200,86.66666666666667,3000000000,34.61538461538461
615,11,6,17,36.1764705882353,102.5,3075,51.25,6000000000,117.07317073170732
355,3,6,9,39.44444444444444,59.166666666666664,1775,29.583333333333332,6000000000,202.81690140845072
904,12,5,17,53.1764705882353,180.8,4520,75.33333333333333,5000000000,66.3716814159292
478,9,3,12,39.833333333333336,159.33333333333334,2390,39.833333333333336,3000000000,75.31380753138075
734,10,5,15,48.93333333333333,146.8,3670,61.166666666666664,5000000000,81.74386920980928
471,4,4,8,58.875,117.75,2355,39.25,4000000000,101.91082802547771
177,6,3,9,19.666666666666668,59,885,14.75,3000000000,203.38983050847457
829,12,3,15,55.266666666666666,276.3333333333333,4145,69.08333333333333,3000000000,43.42581423401689
1231,20,5,25,49.24,246.2,6155,102.58333333333333,5000000000,48.740861088545905
532,6,4,10,53.2,133,2660,44.333333333333336,4000000000,90.22556390977444
720,10,8,18,40,90,3600,60,8000000000,133.33333333333331
768,10,5,15,51.2,153.6,3840,64,5000000000,78.125
429,5,3,8,53.625,143,2145,35.75,3000000000,83.91608391608392
1171,14,3,17,68.88235294117646,390.3333333333333,5855,97.58333333333333,3000000000,30.742954739538856
676,12,3,15,45.06666666666667,225.33333333333334,3380,56.333333333333336,3000000000,53.25443786982248
308,6,6,12,25.666666666666668,51.333333333333336,1540,25.666666666666668,6000000000,233.76623376623374
756,11,5,16,47.25,151.2,3780,63,5000000000,79.36507936507935
706,12,4,16,44.125,176.5,3530,58.833333333333336,4000000000,67.98866855524079
1096,23,7,30,36.53333333333333,156.57142857142858,5480,91.33333333333333,7000000000,76.64233576642336
627,14,3,17,36.88235294117647,209,3135,52.25,3000000000,57.41626794258373
295,4,4,8,36.875,73.75,1475,24.583333333333332,4000000000,162.71186440677968
521,10,3,13,40.07692307692308,173.66666666666666,2605,43.416666666666664,3000000000,69.0978886756238
344,5,3,8,43,114.66666666666667,1720,28.666666666666668,3000000000,104.65116279069767
799,11,3,14,57.07142857142857,266.3333333333333,3995,66.58333333333333,3000000000,45.056320400500624
675,9,6,15,45,112.5,3375,56.25,6000000000,106.66666666666667
422,7,3,10,42.2,140.66666666666666,2110,35.166666666666664,3000000000,85.30805687203792
238,6,3,9,26.444444444444443,79.33333333333333,1190,19.833333333333332,3000000000,151.2605042016807
512,15,3,18,28.444444444444443,170.66666666666666,2560,42.666666666666664,3000000000,70.3125
1143,26,8,34,33.61764705882353,142.875,5715,95.25,8000000000,83.98950131233595
708,9,6,15,47.2,118,3540,59,6000000000,101.69491525423729
317,6,3,9,35.22222222222222,105.66666666666667,1585,26.416666666666668,3000000000,113.56466876971608
551,9,4,13,42.38461538461539,137.75,2755,45.916666666666664,4000000000,87.11433756805808
750,11,4,15,50,187.5,3750,62.5,4000000000,64
255,4,3,7,36.42857142857143,85,1275,21.25,3000000000,141.17647058823528
949,13,7,20,47.45,135.57142857142858,4745,79.08333333333333,7000000000,88.51422550052688
559,11,3,14,39.92857142857143,186.33333333333334,2795,46.583333333333336,3000000000,64.40071556350627
572,12,3,15,38.13333333333333,190.66666666666666,2860,47.666666666666664,3000000000,62.93706293706294
1317,17,3,20,65.85,439,6585,109.75,3000000000,27.33485193621868
195,4,5,9,21.666666666666668,39,975,16.25,5000000000,307.69230769230774
1578,28,3,31,50.903225806451616,526,7890,131.5,3000000000,22.813688212927755
893,15,6,21,42.523809523809526,148.83333333333334,4465,74.41666666666667,6000000000,80.62709966405376
293,6,4,10,29.3,73.25,1465,24.416666666666668,4000000000,163.82252559726962
592,10,3,13,45.53846153846154,197.33333333333334,2960,49.333333333333336,3000000000,60.81081081081081
835,18,5,23,36.30434782608695,167,4175,69.58333333333333,5000000000,71.8562874251497
216,3,3,6,36,72,1080,18,3000000000,166.66666666666666
728,12,3,15,48.53333333333333,242.66666666666666,3640,60.666666666666664,3000000000,49.45054945054945
993,12,5,17,58.411764705882355,198.6,4965,82.75,5000000000,60.42296072507553
627,7,3,10,62.7,209,3135,52.25,3000000000,57.41626794258373
373,4,3,7,53.285714285714285,124.33333333333333,1865,31.083333333333332,3000000000,96.514745308311
1043,11,4,15,69.53333333333333,260.75,5215,86.91666666666667,4000000000,46.02109300095877
651,12,4,16,40.6875,162.75,3255,54.25,4000000000,73.73271889400922
508,10,5,15,33.86666666666667,101.6,2540,42.333333333333336,5000000000,118.11023622047244
668,7,4,11,60.72727272727273,167,3340,55.666666666666664,4000000000,71.8562874251497
714,14,3,17,42,238,3570,59.5,3000000000,50.420168067226896
455,5,3,8,56.875,151.66666666666666,2275,37.916666666666664,3000000000,79.12087912087912
488,7,3,10,48.8,162.66666666666666,2440,40.666666666666664,3000000000,73.7704918032787
664,12,5,17,39.05882352941177,132.8,3320,55.333333333333336,5000000000,90.36144578313252
937,19,4,23,40.73913043478261,234.25,4685,78.08333333333333,4000000000,51.2273212379936
550,13,3,16,34.375,183.33333333333334,2750,45.833333333333336,3000000000,65.45454545454545
1184,21,3,24,49.333333333333336,394.6666666666667,5920,98.66666666666667,3000000000,30.405405405405403
692,9,3,12,57.666666666666664,230.66666666666666,3460,57.666666666666664,3000000000,52.02312138728323
671,6,3,9,74.55555555555556,223.66666666666666,3355,55.916666666666664,3000000000,53.65126676602087
596,13,10,23,25.91304347826087,59.6,2980,49.666666666666664,10000000000,201.34228187919464
292,7,3,10,29.2,97.33333333333333,1460,24.333333333333332,3000000000,123.28767123287672
593,6,3,9,65.88888888888889,197.66666666666666,2965,49.416666666666664,3000000000,60.708263069139974
963,19,3,22,43.77272727272727,321,4815,80.25,3000000000,37.38317757009346
514,9,5,14,36.714285714285715,102.8,2570,42.833333333333336,5000000000,116.73151750972762
674,9,8,17,39.64705882352941,84.25,3370,56.166666666666664,8000000000,142.433234421365
380,4,5,9,42.22222222222222,76,1900,31.666666666666668,5000000000,157.89473684210526
906,11,10,21,43.142857142857146,90.6,4530,75.5,10000000000,132.45033112582783
551,12,6,18,30.61111111111111,91.83333333333333,2755,45.916666666666664,6000000000,130.67150635208714
1071,19,3,22,48.68181818181818,357,5355,89.25,3000000000,33.61344537815126
572,12,3,15,38.13333333333333,190.66666666666666,2860,47.666666666666664,3000000000,62.93706293706294
816,11,3,14,58.285714285714285,272,4080,68,3000000000,44.11764705882353
209,4,3,7,29.857142857142858,69.66666666666667,1045,17.416666666666668,3000000000,172.2488038277512
327,3,7,10,32.7,46.714285714285715,1635,27.25,7000000000,256.8807339449541
1185,16,16,32,37.03125,74.0625,5925,98.75,16000000000,162.02531645569618
855,15,3,18,47.5,285,4275,71.25,3000000000,42.10526315789474
723,11,8,19,38.05263157894737,90.375,3615,60.25,8000000000,132.78008298755188
523,10,4,14,37.357142857142854,130.75,2615,43.583333333333336,4000000000,91.77820267686424
220,3,4,7,31.428571428571427,55,1100,18.333333333333332,4000000000,218.1818181818182
616,4,3,7,88,205.33333333333334,3080,51.333333333333336,3000000000,58.441558441558435
658,9,3,12,54.833333333333336,219.33333333333334,3290,54.833333333333336,3000000000,54.7112462006079
387,7,3,10,38.7,129,1935,32.25,3000000000,93.02325581395348
304,7,3,10,30.4,101.33333333333333,1520,25.333333333333332,3000000000,118.42105263157895
292,4,3,7,41.714285714285715,97.33333333333333,1460,24.333333333333332,3000000000,123.28767123287672
553,5,5,10,55.3,110.6,2765,46.083333333333336,5000000000,108.49909584086798
989,20,8,28,35.32142857142857,123.625,4945,82.41666666666667,8000000000,97.06774519716886
295,5,3,8,36.875,98.33333333333333,1475,24.583333333333332,3000000000,122.03389830508475
531,15,5,20,26.55,106.2,2655,44.25,5000000000,112.99435028248587
689,11,9,20,34.45,76.55555555555556,3445,57.416666666666664,9000000000,156.7489114658926
441,8,3,11,40.09090909090909,147,2205,36.75,3000000000,81.63265306122449
633,8,3,11,57.54545454545455,211,3165,52.75,3000000000,56.87203791469194
389,9,4,13,29.923076923076923,97.25,1945,32.416666666666664,4000000000,123.39331619537276
221,5,3,8,27.625,73.66666666666667,1105,18.416666666666668,3000000000,162.89592760180994
435,6,3,9,48.333333333333336,145,2175,36.25,3000000000,82.75862068965517
706,16,3,19,37.1578947368421,235.33333333333334,3530,58.833333333333336,3000000000,50.991501416430594
513,11,4,15,34.2,128.25,2565,42.75,4000000000,93.5672514619883
510,9,5,14,36.42857142857143,102,2550,42.5,5000000000,117.6470588235294
416,8,3,11,37.81818181818182,138.66666666666666,2080,34.666666666666664,3000000000,86.53846153846155
987,18,3,21,47,329,4935,82.25,3000000000,36.4741641337386
814,13,3,16,50.875,271.3333333333333,4070,67.83333333333333,3000000000,44.22604422604423
470,8,3,11,42.72727272727273,156.66666666666666,2350,39.166666666666664,3000000000,76.59574468085107
667,11,4,15,44.46666666666667,166.75,3335,55.583333333333336,4000000000,71.9640179910045
726,12,3,15,48.4,242,3630,60.5,3000000000,49.586776859504134
742,12,3,15,49.46666666666667,247.33333333333334,3710,61.833333333333336,3000000000,48.517520215633425
677,12,5,17,39.8235294117647,135.4,3385,56.416666666666664,5000000000,88.62629246676515
1300,25,11,36,36.111111111111114,118.18181818181819,6500,108.33333333333333,11000000000,101.53846153846153
687,15,4,19,36.1578947368421,171.75,3435,57.25,4000000000,69.86899563318777
161,3,3,6,26.833333333333332,53.666666666666664,805,13.416666666666666,3000000000,223.60248447204972
593,6,4,10,59.3,148.25,2965,49.416666666666664,4000000000,80.94435075885329
507,7,7,14,36.214285714285715,72.42857142857143,2535,42.25,7000000000,165.68047337278108
672,11,10,21,32,67.2,3360,56,10000000000,178.57142857142856
548,4,5,9,60.888888888888886,109.6,2740,45.666666666666664,5000000000,109.48905109489051
664,12,3,15,44.266666666666666,221.33333333333334,3320,55.333333333333336,3000000000,54.21686746987952
676,9,3,12,56.333333333333336,225.33333333333334,3380,56.333333333333336,3000000000,53.25443786982248
711,7,5,12,59.25,142.2,3555,59.25,5000000000,84.38818565400844
249,3,4,7,35.57142857142857,62.25,1245,20.75,4000000000,192.77108433734938
515,12,3,15,34.333333333333336,171.66666666666666,2575,42.916666666666664,3000000000,69.90291262135923
349,7,3,10,34.9,116.33333333333333,1745,29.083333333333332,3000000000,103.1518624641834
802,12,4,16,50.125,200.5,4010,66.83333333333333,4000000000,59.85037406483791
305,5,3,8,38.125,101.66666666666667,1525,25.416666666666668,3000000000,118.03278688524588
596,8,3,11,54.18181818181818,198.66666666666666,2980,49.666666666666664,3000000000,60.4026845637584
514,4,3,7,73.42857142857143,171.33333333333334,2570,42.833333333333336,3000000000,70.03891050583658
626,11,3,14,44.714285714285715,208.66666666666666,3130,52.166666666666664,3000000000,57.50798722044728
598,6,3,9,66.44444444444444,199.33333333333334,2990,49.833333333333336,3000000000,60.20066889632107
655,13,5,18,36.388888888888886,131,3275,54.583333333333336,5000000000,91.6030534351145
656,7,3,10,65.6,218.66666666666666,3280,54.666666666666664,3000000000,54.8780487804878
421,8,3,11,38.27272727272727,140.33333333333334,2105,35.083333333333336,3000000000,85.5106888361045
524,9,3,12,43.666666666666664,174.66666666666666,2620,43.666666666666664,3000000000,68.70229007633587
1355,18,3,21,64.52380952380952,451.6666666666667,6775,112.91666666666667,3000000000,26.568265682656826
294,6,3,9,32.666666666666664,98,1470,24.5,3000000000,122.44897959183673
840,13,6,19,44.21052631578947,140,4200,70,6000000000,85.71428571428572
813,15,3,18,45.166666666666664,271,4065,67.75,3000000000,44.28044280442804
612,7,8,15,40.8,76.5,3060,51,8000000000,156.8627450980392
358,7,3,10,35.8,119.33333333333333,1790,29.833333333333332,3000000000,100.5586592178771
863,18,3,21,41.095238095238095,287.6666666666667,4315,71.91666666666667,3000000000,41.71494785631517
340,7,3,10,34,113.33333333333333,1700,28.333333333333332,3000000000,105.88235294117648
677,16,3,19,35.63157894736842,225.66666666666666,3385,56.416666666666664,3000000000,53.17577548005909
840,10,3,13,64.61538461538461,280,4200,70,3000000000,42.85714285714286
473,6,3,9,52.55555555555556,157.66666666666666,2365,39.416666666666664,3000000000,76.10993657505286
457,11,5,16,28.5625,91.4,2285,38.083333333333336,5000000000,131.29102844638948
922,10,3,13,70.92307692307692,307.3333333333333,4610,76.83333333333333,3000000000,39.04555314533623
509,11,3,14,36.357142857142854,169.66666666666666,2545,42.416666666666664,3000000000,70.7269155206287
543,8,3,11,49.36363636363637,181,2715,45.25,3000000000,66.29834254143647
541,8,5,13,41.61538461538461,108.2,2705,45.083333333333336,5000000000,110.90573012939002
491,7,4,11,44.63636363636363,122.75,2455,40.916666666666664,4000000000,97.759674134419555
414,11,3,14,29.571428571428573,138,2070,34.5,3000000000,86.95652173913044
982,22,3,25,39.28,327.3333333333333,4910,81.83333333333333,3000000000,36.65987780040734
692,14,6,20,34.6,115.33333333333333,3460,57.666666666666664,6000000000,104.04624277456647
541,10,3,13,41.61538461538461,180.33333333333334,2705,45.083333333333336,3000000000,66.54343807763401
410,8,3,11,37.27272727272727,136.66666666666666,2050,34.166666666666664,3000000000,87.8048780487805
760,9,6,15,50.666666666666664,126.66666666666667,3800,63.333333333333336,6000000000,94.73684210526316
880,9,7,16,55,125.71428571428571,4400,73.33333333333333,7000000000,95.45454545454547
696,9,3,12,58,232,3480,58,3000000000,51.724137931034484
778,15,3,18,43.22222222222222,259.3333333333333,3890,64.83333333333333,3000000000,46.27249357326478
598,10,4,14,42.714285714285715,149.5,2990,49.833333333333336,4000000000,80.2675585284281
281,3,3,6,46.833333333333336,93.66666666666667,1405,23.416666666666668,3000000000,128.1138790035587
579,11,3,14,41.357142857142854,193,2895,48.25,3000000000,62.17616580310881
894,9,3,12,74.5,298,4470,74.5,3000000000,40.26845637583893
946,12,4,16,59.125,236.5,4730,78.83333333333333,4000000000,50.7399577167019
277,6,3,9,30.77777777777778,92.33333333333333,1385,23.083333333333332,3000000000,129.9638989169675
1263,20,6,26,48.57692307692308,210.5,6315,105.25,6000000000,57.00712589073634
867,12,3,15,57.8,289,4335,72.25,3000000000,41.52249134948097
716,10,6,16,44.75,119.33333333333333,3580,59.666666666666664,6000000000,100.5586592178771
635,7,5,12,52.916666666666664,127,3175,52.916666666666664,5000000000,94.48818897637797
292,6,3,9,32.44444444444444,97.33333333333333,1460,24.333333333333332,3000000000,123.28767123287672
470,8,4,12,39.166666666666664,117.5,2350,39.166666666666664,4000000000,102.1276595744681
402,5,5,10,40.2,80.4,2010,33.5,5000000000,149.2537313432836
210,4,3,7,30,70,1050,17.5,3000000000,171.42857142857144
499,5,3,8,62.375,166.33333333333334,2495,41.583333333333336,3000000000,72.14428857715431
662,12,4,16,41.375,165.5,3310,55.166666666666664,4000000000,72.50755287009063
535,13,4,17,31.470588235294116,133.75,2675,44.583333333333336,4000000000,89.7196261682243
568,12,3,15,37.86666666666667,189.33333333333334,2840,47.333333333333336,3000000000,63.38028169014084
245,5,3,8,30.625,81.66666666666667,1225,20.416666666666668,3000000000,146.93877551020407
945,19,3,22,42.95454545454545,315,4725,78.75,3000000000,38.095238095238095
1337,16,7,23,58.130434782608695,191,6685,111.41666666666667,7000000000,62.82722513089005
743,14,3,17,43.705882352941174,247.66666666666666,3715,61.916666666666664,3000000000,48.45222072678331
519,8,4,12,43.25,129.75,2595,43.25,4000000000,92.48554913294798
617,9,3,12,51.416666666666664,205.66666666666666,3085,51.416666666666664,3000000000,58.346839546191255
363,7,4,11,33,90.75,1815,30.25,4000000000,132.23140495867767
1392,22,9,31,44.903225806451616,154.66666666666666,6960,116,9000000000,77.58620689655173
768,6,3,9,85.33333333333333,256,3840,64,3000000000,46.875
1062,15,10,25,42.48,106.2,5310,88.5,10000000000,112.99435028248587
375,4,3,7,53.57142857142857,125,1875,31.25,3000000000,96
538,7,3,10,53.8,179.33333333333334,2690,44.833333333333336,3000000000,66.91449814126393
522,6,3,9,58,174,2610,43.5,3000000000,68.9655172413793
1197,19,7,26,46.03846153846154,171,5985,99.75,7000000000,70.17543859649123
795,11,6,17,46.76470588235294,132.5,3975,66.25,6000000000,90.56603773584905
622,8,3,11,56.54545454545455,207.33333333333334,3110,51.833333333333336,3000000000,57.877813504823145
1339,24,4,28,47.82142857142857,334.75,6695,111.58333333333333,4000000000,35.847647498132936
1078,9,12,21,51.333333333333336,89.83333333333333,5390,89.83333333333333,12000000000,133.58070500927644
808,9,4,13,62.15384615384615,202,4040,67.33333333333333,4000000000,59.40594059405941
328,6,3,9,36.44444444444444,109.33333333333333,1640,27.333333333333332,3000000000,109.7560975609756
807,10,4,14,57.642857142857146,201.75,4035,67.25,4000000000,59.479553903345725
861,8,3,11,78.27272727272727,287,4305,71.75,3000000000,41.811846689895475
765,13,4,17,45,191.25,3825,63.75,4000000000,62.745098039215684
713,16,5,21,33.95238095238095,142.6,3565,59.416666666666664,5000000000,84.1514726507714
738,14,4,18,41,184.5,3690,61.5,4000000000,65.04065040650407
653,13,3,16,40.8125,217.66666666666666,3265,54.416666666666664,3000000000,55.1301684532925
864,8,3,11,78.54545454545455,288,4320,72,3000000000,41.666666666666664
566,7,4,11,51.45454545454545,141.5,2830,47.166666666666664,4000000000,84.80565371024736
310,7,3,10,31,103.33333333333333,1550,25.833333333333332,3000000000,116.12903225806453
421,4,3,7,60.142857142857146,140.33333333333334,2105,35.083333333333336,3000000000,85.5106888361045
663,8,4,12,55.25,165.75,3315,55.25,4000000000,72.39819004524887
945,15,3,18,52.5,315,4725,78.75,3000000000,38.095238095238095
202,9,3,12,16.833333333333332,67.33333333333333,1010,16.833333333333332,3000000000,178.21782178217822
830,11,8,19,43.68421052631579,103.75,4150,69.16666666666667,8000000000,115.66265060240963
519,9,4,13,39.92307692307692,129.75,2595,43.25,4000000000,92.48554913294798
366,5,3,8,45.75,122,1830,30.5,3000000000,98.36065573770492
465,9,3,12,38.75,155,2325,38.75,3000000000,77.41935483870968
800,10,10,20,40,80,4000,66.66666666666667,10000000000,150
651,7,3,10,65.1,217,3255,54.25,3000000000,55.29953917050691
1012,18,5,23,44,202.4,5060,84.33333333333333,5000000000,59.28853754940712
449,8,3,11,40.81818181818182,149.66666666666666,2245,37.416666666666664,3000000000,80.1781737193764
402,7,3,10,40.2,134,2010,33.5,3000000000,89.55223880597015
808,12,9,21,38.476190476190474,89.77777777777777,4040,67.33333333333333,9000000000,133.66336633663366
308,4,3,7,44,102.66666666666667,1540,25.666666666666668,3000000000,116.88311688311687
472,4,3,7,67.42857142857143,157.33333333333334,2360,39.333333333333336,3000000000,76.27118644067795
359,6,3,9,39.888888888888886,119.66666666666667,1795,29.916666666666668,3000000000,100.27855153203343
484,6,3,9,53.77777777777778,161.33333333333334,2420,40.333333333333336,3000000000,74.3801652892562
666,7,3,10,66.6,222,3330,55.5,3000000000,54.05405405405405
565,4,3,7,80.71428571428571,188.33333333333334,2825,47.083333333333336,3000000000,63.716814159292035
1607,15,8,23,69.8695652173913,200.875,8035,133.91666666666666,8000000000,59.738643434972005
646,10,7,17,38,92.28571428571429,3230,53.833333333333336,7000000000,130.03095975232196
480,9,3,12,40,160,2400,40,3000000000,75
531,8,3,11,48.27272727272727,177,2655,44.25,3000000000,67.79661016949153
868,12,8,20,43.4,108.5,4340,72.33333333333333,8000000000,110.59907834101384
872,9,9,18,48.44444444444444,96.88888888888889,4360,72.66666666666667,9000000000,123.8532110091743
395,4,3,7,56.42857142857143,131.66666666666666,1975,32.916666666666664,3000000000,91.13924050632912
749,11,3,14,53.5,249.66666666666666,3745,62.416666666666664,3000000000,48.06408544726302
684,7,3,10,68.4,228,3420,57,3000000000,52.63157894736842
583,11,6,17,34.294117647058826,97.16666666666667,2915,48.583333333333336,6000000000,123.4991423670669
547,12,3,15,36.46666666666667,182.33333333333334,2735,45.583333333333336,3000000000,65.81352833638024
474,5,3,8,59.25,158,2370,39.5,3000000000,75.94936708860759
719,15,7,22,32.68181818181818,102.71428571428571,3595,59.916666666666664,7000000000,116.8289290681502
587,11,3,14,41.92857142857143,195.66666666666666,2935,48.916666666666664,3000000000,61.32879045996593
673,14,3,17,39.588235294117645,224.33333333333334,3365,56.083333333333336,3000000000,53.49182763744428
673,12,4,16,42.0625,168.25,3365,56.083333333333336,4000000000,71.3224368499257
729,11,3,14,52.07142857142857,243,3645,60.75,3000000000,49.382716049382715
579,8,3,11,52.63636363636363,193,2895,48.25,3000000000,62.17616580310881
483,7,3,10,48.3,161,2415,40.25,3000000000,74.53416149068323
663,17,3,20,33.15,221,3315,55.25,3000000000,54.29864253393665
481,9,3,12,40.083333333333336,160.33333333333334,2405,40.083333333333336,3000000000,74.84407484407484
578,5,3,8,72.25,192.66666666666666,2890,48.166666666666664,3000000000,62.28373702422146
454,9,3,12,37.833333333333336,151.33333333333334,2270,37.833333333333336,3000000000,79.29515418502203
849,10,6,16,53.0625,141.5,4245,70.75,6000000000,84.80565371024736
807,10,9,19,42.473684210526315,89.66666666666667,4035,67.25,9000000000,133.82899628252787
704,7,4,11,64,176,3520,58.666666666666664,4000000000,68.18181818181819
452,9,3,12,37.666666666666664,150.66666666666666,2260,37.666666666666664,3000000000,79.64601769911505
582,18,6,24,24.25,97,2910,48.5,6000000000,123.71134020618557
762,8,3,11,69.27272727272727,254,3810,63.5,3000000000,47.24409448818898
587,8,3,11,53.36363636363637,195.66666666666666,2935,48.916666666666664,3000000000,61.32879045996593
630,15,3,18,35,210,3150,52.5,3000000000,57.14285714285714
382,5,3,8,47.75,127.33333333333333,1910,31.833333333333332,3000000000,94.24083769633508
848,7,3,10,84.8,282.6666666666667,4240,70.66666666666667,3000000000,42.45283018867924
693,15,3,18,38.5,231,3465,57.75,3000000000,51.94805194805195
472,4,5,9,52.44444444444444,94.4,2360,39.333333333333336,5000000000,127.11864406779661
251,3,3,6,41.833333333333336,83.66666666666667,1255,20.916666666666668,3000000000,143.42629482071712
1072,14,7,21,51.04761904761905,153.14285714285714,5360,89.33333333333333,7000000000,78.35820895522389
429,7,3,10,42.9,143,2145,35.75,3000000000,83.91608391608392
594,13,3,16,37.125,198,2970,49.5,3000000000,60.60606060606061
671,12,3,15,44.733333333333334,223.66666666666666,3355,55.916666666666664,3000000000,53.65126676602087
758,12,3,15,50.53333333333333,252.66666666666666,3790,63.166666666666664,3000000000,47.4934036939314
869,17,6,23,37.78260869565217,144.83333333333334,4345,72.41666666666667,6000000000,82.85385500575374
1057,18,4,22,48.04545454545455,264.25,5285,88.08333333333333,4000000000,45.411542100283825
598,6,3,9,66.44444444444444,199.33333333333334,2990,49.833333333333336,3000000000,60.20066889632107
403,9,3,12,33.583333333333336,134.33333333333334,2015,33.583333333333336,3000000000,89.33002481389578
609,13,3,16,38.0625,203,3045,50.75,3000000000,59.11330049261083
653,9,3,12,54.416666666666664,217.66666666666666,3265,54.416666666666664,3000000000,55.1301684532925
349,5,3,8,43.625,116.33333333333333,1745,29.083333333333332,3000000000,103.1518624641834
862,24,3,27,31.925925925925927,287.3333333333333,4310,71.83333333333333,3000000000,41.76334106728539
502,8,3,11,45.63636363636363,167.33333333333334,2510,41.833333333333336,3000000000,71.71314741035856
737,15,8,23,32.04347826086956,92.125,3685,61.416666666666664,8000000000,130.25780189959295
925,13,8,21,44.04761904761905,115.625,4625,77.08333333333333,8000000000,103.78378378378379
548,11,3,14,39.142857142857146,182.66666666666666,2740,45.666666666666664,3000000000,65.69343065693431
810,9,3,12,67.5,270,4050,67.5,3000000000,44.44444444444445
1262,24,3,27,46.74074074074074,420.6666666666667,6310,105.16666666666667,3000000000,28.526148969889064
676,12,3,15,45.06666666666667,225.33333333333334,3380,56.333333333333336,3000000000,53.25443786982248
1591,31,3,34,46.794117647058826,530.3333333333334,7955,132.58333333333334,3000000000,22.62727844123193
862,14,3,17,50.705882352941174,287.3333333333333,4310,71.83333333333333,3000000000,41.76334106728539
844,15,3,18,46.888888888888886,281.3333333333333,4220,70.33333333333333,3000000000,42.65402843601896
551,9,3,12,45.916666666666664,183.66666666666666,2755,45.916666666666664,3000000000,65.33575317604357
314,7,3,10,31.4,104.66666666666667,1570,26.166666666666668,3000000000,114.64968152866241
686,5,6,11,62.36363636363637,114.33333333333333,3430,57.166666666666664,6000000000,104.95626822157435
784,14,3,17,46.11764705882353,261.3333333333333,3920,65.33333333333333,3000000000,45.91836734693878
720,13,3,16,45,240,3600,60,3000000000,50
732,13,3,16,45.75,244,3660,61,3000000000,49.18032786885246
592,14,3,17,34.8235294117647,197.33333333333334,2960,49.333333333333336,3000000000,60.81081081081081
387,4,3,7,55.285714285714285,129,1935,32.25,3000000000,93.02325581395348
894,21,3,24,37.25,298,4470,74.5,3000000000,40.26845637583893
1263,14,10,24,52.625,126.3,6315,105.25,10000000000,95.01187648456056
679,6,3,9,75.44444444444444,226.33333333333334,3395,56.583333333333336,3000000000,53.01914580265096
622,11,5,16,38.875,124.4,3110,51.833333333333336,5000000000,96.46302250803858
487,7,3,10,48.7,162.33333333333334,2435,40.583333333333336,3000000000,73.92197125256672
610,11,3,14,43.57142857142857,203.33333333333334,3050,50.833333333333336,3000000000,59.01639344262294
746,9,3,12,62.166666666666664,248.66666666666666,3730,62.166666666666664,3000000000,48.2573726541555
425,9,3,12,35.416666666666664,141.66666666666666,2125,35.416666666666664,3000000000,84.70588235294119
793,13,6,19,41.73684210526316,132.16666666666666,3965,66.08333333333333,6000000000,90.79445145018916
1147,18,8,26,44.11538461538461,143.375,5735,95.58333333333333,8000000000,83.69659982563208
825,10,12,22,37.5,68.75,4125,68.75,12000000000,174.54545454545453
876,6,6,12,73,146,4380,73,6000000000,82.1917808219178
829,14,3,17,48.76470588235294,276.3333333333333,4145,69.08333333333333,3000000000,43.42581423401689
915,16,3,19,48.1578947368421,305,4575,76.25,3000000000,39.34426229508197
543,10,3,13,41.76923076923077,181,2715,45.25,3000000000,66.29834254143647
556,6,3,9,61.77777777777778,185.33333333333334,2780,46.333333333333336,3000000000,64.74820143884892
184,3,4,7,26.285714285714285,46,920,15.333333333333334,4000000000,260.86956521739125
884,11,4,15,58.93333333333333,221,4420,73.66666666666667,4000000000,54.29864253393665
429,5,4,9,47.666666666666664,107.25,2145,35.75,4000000000,111.8881118881119
546,10,3,13,42,182,2730,45.5,3000000000,65.93406593406593
656,10,3,13,50.46153846153846,218.66666666666666,3280,54.666666666666664,3000000000,54.8780487804878
1354,15,3,18,75.22222222222223,451.3333333333333,6770,112.83333333333333,3000000000,26.587887740029544
405,10,7,17,23.823529411764707,57.857142857142854,2025,33.75,7000000000,207.4074074074074
581,10,6,16,36.3125,96.83333333333333,2905,48.416666666666664,6000000000,123.92426850258175
494,9,5,14,35.285714285714285,98.8,2470,41.166666666666664,5000000000,121.45748987854252
422,6,3,9,46.888888888888886,140.66666666666666,2110,35.166666666666664,3000000000,85.30805687203792
478,10,4,14,34.142857142857146,119.5,2390,39.833333333333336,4000000000,100.418410041841
388,4,4,8,48.5,97,1940,32.333333333333336,4000000000,123.71134020618557
520,7,4,11,47.27272727272727,130,2600,43.333333333333336,4000000000,92.3076923076923
385,10,3,13,29.615384615384617,128.33333333333334,1925,32.083333333333336,3000000000,93.5064935064935
460,6,4,10,46,115,2300,38.333333333333336,4000000000,104.34782608695652
911,9,6,15,60.733333333333334,151.83333333333334,4555,75.91666666666667,6000000000,79.03402854006586
1078,18,3,21,51.333333333333336,359.3333333333333,5390,89.83333333333333,3000000000,33.39517625231911
563,8,6,14,40.214285714285715,93.83333333333333,2815,46.916666666666664,6000000000,127.88632326820604
216,4,7,11,19.636363636363637,30.857142857142858,1080,18,7000000000,388.8888888888889
604,7,9,16,37.75,67.11111111111111,3020,50.333333333333336,9000000000,178.80794701986753
1138,20,3,23,49.47826086956522,379.3333333333333,5690,94.83333333333333,3000000000,31.634446397188054
894,13,4,17,52.588235294117645,223.5,4470,74.5,4000000000,53.691275167785236
809,19,5,24,33.708333333333336,161.8,4045,67.41666666666667,5000000000,74.1656365883807
309,4,3,7,44.142857142857146,103,1545,25.75,3000000000,116.50485436893204
683,10,4,14,48.785714285714285,170.75,3415,56.916666666666664,4000000000,70.27818448023426
458,3,5,8,57.25,91.6,2290,38.166666666666664,5000000000,131.0043668122271
699,6,4,10,69.9,174.75,3495,58.25,4000000000,68.6695278969957
927,12,8,20,46.35,115.875,4635,77.25,8000000000,103.5598705501618
657,11,4,15,43.8,164.25,3285,54.75,4000000000,73.05936073059361
539,14,4,18,29.944444444444443,134.75,2695,44.916666666666664,4000000000,89.05380333951763
897,15,3,18,49.833333333333336,299,4485,74.75,3000000000,40.13377926421405
779,12,6,18,43.27777777777778,129.83333333333334,3895,64.91666666666667,6000000000,92.42618741976892
745,14,9,23,32.391304347826086,82.77777777777777,3725,62.083333333333336,9000000000,144.96644295302013
506,9,4,13,38.92307692307692,126.5,2530,42.166666666666664,4000000000,94.86166007905139
363,10,3,13,27.923076923076923,121,1815,30.25,3000000000,99.17355371900827
657,11,4,15,43.8,164.25,3285,54.75,4000000000,73.05936073059361
753,5,4,9,83.66666666666667,188.25,3765,62.75,4000000000,63.745019920318725
1002,20,8,28,35.785714285714285,125.25,5010,83.5,8000000000,95.80838323353294
402,5,7,12,33.5,57.42857142857143,2010,33.5,7000000000,208.95522388059703
328,7,3,10,32.8,109.33333333333333,1640,27.333333333333332,3000000000,109.7560975609756
614,8,3,11,55.81818181818182,204.66666666666666,3070,51.166666666666664,3000000000,58.63192182410423
393,5,3,8,49.125,131,1965,32.75,3000000000,91.6030534351145
505,11,4,15,33.666666666666664,126.25,2525,42.083333333333336,4000000000,95.04950495049505
173,3,3,6,28.833333333333332,57.666666666666664,865,14.416666666666666,3000000000,208.09248554913293
339,4,4,8,42.375,84.75,1695,28.25,4000000000,141.5929203539823
359,6,3,9,39.888888888888886,119.66666666666667,1795,29.916666666666668,3000000000,100.27855153203343
392,4,3,7,56,130.66666666666666,1960,32.666666666666664,3000000000,91.83673469387756
567,7,5,12,47.25,113.4,2835,47.25,5000000000,105.82010582010582
698,13,3,16,43.625,232.66666666666666,3490,58.166666666666664,3000000000,51.5759312320917
305,4,3,7,43.57142857142857,101.66666666666667,1525,25.416666666666668,3000000000,118.03278688524588
1188,16,10,26,45.69230769230769,118.8,5940,99,10000000000,101.01010101010101
576,6,5,11,52.36363636363637,115.2,2880,48,5000000000,104.16666666666667
758,17,7,24,31.583333333333332,108.28571428571429,3790,63.166666666666664,7000000000,110.8179419525066
412,6,4,10,41.2,103,2060,34.333333333333336,4000000000,116.50485436893203
376,5,3,8,47,125.33333333333333,1880,31.333333333333332,3000000000,95.74468085106383
672,13,3,16,42,224,3360,56,3000000000,53.57142857142858
668,7,3,10,66.8,222.66666666666666,3340,55.666666666666664,3000000000,53.89221556886228
662,16,3,19,34.8421052631579,220.66666666666666,3310,55.166666666666664,3000000000,54.38066465256797
749,17,3,20,37.45,249.66666666666666,3745,62.416666666666664,3000000000,48.06408544726302
636,8,4,12,53,159,3180,53,4000000000,75.47169811320755
705,6,3,9,78.33333333333333,235,3525,58.75,3000000000,51.06382978723405
921,20,9,29,31.75862068965517,102.33333333333333,4605,76.75,9000000000,117.26384364820846
483,9,7,16,30.1875,69,2415,40.25,7000000000,173.91304347826087
704,7,3,10,70.4,234.66666666666666,3520,58.666666666666664,3000000000,51.13636363636364
994,14,4,18,55.22222222222222,248.5,4970,82.83333333333333,4000000000,48.289738430583505
564,13,4,17,33.1764705882353,141,2820,47,4000000000,85.1063829787234
371,8,3,11,33.72727272727273,123.66666666666667,1855,30.916666666666668,3000000000,97.03504043126685
775,9,6,15,51.666666666666664,129.16666666666666,3875,64.58333333333333,6000000000,92.90322580645162
710,9,3,12,59.166666666666664,236.66666666666666,3550,59.166666666666664,3000000000,50.70422535211268
498,10,6,16,31.125,83,2490,41.5,6000000000,144.57831325301206
581,9,3,12,48.416666666666664,193.66666666666666,2905,48.416666666666664,3000000000,61.96213425129088
1310,19,3,22,59.54545454545455,436.6666666666667,6550,109.16666666666667,3000000000,27.48091603053435
359,4,3,7,51.285714285714285,119.66666666666667,1795,29.916666666666668,3000000000,100.27855153203343
996,9,3,12,83,332,4980,83,3000000000,36.144578313253014
1002,14,4,18,55.666666666666664,250.5,5010,83.5,4000000000,47.90419161676647
667,13,3,16,41.6875,222.33333333333334,3335,55.583333333333336,3000000000,53.973013493253376
354,6,3,9,39.333333333333336,118,1770,29.5,3000000000,101.69491525423729
262,8,3,11,23.818181818181817,87.33333333333333,1310,21.833333333333332,3000000000,137.40458015267174
542,6,5,11,49.27272727272727,108.4,2710,45.166666666666664,5000000000,110.70110701107012
517,10,4,14,36.92857142857143,129.25,2585,43.083333333333336,4000000000,92.84332688588007
535,9,5,14,38.214285714285715,107,2675,44.583333333333336,5000000000,112.14953271028037
371,9,3,12,30.916666666666668,123.66666666666667,1855,30.916666666666668,3000000000,97.03504043126685
442,8,4,12,36.833333333333336,110.5,2210,36.833333333333336,4000000000,108.5972850678733
539,7,4,11,49,134.75,2695,44.916666666666664,4000000000,89.05380333951763
993,16,3,19,52.26315789473684,331,4965,82.75,3000000000,36.25377643504532
626,13,4,17,36.8235294117647,156.5,3130,52.166666666666664,4000000000,76.6773162939297
1110,20,8,28,39.642857142857146,138.75,5550,92.5,8000000000,86.48648648648648
1094,11,12,23,47.56521739130435,91.16666666666667,5470,91.16666666666667,12000000000,131.6270566727605
320,4,4,8,40,80,1600,26.666666666666668,4000000000,150
524,10,3,13,40.30769230769231,174.66666666666666,2620,43.666666666666664,3000000000,68.70229007633587
438,4,3,7,62.57142857142857,146,2190,36.5,3000000000,82.1917808219178
352,6,3,9,39.111111111111114,117.33333333333333,1760,29.333333333333332,3000000000,102.27272727272728
907,13,3,16,56.6875,302.3333333333333,4535,75.58333333333333,3000000000,39.69128996692393
706,11,8,19,37.1578947368421,88.25,3530,58.833333333333336,8000000000,135.97733711048159
818,9,8,17,48.11764705882353,102.25,4090,68.16666666666667,8000000000,117.35941320293398
449,8,3,11,40.81818181818182,149.66666666666666,2245,37.416666666666664,3000000000,80.1781737193764
545,3,3,6,90.83333333333333,181.66666666666666,2725,45.416666666666664,3000000000,66.05504587155963
1076,16,7,23,46.78260869565217,153.71428571428572,5380,89.66666666666667,7000000000,78.06691449814126
306,5,3,8,38.25,102,1530,25.5,3000000000,117.6470588235294
717,11,5,16,44.8125,143.4,3585,59.75,5000000000,83.68200836820084
693,14,6,20,34.65,115.5,3465,57.75,6000000000,103.8961038961039
213,3,3,6,35.5,71,1065,17.75,3000000000,169.01408450704227
1146,18,3,21,54.57142857142857,382,5730,95.5,3000000000,31.413612565445025
587,10,6,16,36.6875,97.83333333333333,2935,48.916666666666664,6000000000,122.65758091993186
1075,17,9,26,41.34615384615385,119.44444444444444,5375,89.58333333333333,9000000000,100.46511627906976
357,6,3,9,39.666666666666664,119,1785,29.75,3000000000,100.84033613445379
532,12,3,15,35.46666666666667,177.33333333333334,2660,44.333333333333336,3000000000,67.66917293233082
675,7,7,14,48.214285714285715,96.42857142857143,3375,56.25,7000000000,124.44444444444444
550,8,3,11,50,183.33333333333334,2750,45.833333333333336,3000000000,65.45454545454545
501,9,6,15,33.4,83.5,2505,41.75,6000000000,143.71257485029938
607,18,3,21,28.904761904761905,202.33333333333334,3035,50.583333333333336,3000000000,59.308072487644154
791,4,4,8,98.875,197.75,3955,65.91666666666667,4000000000,60.6826801517067
472,6,6,12,39.333333333333336,78.66666666666667,2360,39.333333333333336,6000000000,152.5423728813559
551,15,3,18,30.61111111111111,183.66666666666666,2755,45.916666666666664,3000000000,65.33575317604357
650,11,3,14,46.42857142857143,216.66666666666666,3250,54.166666666666664,3000000000,55.38461538461539
579,14,3,17,34.05882352941177,193,2895,48.25,3000000000,62.17616580310881
617,12,3,15,41.13333333333333,205.66666666666666,3085,51.416666666666664,3000000000,58.346839546191255
1110,18,9,27,41.111111111111114,123.33333333333333,5550,92.5,9000000000,97.2972972972973
1226,17,6,23,53.30434782608695,204.33333333333334,6130,102.16666666666667,6000000000,58.727569331158236
833,12,3,15,55.53333333333333,277.6666666666667,4165,69.41666666666667,3000000000,43.2172869147659
230,7,3,10,23,76.66666666666667,1150,19.166666666666668,3000000000,156.52173913043478
628,8,6,14,44.857142857142854,104.66666666666667,3140,52.333333333333336,6000000000,114.64968152866241
375,7,3,10,37.5,125,1875,31.25,3000000000,96
1257,16,8,24,52.375,157.125,6285,104.75,8000000000,76.37231503579952
679,11,3,14,48.5,226.33333333333334,3395,56.583333333333336,3000000000,53.01914580265096
841,22,6,28,30.035714285714285,140.16666666666666,4205,70.08333333333333,6000000000,85.61236623067776
666,7,3,10,66.6,222,3330,55.5,3000000000,54.05405405405405
499,10,3,13,38.38461538461539,166.33333333333334,2495,41.583333333333336,3000000000,72.14428857715431
723,18,4,22,32.86363636363637,180.75,3615,60.25,4000000000,66.39004149377594
990,19,3,22,45,330,4950,82.5,3000000000,36.36363636363637
210,5,3,8,26.25,70,1050,17.5,3000000000,171.42857142857144
788,8,5,13,60.61538461538461,157.6,3940,65.66666666666667,5000000000,76.14213197969542
890,17,3,20,44.5,296.6666666666667,4450,74.16666666666667,3000000000,40.44943820224719
1123,18,10,28,40.107142857142854,112.3,5615,93.58333333333333,10000000000,106.8566340160285
235,5,3,8,29.375,78.33333333333333,1175,19.583333333333332,3000000000,153.19148936170214
802,17,7,24,33.416666666666664,114.57142857142857,4010,66.83333333333333,7000000000,104.73815461346634
241,5,3,8,30.125,80.33333333333333,1205,20.083333333333332,3000000000,149.37759336099586
768,13,7,20,38.4,109.71428571428571,3840,64,7000000000,109.375
560,13,3,16,35,186.66666666666666,2800,46.666666666666664,3000000000,64.28571428571429
710,14,3,17,41.76470588235294,236.66666666666666,3550,59.166666666666664,3000000000,50.70422535211268
648,10,4,14,46.285714285714285,162,3240,54,4000000000,74.07407407407408
292,8,3,11,26.545454545454547,97.33333333333333,1460,24.333333333333332,3000000000,123.28767123287672
243,5,3,8,30.375,81,1215,20.25,3000000000,148.14814814814815
717,7,6,13,55.15384615384615,119.5,3585,59.75,6000000000,100.418410041841
997,16,3,19,52.473684210526315,332.3333333333333,4985,83.08333333333333,3000000000,36.10832497492477
407,4,3,7,58.142857142857146,135.66666666666666,2035,33.916666666666664,3000000000,88.45208845208846
423,8,3,11,38.45454545454545,141,2115,35.25,3000000000,85.1063829787234
825,11,3,14,58.92857142857143,275,4125,68.75,3000000000,43.63636363636363
1172,9,8,17,68.94117647058823,146.5,5860,97.66666666666667,8000000000,81.91126279863481
308,9,3,12,25.666666666666668,102.66666666666667,1540,25.666666666666668,3000000000,116.88311688311687
302,4,3,7,43.142857142857146,100.66666666666667,1510,25.166666666666668,3000000000,119.20529801324503
556,9,3,12,46.333333333333336,185.33333333333334,2780,46.333333333333336,3000000000,64.74820143884892
541,7,4,11,49.18181818181818,135.25,2705,45.083333333333336,4000000000,88.724584103512
658,6,4,10,65.8,164.5,3290,54.833333333333336,4000000000,72.9483282674772
1004,15,7,22,45.63636363636363,143.42857142857142,5020,83.66666666666667,7000000000,83.66533864541832
733,10,5,15,48.86666666666667,146.6,3665,61.083333333333336,5000000000,81.85538881309687
541,9,3,12,45.083333333333336,180.33333333333334,2705,45.083333333333336,3000000000,66.54343807763401
419,13,3,16,26.1875,139.66666666666666,2095,34.916666666666664,3000000000,85.91885441527447
610,6,4,10,61,152.5,3050,50.833333333333336,4000000000,78.68852459016394
462,7,3,10,46.2,154,2310,38.5,3000000000,77.92207792207792
851,17,7,24,35.458333333333336,121.57142857142857,4255,70.91666666666667,7000000000,98.70740305522914
294,7,3,10,29.4,98,1470,24.5,3000000000,122.44897959183673
515,8,4,12,42.916666666666664,128.75,2575,42.916666666666664,4000000000,93.20388349514563
808,10,3,13,62.15384615384615,269.3333333333333,4040,67.33333333333333,3000000000,44.554455445544555
1177,17,8,25,47.08,147.125,5885,98.08333333333333,8000000000,81.56329651656755
485,8,4,12,40.416666666666664,121.25,2425,40.416666666666664,4000000000,98.96907216494846
482,10,3,13,37.07692307692308,160.66666666666666,2410,40.166666666666664,3000000000,74.68879668049793
535,8,4,12,44.583333333333336,133.75,2675,44.583333333333336,4000000000,89.7196261682243
614,17,3,20,30.7,204.66666666666666,3070,51.166666666666664,3000000000,58.63192182410423
315,6,3,9,35,105,1575,26.25,3000000000,114.28571428571428
871,12,9,21,41.476190476190474,96.77777777777777,4355,72.58333333333333,9000000000,123.99540757749713
835,13,9,22,37.95454545454545,92.77777777777777,4175,69.58333333333333,9000000000,129.34131736526948
783,13,3,16,48.9375,261,3915,65.25,3000000000,45.97701149425288
1191,18,8,26,45.80769230769231,148.875,5955,99.25,8000000000,80.60453400503779
333,5,4,9,37,83.25,1665,27.75,4000000000,144.14414414414415
365,5,3,8,45.625,121.66666666666667,1825,30.416666666666668,3000000000,98.63013698630137
1040,14,7,21,49.523809523809526,148.57142857142858,5200,86.66666666666667,7000000000,80.76923076923077
629,9,3,12,52.416666666666664,209.66666666666666,3145,52.416666666666664,3000000000,57.233704292527825
665,11,4,15,44.333333333333336,166.25,3325,55.416666666666664,4000000000,72.18045112781955
629,11,6,17,37,104.83333333333333,3145,52.416666666666664,6000000000,114.46740858505565
683,8,6,14,48.785714285714285,113.83333333333333,3415,56.916666666666664,6000000000,105.4172767203514
895,15,6,21,42.61904761904762,149.16666666666666,4475,74.58333333333333,6000000000,80.44692737430168
420,7,5,12,35,84,2100,35,5000000000,142.85714285714286
864,15,3,18,48,288,4320,72,3000000000,41.666666666666664
562,16,8,24,23.416666666666668,70.25,2810,46.833333333333336,8000000000,170.8185053380783
497,5,3,8,62.125,165.66666666666666,2485,41.416666666666664,3000000000,72.43460764587526
406,8,3,11,36.90909090909091,135.33333333333334,2030,33.833333333333336,3000000000,88.66995073891624
591,5,3,8,73.875,197,2955,49.25,3000000000,60.91370558375634
689,9,4,13,53,172.25,3445,57.416666666666664,4000000000,69.66618287373005
809,12,4,16,50.5625,202.25,4045,67.41666666666667,4000000000,59.33250927070457
408,5,7,12,34,58.285714285714285,2040,34,7000000000,205.88235294117646
535,9,3,12,44.583333333333336,178.33333333333334,2675,44.583333333333336,3000000000,67.28971962616822
412,4,3,7,58.857142857142854,137.33333333333334,2060,34.333333333333336,3000000000,87.37864077669902
658,10,4,14,47,164.5,3290,54.833333333333336,4000000000,72.9483282674772
806,8,6,14,57.57142857142857,134.33333333333334,4030,67.16666666666667,6000000000,89.33002481389578
560,9,3,12,46.666666666666664,186.66666666666666,2800,46.666666666666664,3000000000,64.28571428571429
457,5,3,8,57.125,152.33333333333334,2285,38.083333333333336,3000000000,78.77461706783369
1008,15,12,27,37.333333333333336,84,5040,84,12000000000,142.85714285714286
827,13,5,18,45.94444444444444,165.4,4135,68.91666666666667,5000000000,72.55139056831922
260,4,3,7,37.142857142857146,86.66666666666667,1300,21.666666666666668,3000000000,138.46153846153845
578,11,3,14,41.285714285714285,192.66666666666666,2890,48.166666666666664,3000000000,62.28373702422146
345,6,3,9,38.333333333333336,115,1725,28.75,3000000000,104.34782608695652
260,4,3,7,37.142857142857146,86.66666666666667,1300,21.666666666666668,3000000000,138.46153846153845
535,10,3,13,41.15384615384615,178.33333333333334,2675,44.583333333333336,3000000000,67.28971962616822
620,6,3,9,68.88888888888889,206.66666666666666,3100,51.666666666666664,3000000000,58.06451612903226
965,17,3,20,48.25,321.6666666666667,4825,80.41666666666667,3000000000,37.30569948186528
700,10,9,19,36.8421052631579,77.77777777777777,3500,58.333333333333336,9000000000,154.28571428571428
531,5,3,8,66.375,177,2655,44.25,3000000000,67.79661016949153
463,3,6,9,51.44444444444444,77.16666666666667,2315,38.583333333333336,6000000000,155.5075593952484
331,8,3,11,30.09090909090909,110.33333333333333,1655,27.583333333333332,3000000000,108.76132930513594
663,16,6,22,30.136363636363637,110.5,3315,55.25,6000000000,108.5972850678733
1135,14,5,19,59.73684210526316,227,5675,94.58333333333333,5000000000,52.86343612334802
625,11,6,17,36.76470588235294,104.16666666666667,3125,52.083333333333336,6000000000,115.2
353,10,4,14,25.214285714285715,88.25,1765,29.416666666666668,4000000000,135.97733711048159
995,15,3,18,55.27777777777778,331.6666666666667,4975,82.91666666666667,3000000000,36.18090452261306
390,9,3,12,32.5,130,1950,32.5,3000000000,92.3076923076923
1104,16,3,19,58.10526315789474,368,5520,92,3000000000,32.608695652173914
196,4,3,7,28,65.33333333333333,980,16.333333333333332,3000000000,183.67346938775512
1308,24,4,28,46.714285714285715,327,6540,109,4000000000,36.69724770642202
519,11,4,15,34.6,129.75,2595,43.25,4000000000,92.48554913294798
300,6,3,9,33.333333333333336,100,1500,25,3000000000,120
1020,15,5,20,51,204,5100,85,5000000000,58.8235294117647
496,7,3,10,49.6,165.33333333333334,2480,41.333333333333336,3000000000,72.58064516129032
646,9,7,16,40.375,92.28571428571429,3230,53.833333333333336,7000000000,130.03095975232196
409,7,3,10,40.9,136.33333333333334,2045,34.083333333333336,3000000000,88.01955990220048
311,6,4,10,31.1,77.75,1555,25.916666666666668,4000000000,154.34083601286173
720,17,10,27,26.666666666666668,72,3600,60,10000000000,166.66666666666666
389,8,3,11,35.36363636363637,129.66666666666666,1945,32.416666666666664,3000000000,92.54498714652956
508,10,3,13,39.07692307692308,169.33333333333334,2540,42.333333333333336,3000000000,70.86614173228345
569,8,8,16,35.5625,71.125,2845,47.416666666666664,8000000000,168.7170474516696
1260,27,3,30,42,420,6300,105,3000000000,28.57142857142857
325,12,3,15,21.666666666666668,108.33333333333333,1625,27.083333333333332,3000000000,110.76923076923077
380,9,5,14,27.142857142857142,76,1900,31.666666666666668,5000000000,157.89473684210526
969,12,3,15,64.6,323,4845,80.75,3000000000,37.151702786377705
353,9,3,12,29.416666666666668,117.66666666666667,1765,29.416666666666668,3000000000,101.98300283286119
592,12,3,15,39.46666666666667,197.33333333333334,2960,49.333333333333336,3000000000,60.81081081081081
1229,15,8,23,53.43478260869565,153.625,6145,102.41666666666667,8000000000,78.11228641171684
730,12,3,15,48.666666666666664,243.33333333333334,3650,60.833333333333336,3000000000,49.31506849315068
880,17,3,20,44,293.3333333333333,4400,73.33333333333333,3000000000,40.909090909090914
1335,20,3,23,58.04347826086956,445,6675,111.25,3000000000,26.966292134831463
687,13,3,16,42.9375,229,3435,57.25,3000000000,52.40174672489083
1415,13,12,25,56.6,117.91666666666667,7075,117.91666666666667,12000000000,101.7667844522968
957,14,6,20,47.85,159.5,4785,79.75,6000000000,75.23510971786834
643,11,3,14,45.92857142857143,214.33333333333334,3215,53.583333333333336,3000000000,55.987558320373246
834,11,3,14,59.57142857142857,278,4170,69.5,3000000000,43.165467625899275
673,7,5,12,56.083333333333336,134.6,3365,56.083333333333336,5000000000,89.15304606240713
333,5,3,8,41.625,111,1665,27.75,3000000000,108.1081081081081
790,15,3,18,43.888888888888886,263.3333333333333,3950,65.83333333333333,3000000000,45.56962025316456
688,9,5,14,49.142857142857146,137.6,3440,57.333333333333336,5000000000,87.20930232558139
444,6,3,9,49.333333333333336,148,2220,37,3000000000,81.08108108108108
1663,33,3,36,46.19444444444444,554.3333333333334,8315,138.58333333333334,3000000000,21.647624774503907
795,11,5,16,49.6875,159,3975,66.25,5000000000,75.47169811320755
332,6,3,9,36.888888888888886,110.66666666666667,1660,27.666666666666668,3000000000,108.43373493975903
1164,15,10,25,46.56,116.4,5820,97,10000000000,103.09278350515464
201,4,3,7,28.714285714285715,67,1005,16.75,3000000000,179.1044776119403
645,8,4,12,53.75,161.25,3225,53.75,4000000000,74.4186046511628
628,8,3,11,57.09090909090909,209.33333333333334,3140,52.333333333333336,3000000000,57.324840764331206
421,4,3,7,60.142857142857146,140.33333333333334,2105,35.083333333333336,3000000000,85.5106888361045
548,6,5,11,49.81818181818182,109.6,2740,45.666666666666664,5000000000,109.48905109489051
811,6,3,9,90.11111111111111,270.3333333333333,4055,67.58333333333333,3000000000,44.38964241676942
279,4,3,7,39.857142857142854,93,1395,23.25,3000000000,129.03225806451613
514,11,3,14,36.714285714285715,171.33333333333334,2570,42.833333333333336,3000000000,70.03891050583658
747,13,3,16,46.6875,249,3735,62.25,3000000000,48.192771084337345
669,17,3,20,33.45,223,3345,55.75,3000000000,53.81165919282511
333,6,3,9,37,111,1665,27.75,3000000000,108.1081081081081
372,8,3,11,33.81818181818182,124,1860,31,3000000000,96.77419354838709
233,4,4,8,29.125,58.25,1165,19.416666666666668,4000000000,206.0085836909871
513,8,3,11,46.63636363636363,171,2565,42.75,3000000000,70.17543859649123
799,12,7,19,42.05263157894737,114.14285714285714,3995,66.58333333333333,7000000000,105.1314142678348
651,11,3,14,46.5,217,3255,54.25,3000000000,55.29953917050691
698,14,4,18,38.77777777777778,174.5,3490,58.166666666666664,4000000000,68.76790830945559
433,5,3,8,54.125,144.33333333333334,2165,36.083333333333336,3000000000,83.14087759815241
311,4,3,7,44.42857142857143,103.66666666666667,1555,25.916666666666668,3000000000,115.75562700964629
284,3,4,7,40.57142857142857,71,1420,23.666666666666668,4000000000,169.01408450704227
461,8,3,11,41.90909090909091,153.66666666666666,2305,38.416666666666664,3000000000,78.09110629067246
763,13,7,20,38.15,109,3815,63.583333333333336,7000000000,110.09174311926604
360,8,6,14,25.714285714285715,60,1800,30,6000000000,200
720,9,3,12,60,240,3600,60,3000000000,50
968,12,3,15,64.53333333333333,322.6666666666667,4840,80.66666666666667,3000000000,37.1900826446281
904,15,8,23,39.30434782608695,113,4520,75.33333333333333,8000000000,106.19469026548673
511,10,3,13,39.30769230769231,170.33333333333334,2555,42.583333333333336,3000000000,70.45009784735812
521,10,3,13,40.07692307692308,173.66666666666666,2605,43.416666666666664,3000000000,69.0978886756238
856,7,6,13,65.84615384615384,142.66666666666666,4280,71.33333333333333,6000000000,84.11214953271029
557,9,3,12,46.416666666666664,185.66666666666666,2785,46.416666666666664,3000000000,64.63195691202873
825,8,3,11,75,275,4125,68.75,3000000000,43.63636363636363
788,9,3,12,65.66666666666667,262.6666666666667,3940,65.66666666666667,3000000000,45.68527918781725
929,14,3,17,54.64705882352941,309.6666666666667,4645,77.41666666666667,3000000000,38.751345532830996
654,8,4,12,54.5,163.5,3270,54.5,4000000000,73.39449541284404
222,5,3,8,27.75,74,1110,18.5,3000000000,162.16216216216216
641,10,4,14,45.785714285714285,160.25,3205,53.416666666666664,4000000000,74.88299531981279
720,15,7,22,32.72727272727273,102.85714285714286,3600,60,7000000000,116.66666666666667
861,18,3,21,41,287,4305,71.75,3000000000,41.811846689895475
390,4,3,7,55.714285714285715,130,1950,32.5,3000000000,92.3076923076923
589,7,8,15,39.266666666666666,73.625,2945,49.083333333333336,8000000000,162.9881154499151
716,17,3,20,35.8,238.66666666666666,3580,59.666666666666664,3000000000,50.27932960893855
1058,23,14,37,28.594594594594593,75.57142857142857,5290,88.16666666666667,14000000000,158.79017013232513
516,8,4,12,43,129,2580,43,4000000000,93.02325581395348
391,9,3,12,32.583333333333336,130.33333333333334,1955,32.583333333333336,3000000000,92.07161125319692
823,11,5,16,51.4375,164.6,4115,68.58333333333333,5000000000,72.90400972053463
742,8,6,14,53,123.66666666666667,3710,61.833333333333336,6000000000,97.03504043126685
640,11,3,14,45.714285714285715,213.33333333333334,3200,53.333333333333336,3000000000,56.25
884,12,4,16,55.25,221,4420,73.66666666666667,4000000000,54.29864253393665
547,5,3,8,68.375,182.33333333333334,2735,45.583333333333336,3000000000,65.81352833638024
543,7,3,10,54.3,181,2715,45.25,3000000000,66.29834254143647
163,6,4,10,16.3,40.75,815,13.583333333333334,4000000000,294.47852760736197
245,5,3,8,30.625,81.66666666666667,1225,20.416666666666668,3000000000,146.93877551020407
612,4,4,8,76.5,153,3060,51,4000000000,78.4313725490196
1040,14,3,17,61.1764705882353,346.6666666666667,5200,86.66666666666667,3000000000,34.61538461538461
540,7,4,11,49.09090909090909,135,2700,45,4000000000,88.8888888888889
432,8,3,11,39.27272727272727,144,2160,36,3000000000,83.33333333333333
820,14,5,19,43.1578947368421,164,4100,68.33333333333333,5000000000,73.17073170731709
1264,25,10,35,36.114285714285714,126.4,6320,105.33333333333333,10000000000,94.9367088607595
1188,20,10,30,39.6,118.8,5940,99,10000000000,101.01010101010101
494,6,4,10,49.4,123.5,2470,41.166666666666664,4000000000,97.16599190283401
263,7,3,10,26.3,87.66666666666667,1315,21.916666666666668,3000000000,136.88212927756652
573,10,3,13,44.07692307692308,191,2865,47.75,3000000000,62.82722513089005
577,10,7,17,33.94117647058823,82.42857142857143,2885,48.083333333333336,7000000000,145.580589254766
251,7,3,10,25.1,83.66666666666667,1255,20.916666666666668,3000000000,143.42629482071712
735,10,3,13,56.53846153846154,245,3675,61.25,3000000000,48.9795918367347
396,7,4,11,36,99,1980,33,4000000000,121.21212121212122
707,15,4,19,37.21052631578947,176.75,3535,58.916666666666664,4000000000,67.89250353606789
660,6,3,9,73.33333333333333,220,3300,55,3000000000,54.54545454545455
581,11,5,16,36.3125,116.2,2905,48.416666666666664,5000000000,103.27022375215148
573,6,3,9,63.666666666666664,191,2865,47.75,3000000000,62.82722513089005
745,10,3,13,57.30769230769231,248.33333333333334,3725,62.083333333333336,3000000000,48.32214765100671
463,5,4,9,51.44444444444444,115.75,2315,38.583333333333336,4000000000,103.67170626349892
1286,20,11,31,41.483870967741936,116.9090909090909,6430,107.16666666666667,11000000000,102.6438569206843
309,5,3,8,38.625,103,1545,25.75,3000000000,116.50485436893204
471,8,3,11,42.81818181818182,157,2355,39.25,3000000000,76.43312101910828
1230,14,12,26,47.30769230769231,102.5,6150,102.5,12000000000,117.07317073170732
461,12,3,15,30.733333333333334,153.66666666666666,2305,38.416666666666664,3000000000,78.09110629067246
769,9,3,12,64.08333333333333,256.3333333333333,3845,64.08333333333333,3000000000,46.81404421326398
571,6,3,9,63.44444444444444,190.33333333333334,2855,47.583333333333336,3000000000,63.047285464098074
625,9,3,12,52.083333333333336,208.33333333333334,3125,52.083333333333336,3000000000,57.6
784,10,4,14,56,196,3920,65.33333333333333,4000000000,61.22448979591837
297,4,4,8,37.125,74.25,1485,24.75,4000000000,161.6161616161616
506,9,3,12,42.166666666666664,168.66666666666666,2530,42.166666666666664,3000000000,71.14624505928855
279,7,3,10,27.9,93,1395,23.25,3000000000,129.03225806451613
635,10,3,13,48.84615384615385,211.66666666666666,3175,52.916666666666664,3000000000,56.69291338582677
455,8,5,13,35,91,2275,37.916666666666664,5000000000,131.86813186813188
1028,23,5,28,36.714285714285715,205.6,5140,85.66666666666667,5000000000,58.36575875486381
515,10,3,13,39.61538461538461,171.66666666666666,2575,42.916666666666664,3000000000,69.90291262135923
836,11,7,18,46.44444444444444,119.42857142857143,4180,69.66666666666667,7000000000,100.47846889952153
293,5,3,8,36.625,97.66666666666667,1465,24.416666666666668,3000000000,122.8668941979522
290,8,3,11,26.363636363636363,96.66666666666667,1450,24.166666666666668,3000000000,124.13793103448275
237,5,3,8,29.625,79,1185,19.75,3000000000,151.89873417721518
1206,14,3,17,70.94117647058823,402,6030,100.5,3000000000,29.850746268656717
420,6,3,9,46.666666666666664,140,2100,35,3000000000,85.71428571428572
596,6,6,12,49.666666666666664,99.33333333333333,2980,49.666666666666664,6000000000,120.8053691275168
591,9,7,16,36.9375,84.42857142857143,2955,49.25,7000000000,142.13197969543148
345,4,3,7,49.285714285714285,115,1725,28.75,3000000000,104.34782608695652
654,9,3,12,54.5,218,3270,54.5,3000000000,55.04587155963302
629,8,3,11,57.18181818181818,209.66666666666666,3145,52.416666666666664,3000000000,57.233704292527825
692,9,7,16,43.25,98.85714285714286,3460,57.666666666666664,7000000000,121.38728323699422
934,13,7,20,46.7,133.42857142857142,4670,77.83333333333333,7000000000,89.93576017130623
455,8,7,15,30.333333333333332,65,2275,37.916666666666664,7000000000,184.61538461538464
501,14,3,17,29.470588235294116,167,2505,41.75,3000000000,71.85628742514969
403,4,3,7,57.57142857142857,134.33333333333334,2015,33.583333333333336,3000000000,89.33002481389578
514,10,4,14,36.714285714285715,128.5,2570,42.833333333333336,4000000000,93.3852140077821
311,6,3,9,34.55555555555556,103.66666666666667,1555,25.916666666666668,3000000000,115.75562700964629
675,8,7,15,45,96.42857142857143,3375,56.25,7000000000,124.44444444444444
419,3,3,6,69.83333333333333,139.66666666666666,2095,34.916666666666664,3000000000,85.91885441527447
906,13,4,17,53.294117647058826,226.5,4530,75.5,4000000000,52.980132450331126
234,4,3,7,33.42857142857143,78,1170,19.5,3000000000,153.84615384615387
840,14,3,17,49.411764705882355,280,4200,70,3000000000,42.85714285714286
386,5,3,8,48.25,128.66666666666666,1930,32.166666666666664,3000000000,93.26424870466322
291,4,4,8,36.375,72.75,1455,24.25,4000000000,164.94845360824743
421,10,4,14,30.071428571428573,105.25,2105,35.083333333333336,4000000000,114.01425178147268
718,17,3,20,35.9,239.33333333333334,3590,59.833333333333336,3000000000,50.139275766016716
535,8,6,14,38.214285714285715,89.16666666666667,2675,44.583333333333336,6000000000,134.57943925233644
835,12,3,15,55.666666666666664,278.3333333333333,4175,69.58333333333333,3000000000,43.11377245508982
1001,21,4,25,40.04,250.25,5005,83.41666666666667,4000000000,47.95204795204795
650,11,4,15,43.333333333333336,162.5,3250,54.166666666666664,4000000000,73.84615384615385
274,5,3,8,34.25,91.33333333333333,1370,22.833333333333332,3000000000,131.38686131386862
248,6,3,9,27.555555555555557,82.66666666666667,1240,20.666666666666668,3000000000,145.16129032258064
156,5,3,8,19.5,52,780,13,3000000000,230.76923076923077
1065,14,3,17,62.64705882352941,355,5325,88.75,3000000000,33.80281690140845
381,9,3,12,31.75,127,1905,31.75,3000000000,94.48818897637796
443,3,3,6,73.83333333333333,147.66666666666666,2215,36.916666666666664,3000000000,81.26410835214448
519,7,4,11,47.18181818181818,129.75,2595,43.25,4000000000,92.48554913294798
851,19,7,26,32.73076923076923,121.57142857142857,4255,70.91666666666667,7000000000,98.70740305522914
457,6,3,9,50.77777777777778,152.33333333333334,2285,38.083333333333336,3000000000,78.77461706783369
738,12,3,15,49.2,246,3690,61.5,3000000000,48.78048780487805
260,4,5,9,28.88888888888889,52,1300,21.666666666666668,5000000000,230.76923076923075
566,4,3,7,80.85714285714286,188.66666666666666,2830,47.166666666666664,3000000000,63.60424028268552
532,8,3,11,48.36363636363637,177.33333333333334,2660,44.333333333333336,3000000000,67.66917293233082
757,16,7,23,32.91304347826087,108.14285714285714,3785,63.083333333333336,7000000000,110.96433289299868
1071,15,5,20,53.55,214.2,5355,89.25,5000000000,56.022408963585434
263,4,4,8,32.875,65.75,1315,21.916666666666668,4000000000,182.50950570342204
544,9,5,14,38.857142857142854,108.8,2720,45.333333333333336,5000000000,110.29411764705881
536,9,3,12,44.666666666666664,178.66666666666666,2680,44.666666666666664,3000000000,67.16417910447761
672,20,4,24,28,168,3360,56,4000000000,71.42857142857143
413,5,3,8,51.625,137.66666666666666,2065,34.416666666666664,3000000000,87.16707021791768
1040,7,5,12,86.66666666666667,208,5200,86.66666666666667,5000000000,57.692307692307686
493,4,3,7,70.42857142857143,164.33333333333334,2465,41.083333333333336,3000000000,73.02231237322515
752,16,3,19,39.578947368421055,250.66666666666666,3760,62.666666666666664,3000000000,47.87234042553192
536,7,3,10,53.6,178.66666666666666,2680,44.666666666666664,3000000000,67.16417910447761
852,9,6,15,56.8,142,4260,71,6000000000,84.50704225352113
334,5,3,8,41.75,111.33333333333333,1670,27.833333333333332,3000000000,107.78443113772455
520,6,5,11,47.27272727272727,104,2600,43.333333333333336,5000000000,115.38461538461537
663,9,3,12,55.25,221,3315,55.25,3000000000,54.29864253393665
721,17,7,24,30.041666666666668,103,3605,60.083333333333336,7000000000,116.50485436893204
688,9,3,12,57.333333333333336,229.33333333333334,3440,57.333333333333336,3000000000,52.325581395348834
633,17,3,20,31.65,211,3165,52.75,3000000000,56.87203791469194
531,13,4,17,31.235294117647058,132.75,2655,44.25,4000000000,90.3954802259887
878,11,3,14,62.714285714285715,292.6666666666667,4390,73.16666666666667,3000000000,41.00227790432802
645,9,3,12,53.75,215,3225,53.75,3000000000,55.81395348837209
1051,16,11,27,38.925925925925924,95.54545454545455,5255,87.58333333333333,11000000000,125.59467174119887
562,11,3,14,40.142857142857146,187.33333333333334,2810,46.833333333333336,3000000000,64.05693950177935
1021,20,11,31,32.935483870967744,92.81818181818181,5105,85.08333333333333,11000000000,129.28501469147895
625,6,4,10,62.5,156.25,3125,52.083333333333336,4000000000,76.8
506,8,4,12,42.166666666666664,126.5,2530,42.166666666666664,4000000000,94.86166007905139
815,14,3,17,47.94117647058823,271.6666666666667,4075,67.91666666666667,3000000000,44.17177914110429
654,6,3,9,72.66666666666667,218,3270,54.5,3000000000,55.04587155963302
1077,11,9,20,53.85,119.66666666666667,5385,89.75,9000000000,100.27855153203343
520,9,3,12,43.333333333333336,173.33333333333334,2600,43.333333333333336,3000000000,69.23076923076923
188,3,3,6,31.333333333333332,62.666666666666664,940,15.666666666666666,3000000000,191.48936170212767
795,9,9,18,44.166666666666664,88.33333333333333,3975,66.25,9000000000,135.8490566037736
758,14,3,17,44.588235294117645,252.66666666666666,3790,63.166666666666664,3000000000,47.4934036939314
654,10,3,13,50.30769230769231,218,3270,54.5,3000000000,55.04587155963302
573,9,6,15,38.2,95.5,2865,47.75,6000000000,125.6544502617801
372,4,3,7,53.142857142857146,124,1860,31,3000000000,96.77419354838709
388,5,3,8,48.5,129.33333333333334,1940,32.333333333333336,3000000000,92.78350515463917
451,8,4,12,37.583333333333336,112.75,2255,37.583333333333336,4000000000,106.43015521064301
703,11,5,16,43.9375,140.6,3515,58.583333333333336,5000000000,85.34850640113798
932,11,5,16,58.25,186.4,4660,77.66666666666667,5000000000,64.37768240343347
569,3,4,7,81.28571428571429,142.25,2845,47.416666666666664,4000000000,84.3585237258348
465,7,5,12,38.75,93,2325,38.75,5000000000,129.03225806451613
456,8,6,14,32.57142857142857,76,2280,38,6000000000,157.89473684210526
554,7,5,12,46.166666666666664,110.8,2770,46.166666666666664,5000000000,108.30324909747294
722,13,3,16,45.125,240.66666666666666,3610,60.166666666666664,3000000000,49.86149584487535
669,8,10,18,37.166666666666664,66.9,3345,55.75,10000000000,179.37219730941703
631,7,3,10,63.1,210.33333333333334,3155,52.583333333333336,3000000000,57.05229793977813
887,15,3,18,49.27777777777778,295.6666666666667,4435,73.91666666666667,3000000000,40.58624577226606
1333,20,10,30,44.43333333333333,133.3,6665,111.08333333333333,10000000000,90.02250562640661
683,8,3,11,62.09090909090909,227.66666666666666,3415,56.916666666666664,3000000000,52.7086383601757
571,9,4,13,43.92307692307692,142.75,2855,47.583333333333336,4000000000,84.0630472854641
460,12,3,15,30.666666666666668,153.33333333333334,2300,38.333333333333336,3000000000,78.26086956521739
533,13,6,19,28.05263157894737,88.83333333333333,2665,44.416666666666664,6000000000,135.0844277673546
693,4,11,15,46.2,63,3465,57.75,11000000000,190.47619047619048
686,14,3,17,40.35294117647059,228.66666666666666,3430,57.166666666666664,3000000000,52.478134110787174
1237,13,9,22,56.22727272727273,137.44444444444446,6185,103.08333333333333,9000000000,87.30800323362975
566,5,5,10,56.6,113.2,2830,47.166666666666664,5000000000,106.00706713780919
530,4,5,9,58.888888888888886,106,2650,44.166666666666664,5000000000,113.20754716981132
978,12,14,26,37.61538461538461,69.85714285714286,4890,81.5,14000000000,171.77914110429447
176,5,3,8,22,58.666666666666664,880,14.666666666666666,3000000000,204.54545454545456
687,12,3,15,45.8,229,3435,57.25,3000000000,52.40174672489083
581,10,3,13,44.69230769230769,193.66666666666666,2905,48.416666666666664,3000000000,61.96213425129088
679,8,3,11,61.72727272727273,226.33333333333334,3395,56.583333333333336,3000000000,53.01914580265096
542,12,3,15,36.13333333333333,180.66666666666666,2710,45.166666666666664,3000000000,66.42066420664207
625,6,3,9,69.44444444444444,208.33333333333334,3125,52.083333333333336,3000000000,57.6
508,11,7,18,28.22222222222222,72.57142857142857,2540,42.333333333333336,7000000000,165.3543307086614
727,8,7,15,48.46666666666667,103.85714285714286,3635,60.583333333333336,7000000000,115.5433287482806
788,14,5,19,41.473684210526315,157.6,3940,65.66666666666667,5000000000,76.14213197969542
576,4,6,10,57.6,96,2880,48,6000000000,125
560,9,3,12,46.666666666666664,186.66666666666666,2800,46.666666666666664,3000000000,64.28571428571429
427,8,4,12,35.583333333333336,106.75,2135,35.583333333333336,4000000000,112.41217798594847
825,10,3,13,63.46153846153846,275,4125,68.75,3000000000,43.63636363636363
296,6,3,9,32.888888888888886,98.66666666666667,1480,24.666666666666668,3000000000,121.62162162162161
989,17,6,23,43,164.83333333333334,4945,82.41666666666667,6000000000,72.80080889787664
748,11,3,14,53.42857142857143,249.33333333333334,3740,62.333333333333336,3000000000,48.1283422459893
514,8,4,12,42.833333333333336,128.5,2570,42.833333333333336,4000000000,93.3852140077821
571,13,8,21,27.19047619047619,71.375,2855,47.583333333333336,8000000000,168.1260945709282
997,5,10,15,66.46666666666667,99.7,4985,83.08333333333333,10000000000,120.36108324974926
509,5,6,11,46.27272727272727,84.83333333333333,2545,42.416666666666664,6000000000,141.4538310412574
311,7,3,10,31.1,103.66666666666667,1555,25.916666666666668,3000000000,115.75562700964629
879,8,6,14,62.785714285714285,146.5,4395,73.25,6000000000,81.91126279863481
772,6,7,13,59.38461538461539,110.28571428571429,3860,64.33333333333333,7000000000,108.80829015544042
305,7,3,10,30.5,101.66666666666667,1525,25.416666666666668,3000000000,118.03278688524588
609,4,3,7,87,203,3045,50.75,3000000000,59.11330049261083
592,9,7,16,37,84.57142857142857,2960,49.333333333333336,7000000000,141.8918918918919
876,11,3,14,62.57142857142857,292,4380,73,3000000000,41.0958904109589
927,12,3,15,61.8,309,4635,77.25,3000000000,38.834951456310684
546,7,3,10,54.6,182,2730,45.5,3000000000,65.93406593406593
1150,12,4,16,71.875,287.5,5750,95.83333333333333,4000000000,41.73913043478261
333,3,3,6,55.5,111,1665,27.75,3000000000,108.1081081081081
713,12,5,17,41.94117647058823,142.6,3565,59.416666666666664,5000000000,84.1514726507714
569,6,3,9,63.22222222222222,189.66666666666666,2845,47.416666666666664,3000000000,63.26889279437611
121,4,3,7,17.285714285714285,40.333333333333336,605,10.083333333333334,3000000000,297.5206611570248
670,11,3,14,47.857142857142854,223.33333333333334,3350,55.833333333333336,3000000000,53.731343283582085
1001,28,11,39,25.666666666666668,91,5005,83.41666666666667,11000000000,131.86813186813185
549,11,3,14,39.214285714285715,183,2745,45.75,3000000000,65.57377049180329
766,8,6,14,54.714285714285715,127.66666666666667,3830,63.833333333333336,6000000000,93.99477806788512
578,12,3,15,38.53333333333333,192.66666666666666,2890,48.166666666666664,3000000000,62.28373702422146
810,12,3,15,54,270,4050,67.5,3000000000,44.44444444444445
634,9,4,13,48.76923076923077,158.5,3170,52.833333333333336,4000000000,75.70977917981072
182,8,3,11,16.545454545454547,60.666666666666664,910,15.166666666666666,3000000000,197.8021978021978
520,11,5,16,32.5,104,2600,43.333333333333336,5000000000,115.38461538461537
442,4,3,7,63.142857142857146,147.33333333333334,2210,36.833333333333336,3000000000,81.44796380090497
499,7,3,10,49.9,166.33333333333334,2495,41.583333333333336,3000000000,72.14428857715431
776,10,6,16,48.5,129.33333333333334,3880,64.66666666666667,6000000000,92.78350515463917
791,8,3,11,71.9090909090909,263.6666666666667,3955,65.91666666666667,3000000000,45.51201011378002
350,5,3,8,43.75,116.66666666666667,1750,29.166666666666668,3000000000,102.85714285714285
1142,18,7,25,45.68,163.14285714285714,5710,95.16666666666667,7000000000,73.55516637478108
483,9,3,12,40.25,161,2415,40.25,3000000000,74.53416149068323
602,4,6,10,60.2,100.33333333333333,3010,50.166666666666664,6000000000,119.60132890365449
223,5,3,8,27.875,74.33333333333333,1115,18.583333333333332,3000000000,161.43497757847535
487,7,3,10,48.7,162.33333333333334,2435,40.583333333333336,3000000000,73.92197125256672
573,6,3,9,63.666666666666664,191,2865,47.75,3000000000,62.82722513089005
686,4,3,7,98,228.66666666666666,3430,57.166666666666664,3000000000,52.478134110787174
816,8,6,14,58.285714285714285,136,4080,68,6000000000,88.23529411764706
425,7,3,10,42.5,141.66666666666666,2125,35.416666666666664,3000000000,84.70588235294119
838,15,6,21,39.904761904761905,139.66666666666666,4190,69.83333333333333,6000000000,85.91885441527447
538,6,3,9,59.77777777777778,179.33333333333334,2690,44.833333333333336,3000000000,66.91449814126393
743,8,5,13,57.15384615384615,148.6,3715,61.916666666666664,5000000000,80.75370121130551
472,9,5,14,33.714285714285715,94.4,2360,39.333333333333336,5000000000,127.11864406779661
281,3,3,6,46.833333333333336,93.66666666666667,1405,23.416666666666668,3000000000,128.1138790035587
643,9,3,12,53.583333333333336,214.33333333333334,3215,53.583333333333336,3000000000,55.987558320373246
329,7,4,11,29.90909090909091,82.25,1645,27.416666666666668,4000000000,145.8966565349544
659,10,4,14,47.07142857142857,164.75,3295,54.916666666666664,4000000000,72.83763277693475
539,8,3,11,49,179.66666666666666,2695,44.916666666666664,3000000000,66.79035250463822
862,10,8,18,47.888888888888886,107.75,4310,71.83333333333333,8000000000,111.36890951276102
786,7,7,14,56.142857142857146,112.28571428571429,3930,65.5,7000000000,106.87022900763358
799,11,3,14,57.07142857142857,266.3333333333333,3995,66.58333333333333,3000000000,45.056320400500624
414,11,3,14,29.571428571428573,138,2070,34.5,3000000000,86.95652173913044
339,6,3,9,37.666666666666664,113,1695,28.25,3000000000,106.19469026548673
473,6,3,9,52.55555555555556,157.66666666666666,2365,39.416666666666664,3000000000,76.10993657505286
507,8,3,11,46.09090909090909,169,2535,42.25,3000000000,71.0059171597633
393,8,3,11,35.72727272727273,131,1965,32.75,3000000000,91.6030534351145
591,8,5,13,45.46153846153846,118.2,2955,49.25,5000000000,101.52284263959392
543,7,3,10,54.3,181,2715,45.25,3000000000,66.29834254143647
396,4,5,9,44,79.2,1980,33,5000000000,151.5151515151515
1099,15,11,26,42.26923076923077,99.9090909090909,5495,91.58333333333333,11000000000,120.10919017288445
647,15,5,20,32.35,129.4,3235,53.916666666666664,5000000000,92.73570324574962
296,5,3,8,37,98.66666666666667,1480,24.666666666666668,3000000000,121.62162162162161
1428,22,6,28,51,238,7140,119,6000000000,50.420168067226896
437,12,3,15,29.133333333333333,145.66666666666666,2185,36.416666666666664,3000000000,82.37986270022884
627,8,5,13,48.23076923076923,125.4,3135,52.25,5000000000,95.69377990430621
583,8,3,11,53,194.33333333333334,2915,48.583333333333336,3000000000,61.74957118353345
801,10,3,13,61.61538461538461,267,4005,66.75,3000000000,44.9438202247191
955,15,3,18,53.05555555555556,318.3333333333333,4775,79.58333333333333,3000000000,37.696335078534034
221,6,3,9,24.555555555555557,73.66666666666667,1105,18.416666666666668,3000000000,162.89592760180994
400,7,4,11,36.36363636363637,100,2000,33.333333333333336,4000000000,119.99999999999999
726,8,8,16,45.375,90.75,3630,60.5,8000000000,132.23140495867767
534,10,3,13,41.07692307692308,178,2670,44.5,3000000000,67.41573033707864
1068,16,3,19,56.21052631578947,356,5340,89,3000000000,33.70786516853932
344,5,3,8,43,114.66666666666667,1720,28.666666666666668,3000000000,104.65116279069767
328,6,3,9,36.44444444444444,109.33333333333333,1640,27.333333333333332,3000000000,109.7560975609756
535,10,3,13,41.15384615384615,178.33333333333334,2675,44.583333333333336,3000000000,67.28971962616822
1121,20,3,23,48.73913043478261,373.6666666666667,5605,93.41666666666667,3000000000,32.114183764495984
534,11,3,14,38.142857142857146,178,2670,44.5,3000000000,67.41573033707864
297,7,3,10,29.7,99,1485,24.75,3000000000,121.21212121212122
1018,14,3,17,59.88235294117647,339.3333333333333,5090,84.83333333333333,3000000000,35.36345776031435
365,6,3,9,40.55555555555556,121.66666666666667,1825,30.416666666666668,3000000000,98.63013698630137
324,5,3,8,40.5,108,1620,27,3000000000,111.1111111111111
589,15,3,18,32.72222222222222,196.33333333333334,2945,49.083333333333336,3000000000,61.120543293718164
439,5,3,8,54.875,146.33333333333334,2195,36.583333333333336,3000000000,82.00455580865604
469,10,5,15,31.266666666666666,93.8,2345,39.083333333333336,5000000000,127.93176972281448
791,11,3,14,56.5,263.6666666666667,3955,65.91666666666667,3000000000,45.51201011378002
248,7,3,10,24.8,82.66666666666667,1240,20.666666666666668,3000000000,145.16129032258064
340,6,3,9,37.77777777777778,113.33333333333333,1700,28.333333333333332,3000000000,105.88235294117648
676,12,4,16,42.25,169,3380,56.333333333333336,4000000000,71.0059171597633
656,10,5,15,43.733333333333334,131.2,3280,54.666666666666664,5000000000,91.46341463414635
628,10,3,13,48.30769230769231,209.33333333333334,3140,52.333333333333336,3000000000,57.324840764331206
517,8,3,11,47,172.33333333333334,2585,43.083333333333336,3000000000,69.63249516441006
236,5,3,8,29.5,78.66666666666667,1180,19.666666666666668,3000000000,152.5423728813559
769,9,6,15,51.266666666666666,128.16666666666666,3845,64.08333333333333,6000000000,93.62808842652797
729,14,4,18,40.5,182.25,3645,60.75,4000000000,65.84362139917695
844,10,3,13,64.92307692307692,281.3333333333333,4220,70.33333333333333,3000000000,42.65402843601896
688,11,5,16,43,137.6,3440,57.333333333333336,5000000000,87.20930232558139
736,6,6,12,61.333333333333336,122.66666666666667,3680,61.333333333333336,6000000000,97.82608695652173
531,7,3,10,53.1,177,2655,44.25,3000000000,67.79661016949153
622,14,3,17,36.588235294117645,207.33333333333334,3110,51.833333333333336,3000000000,57.877813504823145
675,6,3,9,75,225,3375,56.25,3000000000,53.333333333333336
1016,12,6,18,56.44444444444444,169.33333333333334,5080,84.66666666666667,6000000000,70.86614173228345
168,3,3,6,28,56,840,14,3000000000,214.2857142857143
931,16,3,19,49,310.3333333333333,4655,77.58333333333333,3000000000,38.66809881847476
216,4,3,7,30.857142857142858,72,1080,18,3000000000,166.66666666666666
443,5,3,8,55.375,147.66666666666666,2215,36.916666666666664,3000000000,81.26410835214448
386,8,3,11,35.09090909090909,128.66666666666666,1930,32.166666666666664,3000000000,93.26424870466322
224,4,4,8,28,56,1120,18.666666666666668,4000000000,214.28571428571428
1002,15,5,20,50.1,200.4,5010,83.5,5000000000,59.88023952095808
565,14,3,17,33.23529411764706,188.33333333333334,2825,47.083333333333336,3000000000,63.716814159292035
519,9,4,13,39.92307692307692,129.75,2595,43.25,4000000000,92.48554913294798
613,13,6,19,32.26315789473684,102.16666666666667,3065,51.083333333333336,6000000000,117.45513866231647
607,16,3,19,31.94736842105263,202.33333333333334,3035,50.583333333333336,3000000000,59.308072487644154
535,7,3,10,53.5,178.33333333333334,2675,44.583333333333336,3000000000,67.28971962616822
408,6,5,11,37.09090909090909,81.6,2040,34,5000000000,147.05882352941177
593,7,3,10,59.3,197.66666666666666,2965,49.416666666666664,3000000000,60.708263069139974
585,12,3,15,39,195,2925,48.75,3000000000,61.53846153846153
708,13,4,17,41.64705882352941,177,3540,59,4000000000,67.79661016949153
292,9,3,12,24.333333333333332,97.33333333333333,1460,24.333333333333332,3000000000,123.28767123287672
476,8,4,12,39.666666666666664,119,2380,39.666666666666664,4000000000,100.84033613445379
414,7,3,10,41.4,138,2070,34.5,3000000000,86.95652173913044
208,4,3,7,29.714285714285715,69.33333333333333,1040,17.333333333333332,3000000000,173.0769230769231
682,12,3,15,45.46666666666667,227.33333333333334,3410,56.833333333333336,3000000000,52.785923753665685
708,8,4,12,59,177,3540,59,4000000000,67.79661016949153
838,16,3,19,44.10526315789474,279.3333333333333,4190,69.83333333333333,3000000000,42.95942720763723
913,16,4,20,45.65,228.25,4565,76.08333333333333,4000000000,52.573932092004384
1286,25,3,28,45.92857142857143,428.6666666666667,6430,107.16666666666667,3000000000,27.993779160186623
1131,20,9,29,39,125.66666666666667,5655,94.25,9000000000,95.49071618037136
839,12,6,18,46.611111111111114,139.83333333333334,4195,69.91666666666667,6000000000,85.81644815256257
587,7,5,12,48.916666666666664,117.4,2935,48.916666666666664,5000000000,102.21465076660989
318,8,3,11,28.90909090909091,106,1590,26.5,3000000000,113.20754716981132
909,10,3,13,69.92307692307692,303,4545,75.75,3000000000,39.603960396039604
912,15,5,20,45.6,182.4,4560,76,5000000000,65.78947368421052
439,5,3,8,54.875,146.33333333333334,2195,36.583333333333336,3000000000,82.00455580865604
274,6,3,9,30.444444444444443,91.33333333333333,1370,22.833333333333332,3000000000,131.38686131386862
710,10,4,14,50.714285714285715,177.5,3550,59.166666666666664,4000000000,67.6056338028169
559,12,4,16,34.9375,139.75,2795,46.583333333333336,4000000000,85.86762075134168
567,9,6,15,37.8,94.5,2835,47.25,6000000000,126.98412698412699
708,8,6,14,50.57142857142857,118,3540,59,6000000000,101.69491525423729
534,8,3,11,48.54545454545455,178,2670,44.5,3000000000,67.41573033707864
393,3,4,7,56.142857142857146,98.25,1965,32.75,4000000000,122.13740458015268
667,13,8,21,31.761904761904763,83.375,3335,55.583333333333336,8000000000,143.928035982009
344,6,6,12,28.666666666666668,57.333333333333336,1720,28.666666666666668,6000000000,209.30232558139534
786,5,5,10,78.6,157.2,3930,65.5,5000000000,76.33587786259542
846,7,6,13,65.07692307692308,141,4230,70.5,6000000000,85.1063829787234
334,7,4,11,30.363636363636363,83.5,1670,27.833333333333332,4000000000,143.7125748502994
557,6,3,9,61.888888888888886,185.66666666666666,2785,46.416666666666664,3000000000,64.63195691202873
337,7,3,10,33.7,112.33333333333333,1685,28.083333333333332,3000000000,106.82492581602374
499,7,4,11,45.36363636363637,124.75,2495,41.583333333333336,4000000000,96.19238476953907
412,4,3,7,58.857142857142854,137.33333333333334,2060,34.333333333333336,3000000000,87.37864077669902
458,9,3,12,38.166666666666664,152.66666666666666,2290,38.166666666666664,3000000000,78.60262008733625
298,6,3,9,33.111111111111114,99.33333333333333,1490,24.833333333333332,3000000000,120.8053691275168
927,11,3,14,66.21428571428571,309,4635,77.25,3000000000,38.834951456310684
545,9,4,13,41.92307692307692,136.25,2725,45.416666666666664,4000000000,88.07339449541284
412,6,3,9,45.77777777777778,137.33333333333334,2060,34.333333333333336,3000000000,87.37864077669902
375,7,3,10,37.5,125,1875,31.25,3000000000,96
520,5,3,8,65,173.33333333333334,2600,43.333333333333336,3000000000,69.23076923076923
635,5,3,8,79.375,211.66666666666666,3175,52.916666666666664,3000000000,56.69291338582677
465,10,3,13,35.76923076923077,155,2325,38.75,3000000000,77.41935483870968
372,7,3,10,37.2,124,1860,31,3000000000,96.77419354838709
412,6,5,11,37.45454545454545,82.4,2060,34.333333333333336,5000000000,145.63106796116503
792,7,5,12,66,158.4,3960,66,5000000000,75.75757575757575
554,10,4,14,39.57142857142857,138.5,2770,46.166666666666664,4000000000,86.64259927797835
362,6,7,13,27.846153846153847,51.714285714285715,1810,30.166666666666668,7000000000,232.04419889502762
1020,10,9,19,53.68421052631579,113.33333333333333,5100,85,9000000000,105.88235294117648
1044,17,12,29,36,87,5220,87,12000000000,137.9310344827586
232,4,3,7,33.142857142857146,77.33333333333333,1160,19.333333333333332,3000000000,155.17241379310346
572,7,8,15,38.13333333333333,71.5,2860,47.666666666666664,8000000000,167.83216783216784
522,12,3,15,34.8,174,2610,43.5,3000000000,68.9655172413793
360,6,4,10,36,90,1800,30,4000000000,133.33333333333331
528,7,8,15,35.2,66,2640,44,8000000000,181.8181818181818
776,15,3,18,43.111111111111114,258.6666666666667,3880,64.66666666666667,3000000000,46.391752577319586
324,7,3,10,32.4,108,1620,27,3000000000,111.1111111111111
583,6,9,15,38.86666666666667,64.77777777777777,2915,48.583333333333336,9000000000,185.24871355060031
520,5,4,9,57.77777777777778,130,2600,43.333333333333336,4000000000,92.3076923076923
963,12,10,22,43.77272727272727,96.3,4815,80.25,10000000000,124.61059190031153
745,11,3,14,53.214285714285715,248.33333333333334,3725,62.083333333333336,3000000000,48.32214765100671
325,6,3,9,36.111111111111114,108.33333333333333,1625,27.083333333333332,3000000000,110.76923076923077
277,12,3,15,18.466666666666665,92.33333333333333,1385,23.083333333333332,3000000000,129.9638989169675
288,9,4,13,22.153846153846153,72,1440,24,4000000000,166.66666666666666
642,10,4,14,45.857142857142854,160.5,3210,53.5,4000000000,74.76635514018692
793,10,3,13,61,264.3333333333333,3965,66.08333333333333,3000000000,45.39722572509458
1178,24,3,27,43.629629629629626,392.6666666666667,5890,98.16666666666667,3000000000,30.560271646859082
264,4,5,9,29.333333333333332,52.8,1320,22,5000000000,227.27272727272728
588,14,6,20,29.4,98,2940,49,6000000000,122.44897959183673
561,6,5,11,51,112.2,2805,46.75,5000000000,106.951871657754
492,7,3,10,49.2,164,2460,41,3000000000,73.17073170731707
519,13,3,16,32.4375,173,2595,43.25,3000000000,69.36416184971098
332,4,4,8,41.5,83,1660,27.666666666666668,4000000000,144.57831325301203
462,6,5,11,42,92.4,2310,38.5,5000000000,129.87012987012986
241,6,3,9,26.77777777777778,80.33333333333333,1205,20.083333333333332,3000000000,149.37759336099586
426,4,4,8,53.25,106.5,2130,35.5,4000000000,112.67605633802816
223,6,3,9,24.77777777777778,74.33333333333333,1115,18.583333333333332,3000000000,161.43497757847535
588,14,4,18,32.666666666666664,147,2940,49,4000000000,81.63265306122449
926,11,3,14,66.14285714285714,308.6666666666667,4630,77.16666666666667,3000000000,38.8768898488121
344,4,3,7,49.142857142857146,114.66666666666667,1720,28.666666666666668,3000000000,104.65116279069767
426,5,3,8,53.25,142,2130,35.5,3000000000,84.50704225352113
528,7,5,12,44,105.6,2640,44,5000000000,113.63636363636364
286,3,3,6,47.666666666666664,95.33333333333333,1430,23.833333333333332,3000000000,125.87412587412588
632,8,3,11,57.45454545454545,210.66666666666666,3160,52.666666666666664,3000000000,56.9620253164557
845,11,5,16,52.8125,169,4225,70.41666666666667,5000000000,71.0059171597633
524,9,3,12,43.666666666666664,174.66666666666666,2620,43.666666666666664,3000000000,68.70229007633587
604,14,3,17,35.529411764705884,201.33333333333334,3020,50.333333333333336,3000000000,59.602649006622514
1165,19,8,27,43.148148148148145,145.625,5825,97.08333333333333,8000000000,82.40343347639485
799,12,6,18,44.388888888888886,133.16666666666666,3995,66.58333333333333,6000000000,90.11264080100125
217,8,3,11,19.727272727272727,72.33333333333333,1085,18.083333333333332,3000000000,165.89861751152074
1080,12,5,17,63.529411764705884,216,5400,90,5000000000,55.55555555555555
1225,17,7,24,51.041666666666664,175,6125,102.08333333333333,7000000000,68.57142857142857
1202,17,3,20,60.1,400.6666666666667,6010,100.16666666666667,3000000000,29.95008319467554
695,16,3,19,36.578947368421055,231.66666666666666,3475,57.916666666666664,3000000000,51.79856115107914
198,5,3,8,24.75,66,990,16.5,3000000000,181.8181818181818
358,5,3,8,44.75,119.33333333333333,1790,29.833333333333332,3000000000,100.5586592178771
230,4,3,7,32.857142857142854,76.66666666666667,1150,19.166666666666668,3000000000,156.52173913043478
251,5,3,8,31.375,83.66666666666667,1255,20.916666666666668,3000000000,143.42629482071712
364,6,4,10,36.4,91,1820,30.333333333333332,4000000000,131.86813186813188
547,9,3,12,45.583333333333336,182.33333333333334,2735,45.583333333333336,3000000000,65.81352833638024
532,8,3,11,48.36363636363637,177.33333333333334,2660,44.333333333333336,3000000000,67.66917293233082
283,7,3,10,28.3,94.33333333333333,1415,23.583333333333332,3000000000,127.20848056537103
720,9,7,16,45,102.85714285714286,3600,60,7000000000,116.66666666666667
510,11,5,16,31.875,102,2550,42.5,5000000000,117.6470588235294
565,10,4,14,40.357142857142854,141.25,2825,47.083333333333336,4000000000,84.95575221238938
734,13,4,17,43.1764705882353,183.5,3670,61.166666666666664,4000000000,65.39509536784742
614,11,4,15,40.93333333333333,153.5,3070,51.166666666666664,4000000000,78.17589576547232
1044,9,5,14,74.57142857142857,208.8,5220,87,5000000000,57.47126436781609
954,13,3,16,59.625,318,4770,79.5,3000000000,37.735849056603776
1141,20,3,23,49.608695652173914,380.3333333333333,5705,95.08333333333333,3000000000,31.551270815074496
662,13,5,18,36.77777777777778,132.4,3310,55.166666666666664,5000000000,90.6344410876133
447,4,6,10,44.7,74.5,2235,37.25,6000000000,161.07382550335572
197,3,3,6,32.833333333333336,65.66666666666667,985,16.416666666666668,3000000000,182.741116751269
857,8,3,11,77.9090909090909,285.6666666666667,4285,71.41666666666667,3000000000,42.00700116686114
621,11,3,14,44.357142857142854,207,3105,51.75,3000000000,57.971014492753625
580,15,6,21,27.61904761904762,96.66666666666667,2900,48.333333333333336,6000000000,124.13793103448275
688,13,4,17,40.470588235294116,172,3440,57.333333333333336,4000000000,69.76744186046511
416,6,3,9,46.22222222222222,138.66666666666666,2080,34.666666666666664,3000000000,86.53846153846155
523,5,3,8,65.375,174.33333333333334,2615,43.583333333333336,3000000000,68.83365200764818
410,7,3,10,41,136.66666666666666,2050,34.166666666666664,3000000000,87.8048780487805
145,3,3,6,24.166666666666668,48.333333333333336,725,12.083333333333334,3000000000,248.2758620689655
1109,18,6,24,46.208333333333336,184.83333333333334,5545,92.41666666666667,6000000000,64.92335437330928
719,4,6,10,71.9,119.83333333333333,3595,59.916666666666664,6000000000,100.13908205841447
331,5,3,8,41.375,110.33333333333333,1655,27.583333333333332,3000000000,108.76132930513594
408,5,4,9,45.333333333333336,102,2040,34,4000000000,117.6470588235294
340,9,3,12,28.333333333333332,113.33333333333333,1700,28.333333333333332,3000000000,105.88235294117648
373,10,4,14,26.642857142857142,93.25,1865,31.083333333333332,4000000000,128.686327077748
585,8,4,12,48.75,146.25,2925,48.75,4000000000,82.05128205128204
1199,15,7,22,54.5,171.28571428571428,5995,99.91666666666667,7000000000,70.05838198498748
221,4,3,7,31.571428571428573,73.66666666666667,1105,18.416666666666668,3000000000,162.89592760180994
208,6,3,9,23.11111111111111,69.33333333333333,1040,17.333333333333332,3000000000,173.0769230769231
614,11,3,14,43.857142857142854,204.66666666666666,3070,51.166666666666664,3000000000,58.63192182410423
413,5,5,10,41.3,82.6,2065,34.416666666666664,5000000000,145.27845036319613
370,7,3,10,37,123.33333333333333,1850,30.833333333333332,3000000000,97.2972972972973
723,16,3,19,38.05263157894737,241,3615,60.25,3000000000,49.79253112033195
1037,19,3,22,47.13636363636363,345.6666666666667,5185,86.41666666666667,3000000000,34.71552555448408
600,10,3,13,46.15384615384615,200,3000,50,3000000000,60
826,23,3,26,31.76923076923077,275.3333333333333,4130,68.83333333333333,3000000000,43.58353510895884
723,9,3,12,60.25,241,3615,60.25,3000000000,49.79253112033195
816,13,9,22,37.09090909090909,90.66666666666667,4080,68,9000000000,132.35294117647058
608,6,5,11,55.27272727272727,121.6,3040,50.666666666666664,5000000000,98.6842105263158
1202,13,8,21,57.23809523809524,150.25,6010,100.16666666666667,8000000000,79.86688851913478
533,6,5,11,48.45454545454545,106.6,2665,44.416666666666664,5000000000,112.5703564727955
603,12,3,15,40.2,201,3015,50.25,3000000000,59.701492537313435
568,9,3,12,47.333333333333336,189.33333333333334,2840,47.333333333333336,3000000000,63.38028169014084
761,11,10,21,36.23809523809524,76.1,3805,63.416666666666664,10000000000,157.68725361366623
574,3,3,6,95.66666666666667,191.33333333333334,2870,47.833333333333336,3000000000,62.7177700348432
785,10,5,15,52.333333333333336,157,3925,65.41666666666667,5000000000,76.43312101910828
450,9,6,15,30,75,2250,37.5,6000000000,160
343,7,3,10,34.3,114.33333333333333,1715,28.583333333333332,3000000000,104.95626822157435
459,3,3,6,76.5,153,2295,38.25,3000000000,78.4313725490196
1354,21,3,24,56.416666666666664,451.3333333333333,6770,112.83333333333333,3000000000,26.587887740029544
452,11,3,14,32.285714285714285,150.66666666666666,2260,37.666666666666664,3000000000,79.64601769911505
514,8,3,11,46.72727272727273,171.33333333333334,2570,42.833333333333336,3000000000,70.03891050583658
560,7,4,11,50.90909090909091,140,2800,46.666666666666664,4000000000,85.71428571428572
290,4,3,7,41.42857142857143,96.66666666666667,1450,24.166666666666668,3000000000,124.13793103448275
262,7,4,11,23.818181818181817,65.5,1310,21.833333333333332,4000000000,183.206106870229
582,6,3,9,64.66666666666667,194,2910,48.5,3000000000,61.855670103092784
715,6,6,12,59.583333333333336,119.16666666666667,3575,59.583333333333336,6000000000,100.6993006993007
596,10,3,13,45.84615384615385,198.66666666666666,2980,49.666666666666664,3000000000,60.4026845637584
321,4,4,8,40.125,80.25,1605,26.75,4000000000,149.53271028037383
1225,20,3,23,53.26086956521739,408.3333333333333,6125,102.08333333333333,3000000000,29.387755102040817
450,9,5,14,32.142857142857146,90,2250,37.5,5000000000,133.33333333333331
708,11,3,14,50.57142857142857,236,3540,59,3000000000,50.847457627118644
888,9,8,17,52.23529411764706,111,4440,74,8000000000,108.1081081081081
616,6,6,12,51.333333333333336,102.66666666666667,3080,51.333333333333336,6000000000,116.88311688311687
985,13,3,16,61.5625,328.3333333333333,4925,82.08333333333333,3000000000,36.54822335025381
335,8,3,11,30.454545454545453,111.66666666666667,1675,27.916666666666668,3000000000,107.46268656716417
502,8,6,14,35.857142857142854,83.66666666666667,2510,41.833333333333336,6000000000,143.42629482071712
548,13,3,16,34.25,182.66666666666666,2740,45.666666666666664,3000000000,65.69343065693431
956,20,3,23,41.56521739130435,318.6666666666667,4780,79.66666666666667,3000000000,37.65690376569037
791,9,3,12,65.91666666666667,263.6666666666667,3955,65.91666666666667,3000000000,45.51201011378002
386,7,5,12,32.166666666666664,77.2,1930,32.166666666666664,5000000000,155.44041450777203
694,7,3,10,69.4,231.33333333333334,3470,57.833333333333336,3000000000,51.87319884726225
1352,20,3,23,58.78260869565217,450.6666666666667,6760,112.66666666666667,3000000000,26.62721893491124
571,4,3,7,81.57142857142857,190.33333333333334,2855,47.583333333333336,3000000000,63.047285464098074
317,4,3,7,45.285714285714285,105.66666666666667,1585,26.416666666666668,3000000000,113.56466876971608
718,8,4,12,59.833333333333336,179.5,3590,59.833333333333336,4000000000,66.85236768802228
420,9,3,12,35,140,2100,35,3000000000,85.71428571428572
397,6,3,9,44.111111111111114,132.33333333333334,1985,33.083333333333336,3000000000,90.6801007556675
848,11,3,14,60.57142857142857,282.6666666666667,4240,70.66666666666667,3000000000,42.45283018867924
513,8,3,11,46.63636363636363,171,2565,42.75,3000000000,70.17543859649123
555,10,3,13,42.69230769230769,185,2775,46.25,3000000000,64.86486486486487
393,4,3,7,56.142857142857146,131,1965,32.75,3000000000,91.6030534351145
518,4,5,9,57.55555555555556,103.6,2590,43.166666666666664,5000000000,115.83011583011584
991,12,3,15,66.06666666666666,330.3333333333333,4955,82.58333333333333,3000000000,36.326942482341074
1209,15,3,18,67.16666666666667,403,6045,100.75,3000000000,29.776674937965257
970,16,3,19,51.05263157894737,323.3333333333333,4850,80.83333333333333,3000000000,37.11340206185567
735,13,3,16,45.9375,245,3675,61.25,3000000000,48.9795918367347
323,7,4,11,29.363636363636363,80.75,1615,26.916666666666668,4000000000,148.60681114551082
401,6,3,9,44.55555555555556,133.66666666666666,2005,33.416666666666664,3000000000,89.77556109725687
406,10,3,13,31.23076923076923,135.33333333333334,2030,33.833333333333336,3000000000,88.66995073891624
573,11,4,15,38.2,143.25,2865,47.75,4000000000,83.7696335078534
751,10,3,13,57.76923076923077,250.33333333333334,3755,62.583333333333336,3000000000,47.93608521970706
329,6,5,11,29.90909090909091,65.8,1645,27.416666666666668,5000000000,182.370820668693
596,7,4,11,54.18181818181818,149,2980,49.666666666666664,4000000000,80.53691275167786
476,8,3,11,43.27272727272727,158.66666666666666,2380,39.666666666666664,3000000000,75.63025210084035
635,3,4,7,90.71428571428571,158.75,3175,52.916666666666664,4000000000,75.59055118110237
389,8,3,11,35.36363636363637,129.66666666666666,1945,32.416666666666664,3000000000,92.54498714652956
570,9,3,12,47.5,190,2850,47.5,3000000000,63.1578947368421
476,5,4,9,52.888888888888886,119,2380,39.666666666666664,4000000000,100.84033613445379
598,10,3,13,46,199.33333333333334,2990,49.833333333333336,3000000000,60.20066889632107
693,7,6,13,53.30769230769231,115.5,3465,57.75,6000000000,103.8961038961039
1241,17,7,24,51.708333333333336,177.28571428571428,6205,103.41666666666667,7000000000,67.68734891216761
483,7,3,10,48.3,161,2415,40.25,3000000000,74.53416149068323
569,5,5,10,56.9,113.8,2845,47.416666666666664,5000000000,105.4481546572935
763,14,3,17,44.88235294117647,254.33333333333334,3815,63.583333333333336,3000000000,47.18217562254259
1046,19,3,22,47.54545454545455,348.6666666666667,5230,87.16666666666667,3000000000,34.41682600382409
369,6,3,9,41,123,1845,30.75,3000000000,97.5609756097561
728,10,4,14,52,182,3640,60.666666666666664,4000000000,65.93406593406594
833,13,3,16,52.0625,277.6666666666667,4165,69.41666666666667,3000000000,43.2172869147659
417,7,3,10,41.7,139,2085,34.75,3000000000,86.33093525179855
245,4,3,7,35,81.66666666666667,1225,20.416666666666668,3000000000,146.93877551020407
1047,17,6,23,45.52173913043478,174.5,5235,87.25,6000000000,68.76790830945559
328,3,4,7,46.857142857142854,82,1640,27.333333333333332,4000000000,146.34146341463415
735,15,5,20,36.75,147,3675,61.25,5000000000,81.63265306122449
598,6,3,9,66.44444444444444,199.33333333333334,2990,49.833333333333336,3000000000,60.20066889632107
306,5,3,8,38.25,102,1530,25.5,3000000000,117.6470588235294
338,5,4,9,37.55555555555556,84.5,1690,28.166666666666668,4000000000,142.0118343195266
701,9,3,12,58.416666666666664,233.66666666666666,3505,58.416666666666664,3000000000,51.35520684736092
784,12,3,15,52.266666666666666,261.3333333333333,3920,65.33333333333333,3000000000,45.91836734693878
812,10,6,16,50.75,135.33333333333334,4060,67.66666666666667,6000000000,88.66995073891624
543,6,3,9,60.333333333333336,181,2715,45.25,3000000000,66.29834254143647
528,7,3,10,52.8,176,2640,44,3000000000,68.18181818181819
619,6,5,11,56.27272727272727,123.8,3095,51.583333333333336,5000000000,96.93053311793214
854,10,3,13,65.6923076923077,284.6666666666667,4270,71.16666666666667,3000000000,42.15456674473067
537,11,4,15,35.8,134.25,2685,44.75,4000000000,89.38547486033521
403,4,5,9,44.77777777777778,80.6,2015,33.583333333333336,5000000000,148.88337468982627
997,14,10,24,41.541666666666664,99.7,4985,83.08333333333333,10000000000,120.36108324974926
145,3,3,6,24.166666666666668,48.333333333333336,725,12.083333333333334,3000000000,248.2758620689655
287,6,3,9,31.88888888888889,95.66666666666667,1435,23.916666666666668,3000000000,125.4355400696864
752,8,7,15,50.13333333333333,107.42857142857143,3760,62.666666666666664,7000000000,111.70212765957447
418,8,3,11,38,139.33333333333334,2090,34.833333333333336,3000000000,86.1244019138756
470,9,3,12,39.166666666666664,156.66666666666666,2350,39.166666666666664,3000000000,76.59574468085107
773,8,8,16,48.3125,96.625,3865,64.41666666666667,8000000000,124.1914618369987
381,7,3,10,38.1,127,1905,31.75,3000000000,94.48818897637796
511,5,3,8,63.875,170.33333333333334,2555,42.583333333333336,3000000000,70.45009784735812
669,9,3,12,55.75,223,3345,55.75,3000000000,53.81165919282511
778,12,3,15,51.86666666666667,259.3333333333333,3890,64.83333333333333,3000000000,46.27249357326478
380,7,3,10,38,126.66666666666667,1900,31.666666666666668,3000000000,94.73684210526316
878,11,6,17,51.64705882352941,146.33333333333334,4390,73.16666666666667,6000000000,82.00455580865604
300,6,5,11,27.272727272727273,60,1500,25,5000000000,200
959,17,3,20,47.95,319.6666666666667,4795,79.91666666666667,3000000000,37.53910323253389
180,3,3,6,30,60,900,15,3000000000,200
461,12,3,15,30.733333333333334,153.66666666666666,2305,38.416666666666664,3000000000,78.09110629067246
387,6,3,9,43,129,1935,32.25,3000000000,93.02325581395348
509,7,4,11,46.27272727272727,127.25,2545,42.416666666666664,4000000000,94.30255402750493
957,12,3,15,63.8,319,4785,79.75,3000000000,37.61755485893417
471,13,5,18,26.166666666666668,94.2,2355,39.25,5000000000,127.38853503184714
770,17,5,22,35,154,3850,64.16666666666667,5000000000,77.9220779220779
432,9,5,14,30.857142857142858,86.4,2160,36,5000000000,138.88888888888889
630,6,5,11,57.27272727272727,126,3150,52.5,5000000000,95.23809523809524
734,9,6,15,48.93333333333333,122.33333333333333,3670,61.166666666666664,6000000000,98.09264305177112
1020,21,3,24,42.5,340,5100,85,3000000000,35.29411764705882
347,6,3,9,38.55555555555556,115.66666666666667,1735,28.916666666666668,3000000000,103.7463976945245
497,9,5,14,35.5,99.4,2485,41.416666666666664,5000000000,120.72434607645876
927,15,3,18,51.5,309,4635,77.25,3000000000,38.834951456310684
511,11,4,15,34.06666666666667,127.75,2555,42.583333333333336,4000000000,93.9334637964775
1124,16,3,19,59.1578947368421,374.6666666666667,5620,93.66666666666667,3000000000,32.02846975088968
947,21,3,24,39.458333333333336,315.6666666666667,4735,78.91666666666667,3000000000,38.01478352692713
727,16,3,19,38.26315789473684,242.33333333333334,3635,60.583333333333336,3000000000,49.51856946354883
620,13,3,16,38.75,206.66666666666666,3100,51.666666666666664,3000000000,58.06451612903226
293,4,3,7,41.857142857142854,97.66666666666667,1465,24.416666666666668,3000000000,122.8668941979522
383,5,4,9,42.55555555555556,95.75,1915,31.916666666666668,4000000000,125.32637075718016
634,9,3,12,52.833333333333336,211.33333333333334,3170,52.833333333333336,3000000000,56.78233438485804
500,11,3,14,35.714285714285715,166.66666666666666,2500,41.666666666666664,3000000000,72
865,15,3,18,48.05555555555556,288.3333333333333,4325,72.08333333333333,3000000000,41.61849710982659
1107,11,6,17,65.11764705882354,184.5,5535,92.25,6000000000,65.04065040650407
536,7,6,13,41.23076923076923,89.33333333333333,2680,44.666666666666664,6000000000,134.32835820895522
484,6,3,9,53.77777777777778,161.33333333333334,2420,40.333333333333336,3000000000,74.3801652892562
980,17,3,20,49,326.6666666666667,4900,81.66666666666667,3000000000,36.73469387755102
666,8,3,11,60.54545454545455,222,3330,55.5,3000000000,54.05405405405405
487,4,7,11,44.27272727272727,69.57142857142857,2435,40.583333333333336,7000000000,172.48459958932236
493,8,3,11,44.81818181818182,164.33333333333334,2465,41.083333333333336,3000000000,73.02231237322515
338,6,4,10,33.8,84.5,1690,28.166666666666668,4000000000,142.0118343195266
279,5,3,8,34.875,93,1395,23.25,3000000000,129.03225806451613
150,5,4,9,16.666666666666668,37.5,750,12.5,4000000000,320
550,6,3,9,61.111111111111114,183.33333333333334,2750,45.833333333333336,3000000000,65.45454545454545
962,19,3,22,43.72727272727273,320.6666666666667,4810,80.16666666666667,3000000000,37.42203742203742
365,7,3,10,36.5,121.66666666666667,1825,30.416666666666668,3000000000,98.63013698630137
728,14,3,17,42.8235294117647,242.66666666666666,3640,60.666666666666664,3000000000,49.45054945054945
939,15,3,18,52.166666666666664,313,4695,78.25,3000000000,38.33865814696485
568,16,3,19,29.894736842105264,189.33333333333334,2840,47.333333333333336,3000000000,63.38028169014084
394,5,3,8,49.25,131.33333333333334,1970,32.833333333333336,3000000000,91.3705583756345
546,10,3,13,42,182,2730,45.5,3000000000,65.93406593406593
737,11,3,14,52.642857142857146,245.66666666666666,3685,61.416666666666664,3000000000,48.846675712347356
460,10,7,17,27.058823529411764,65.71428571428571,2300,38.333333333333336,7000000000,182.6086956521739
444,12,3,15,29.6,148,2220,37,3000000000,81.08108108108108
786,15,3,18,43.666666666666664,262,3930,65.5,3000000000,45.80152671755725
506,5,3,8,63.25,168.66666666666666,2530,42.166666666666664,3000000000,71.14624505928855
544,10,8,18,30.22222222222222,68,2720,45.333333333333336,8000000000,176.47058823529412
1016,15,9,24,42.333333333333336,112.88888888888889,5080,84.66666666666667,9000000000,106.2992125984252
458,7,4,11,41.63636363636363,114.5,2290,38.166666666666664,4000000000,104.80349344978167
235,3,3,6,39.166666666666664,78.33333333333333,1175,19.583333333333332,3000000000,153.19148936170214
374,6,3,9,41.55555555555556,124.66666666666667,1870,31.166666666666668,3000000000,96.2566844919786
327,3,3,6,54.5,109,1635,27.25,3000000000,110.09174311926604
562,7,3,10,56.2,187.33333333333334,2810,46.833333333333336,3000000000,64.05693950177935
399,9,3,12,33.25,133,1995,33.25,3000000000,90.22556390977444
789,13,6,19,41.526315789473685,131.5,3945,65.75,6000000000,91.25475285171102
597,10,3,13,45.92307692307692,199,2985,49.75,3000000000,60.301507537688444
709,10,3,13,54.53846153846154,236.33333333333334,3545,59.083333333333336,3000000000,50.77574047954865
751,9,8,17,44.1764705882353,93.875,3755,62.583333333333336,8000000000,127.82956058588547
761,13,4,17,44.76470588235294,190.25,3805,63.416666666666664,4000000000,63.074901445466494
689,10,8,18,38.27777777777778,86.125,3445,57.416666666666664,8000000000,139.3323657474601
639,14,3,17,37.588235294117645,213,3195,53.25,3000000000,56.33802816901408
688,10,3,13,52.92307692307692,229.33333333333334,3440,57.333333333333336,3000000000,52.325581395348834
513,9,3,12,42.75,171,2565,42.75,3000000000,70.17543859649123
745,11,3,14,53.214285714285715,248.33333333333334,3725,62.083333333333336,3000000000,48.32214765100671
669,11,4,15,44.6,167.25,3345,55.75,4000000000,71.74887892376682
409,8,3,11,37.18181818181818,136.33333333333334,2045,34.083333333333336,3000000000,88.01955990220048
963,8,7,15,64.2,137.57142857142858,4815,80.25,7000000000,87.22741433021807
774,10,3,13,59.53846153846154,258,3870,64.5,3000000000,46.51162790697674
987,18,9,27,36.55555555555556,109.66666666666667,4935,82.25,9000000000,109.4224924012158
908,13,7,20,45.4,129.71428571428572,4540,75.66666666666667,7000000000,92.51101321585902
911,12,5,17,53.588235294117645,182.2,4555,75.91666666666667,5000000000,65.86169045005488
479,6,4,10,47.9,119.75,2395,39.916666666666664,4000000000,100.20876826722339
833,10,7,17,49,119,4165,69.41666666666667,7000000000,100.84033613445378
426,9,5,14,30.428571428571427,85.2,2130,35.5,5000000000,140.8450704225352
560,7,9,16,35,62.22222222222222,2800,46.666666666666664,9000000000,192.85714285714286
693,14,3,17,40.76470588235294,231,3465,57.75,3000000000,51.94805194805195
782,11,3,14,55.857142857142854,260.6666666666667,3910,65.16666666666667,3000000000,46.03580562659846
756,10,4,14,54,189,3780,63,4000000000,63.492063492063494
441,8,3,11,40.09090909090909,147,2205,36.75,3000000000,81.63265306122449
422,5,4,9,46.888888888888886,105.5,2110,35.166666666666664,4000000000,113.74407582938389
563,9,3,12,46.916666666666664,187.66666666666666,2815,46.916666666666664,3000000000,63.94316163410302
1305,20,3,23,56.73913043478261,435,6525,108.75,3000000000,27.586206896551726
1065,18,3,21,50.714285714285715,355,5325,88.75,3000000000,33.80281690140845
581,11,6,17,34.1764705882353,96.83333333333333,2905,48.416666666666664,6000000000,123.92426850258175
1030,17,3,20,51.5,343.3333333333333,5150,85.83333333333333,3000000000,34.95145631067962
298,9,3,12,24.833333333333332,99.33333333333333,1490,24.833333333333332,3000000000,120.8053691275168
557,4,4,8,69.625,139.25,2785,46.416666666666664,4000000000,86.17594254937164
586,10,8,18,32.55555555555556,73.25,2930,48.833333333333336,8000000000,163.82252559726962
548,5,4,9,60.888888888888886,137,2740,45.666666666666664,4000000000,87.59124087591242
378,3,3,6,63,126,1890,31.5,3000000000,95.23809523809524
594,9,3,12,49.5,198,2970,49.5,3000000000,60.60606060606061
303,9,3,12,25.25,101,1515,25.25,3000000000,118.81188118811882
363,7,3,10,36.3,121,1815,30.25,3000000000,99.17355371900827
1283,26,3,29,44.241379310344826,427.6666666666667,6415,106.91666666666667,3000000000,28.05923616523772
594,7,3,10,59.4,198,2970,49.5,3000000000,60.60606060606061
972,8,3,11,88.36363636363636,324,4860,81,3000000000,37.03703703703704
620,3,5,8,77.5,124,3100,51.666666666666664,5000000000,96.77419354838709
776,10,7,17,45.64705882352941,110.85714285714286,3880,64.66666666666667,7000000000,108.24742268041237
1084,17,6,23,47.130434782608695,180.66666666666666,5420,90.33333333333333,6000000000,66.42066420664207
519,6,7,13,39.92307692307692,74.14285714285714,2595,43.25,7000000000,161.84971098265896
625,8,3,11,56.81818181818182,208.33333333333334,3125,52.083333333333336,3000000000,57.6
1085,14,3,17,63.8235294117647,361.6666666666667,5425,90.41666666666667,3000000000,33.17972350230414
618,13,3,16,38.625,206,3090,51.5,3000000000,58.25242718446602
639,6,8,14,45.642857142857146,79.875,3195,53.25,8000000000,150.23474178403757
523,7,3,10,52.3,174.33333333333334,2615,43.583333333333336,3000000000,68.83365200764818
579,6,6,12,48.25,96.5,2895,48.25,6000000000,124.35233160621762
741,11,5,16,46.3125,148.2,3705,61.75,5000000000,80.97165991902834
593,6,6,12,49.416666666666664,98.83333333333333,2965,49.416666666666664,6000000000,121.41652613827995
471,5,3,8,58.875,157,2355,39.25,3000000000,76.43312101910828
653,10,7,17,38.411764705882355,93.28571428571429,3265,54.416666666666664,7000000000,128.63705972434914
300,5,3,8,37.5,100,1500,25,3000000000,120
647,8,5,13,49.76923076923077,129.4,3235,53.916666666666664,5000000000,92.73570324574962
199,6,3,9,22.11111111111111,66.33333333333333,995,16.583333333333332,3000000000,180.90452261306532
1030,15,7,22,46.81818181818182,147.14285714285714,5150,85.83333333333333,7000000000,81.55339805825244
515,10,3,13,39.61538461538461,171.66666666666666,2575,42.916666666666664,3000000000,69.90291262135923
684,9,3,12,57,228,3420,57,3000000000,52.63157894736842
524,8,4,12,43.666666666666664,131,2620,43.666666666666664,4000000000,91.6030534351145
527,13,4,17,31,131.75,2635,43.916666666666664,4000000000,91.08159392789375
292,5,3,8,36.5,97.33333333333333,1460,24.333333333333332,3000000000,123.28767123287672
814,24,9,33,24.666666666666668,90.44444444444444,4070,67.83333333333333,9000000000,132.67813267813267
256,4,3,7,36.57142857142857,85.33333333333333,1280,21.333333333333332,3000000000,140.625
604,5,4,9,67.11111111111111,151,3020,50.333333333333336,4000000000,79.47019867549669
906,27,8,35,25.885714285714286,113.25,4530,75.5,8000000000,105.96026490066225
863,10,6,16,53.9375,143.83333333333334,4315,71.91666666666667,6000000000,83.42989571263034
502,5,3,8,62.75,167.33333333333334,2510,41.833333333333336,3000000000,71.71314741035856
904,12,8,20,45.2,113,4520,75.33333333333333,8000000000,106.19469026548673
1015,19,3,22,46.13636363636363,338.3333333333333,5075,84.58333333333333,3000000000,35.467980295566505
536,4,3,7,76.57142857142857,178.66666666666666,2680,44.666666666666664,3000000000,67.16417910447761
706,13,3,16,44.125,235.33333333333334,3530,58.833333333333336,3000000000,50.991501416430594
851,16,5,21,40.523809523809526,170.2,4255,70.91666666666667,5000000000,70.50528789659225
358,9,3,12,29.833333333333332,119.33333333333333,1790,29.833333333333332,3000000000,100.5586592178771
524,8,5,13,40.30769230769231,104.8,2620,43.666666666666664,5000000000,114.50381679389312
651,11,4,15,43.4,162.75,3255,54.25,4000000000,73.73271889400922
1170,13,6,19,61.578947368421055,195,5850,97.5,6000000000,61.53846153846153
409,6,5,11,37.18181818181818,81.8,2045,34.083333333333336,5000000000,146.69926650366747
322,5,4,9,35.77777777777778,80.5,1610,26.833333333333332,4000000000,149.06832298136646
418,8,3,11,38,139.33333333333334,2090,34.833333333333336,3000000000,86.1244019138756
736,8,3,11,66.9090909090909,245.33333333333334,3680,61.333333333333336,3000000000,48.91304347826087
540,10,3,13,41.53846153846154,180,2700,45,3000000000,66.66666666666666
649,10,3,13,49.92307692307692,216.33333333333334,3245,54.083333333333336,3000000000,55.46995377503852
599,10,3,13,46.07692307692308,199.66666666666666,2995,49.916666666666664,3000000000,60.10016694490819
757,19,4,23,32.91304347826087,189.25,3785,63.083333333333336,4000000000,63.40819022457067
625,11,3,14,44.642857142857146,208.33333333333334,3125,52.083333333333336,3000000000,57.6
552,3,3,6,92,184,2760,46,3000000000,65.21739130434783
968,18,7,25,38.72,138.28571428571428,4840,80.66666666666667,7000000000,86.77685950413223
564,9,3,12,47,188,2820,47,3000000000,63.829787234042556
880,19,4,23,38.26086956521739,220,4400,73.33333333333333,4000000000,54.54545454545455
823,14,3,17,48.411764705882355,274.3333333333333,4115,68.58333333333333,3000000000,43.74240583232078
417,5,3,8,52.125,139,2085,34.75,3000000000,86.33093525179855
554,14,3,17,32.588235294117645,184.66666666666666,2770,46.166666666666664,3000000000,64.98194945848375
807,13,3,16,50.4375,269,4035,67.25,3000000000,44.60966542750929
837,5,3,8,104.625,279,4185,69.75,3000000000,43.01075268817204
545,8,3,11,49.54545454545455,181.66666666666666,2725,45.416666666666664,3000000000,66.05504587155963
604,9,5,14,43.142857142857146,120.8,3020,50.333333333333336,5000000000,99.33774834437085
487,7,3,10,48.7,162.33333333333334,2435,40.583333333333336,3000000000,73.92197125256672
687,8,3,11,62.45454545454545,229,3435,57.25,3000000000,52.40174672489083
852,14,3,17,50.11764705882353,284,4260,71,3000000000,42.25352112676057
640,13,4,17,37.64705882352941,160,3200,53.333333333333336,4000000000,75
1266,13,10,23,55.04347826086956,126.6,6330,105.5,10000000000,94.7867298578199
1102,12,6,18,61.22222222222222,183.66666666666666,5510,91.83333333333333,6000000000,65.33575317604357
455,11,3,14,32.5,151.66666666666666,2275,37.916666666666664,3000000000,79.12087912087912
1541,17,3,20,77.05,513.6666666666666,7705,128.41666666666666,3000000000,23.361453601557432
837,11,3,14,59.785714285714285,279,4185,69.75,3000000000,43.01075268817204
637,12,3,15,42.46666666666667,212.33333333333334,3185,53.083333333333336,3000000000,56.5149136577708
539,12,3,15,35.93333333333333,179.66666666666666,2695,44.916666666666664,3000000000,66.79035250463822
444,13,3,16,27.75,148,2220,37,3000000000,81.08108108108108
397,10,4,14,28.357142857142858,99.25,1985,33.083333333333336,4000000000,120.90680100755667
256,5,3,8,32,85.33333333333333,1280,21.333333333333332,3000000000,140.625
537,8,6,14,38.357142857142854,89.5,2685,44.75,6000000000,134.0782122905028
916,16,8,24,38.166666666666664,114.5,4580,76.33333333333333,8000000000,104.80349344978167
591,8,7,15,39.4,84.42857142857143,2955,49.25,7000000000,142.13197969543148
646,11,8,19,34,80.75,3230,53.833333333333336,8000000000,148.60681114551082
600,7,3,10,60,200,3000,50,3000000000,60
637,12,3,15,42.46666666666667,212.33333333333334,3185,53.083333333333336,3000000000,56.5149136577708
895,12,3,15,59.666666666666664,298.3333333333333,4475,74.58333333333333,3000000000,40.22346368715084
441,10,3,13,33.92307692307692,147,2205,36.75,3000000000,81.63265306122449
413,13,4,17,24.294117647058822,103.25,2065,34.416666666666664,4000000000,116.2227602905569
479,8,3,11,43.54545454545455,159.66666666666666,2395,39.916666666666664,3000000000,75.15657620041755
1211,24,5,29,41.758620689655174,242.2,6055,100.91666666666667,5000000000,49.5458298926507
528,6,3,9,58.666666666666664,176,2640,44,3000000000,68.18181818181819
943,9,3,12,78.58333333333333,314.3333333333333,4715,78.58333333333333,3000000000,38.17603393425239
635,9,3,12,52.916666666666664,211.66666666666666,3175,52.916666666666664,3000000000,56.69291338582677
566,13,3,16,35.375,188.66666666666666,2830,47.166666666666664,3000000000,63.60424028268552
726,7,3,10,72.6,242,3630,60.5,3000000000,49.586776859504134
1388,28,3,31,44.774193548387096,462.6666666666667,6940,115.66666666666667,3000000000,25.936599423631126
1090,14,3,17,64.11764705882354,363.3333333333333,5450,90.83333333333333,3000000000,33.027522935779814
998,20,3,23,43.391304347826086,332.6666666666667,4990,83.16666666666667,3000000000,36.07214428857716
176,3,3,6,29.333333333333332,58.666666666666664,880,14.666666666666666,3000000000,204.54545454545456
1006,21,11,32,31.4375,91.45454545454545,5030,83.83333333333333,11000000000,131.2127236580517
512,5,6,11,46.54545454545455,85.33333333333333,2560,42.666666666666664,6000000000,140.625
435,9,3,12,36.25,145,2175,36.25,3000000000,82.75862068965517
373,4,3,7,53.285714285714285,124.33333333333333,1865,31.083333333333332,3000000000,96.514745308311
356,3,3,6,59.333333333333336,118.66666666666667,1780,29.666666666666668,3000000000,101.12359550561797
960,10,7,17,56.470588235294116,137.14285714285714,4800,80,7000000000,87.5
1305,25,3,28,46.607142857142854,435,6525,108.75,3000000000,27.586206896551726
499,6,7,13,38.38461538461539,71.28571428571429,2495,41.583333333333336,7000000000,168.33667334669337
637,12,3,15,42.46666666666667,212.33333333333334,3185,53.083333333333336,3000000000,56.5149136577708
768,10,3,13,59.07692307692308,256,3840,64,3000000000,46.875
801,7,3,10,80.1,267,4005,66.75,3000000000,44.9438202247191
443,7,3,10,44.3,147.66666666666666,2215,36.916666666666664,3000000000,81.26410835214448
903,10,7,17,53.11764705882353,129,4515,75.25,7000000000,93.02325581395348
493,9,3,12,41.083333333333336,164.33333333333334,2465,41.083333333333336,3000000000,73.02231237322515
946,18,3,21,45.04761904761905,315.3333333333333,4730,78.83333333333333,3000000000,38.05496828752643
801,12,6,18,44.5,133.5,4005,66.75,6000000000,89.8876404494382
357,6,4,10,35.7,89.25,1785,29.75,4000000000,134.45378151260505
1056,14,3,17,62.11764705882353,352,5280,88,3000000000,34.09090909090909
316,5,3,8,39.5,105.33333333333333,1580,26.333333333333332,3000000000,113.9240506329114
377,11,3,14,26.928571428571427,125.66666666666667,1885,31.416666666666668,3000000000,95.49071618037135
907,17,3,20,45.35,302.3333333333333,4535,75.58333333333333,3000000000,39.69128996692393
914,12,3,15,60.93333333333333,304.6666666666667,4570,76.16666666666667,3000000000,39.387308533916844
533,8,4,12,44.416666666666664,133.25,2665,44.416666666666664,4000000000,90.0562851782364
564,9,5,14,40.285714285714285,112.8,2820,47,5000000000,106.38297872340426
781,13,3,16,48.8125,260.3333333333333,3905,65.08333333333333,3000000000,46.09475032010244
1043,18,10,28,37.25,104.3,5215,86.91666666666667,10000000000,115.05273250239692
840,9,3,12,70,280,4200,70,3000000000,42.85714285714286
314,7,4,11,28.545454545454547,78.5,1570,26.166666666666668,4000000000,152.86624203821657
380,10,3,13,29.23076923076923,126.66666666666667,1900,31.666666666666668,3000000000,94.73684210526316
1543,26,3,29,53.206896551724135,514.3333333333334,7715,128.58333333333334,3000000000,23.331173039533372
826,10,3,13,63.53846153846154,275.3333333333333,4130,68.83333333333333,3000000000,43.58353510895884
1085,19,3,22,49.31818181818182,361.6666666666667,5425,90.41666666666667,3000000000,33.17972350230414
942,22,6,28,33.642857142857146,157,4710,78.5,6000000000,76.43312101910828
697,8,3,11,63.36363636363637,232.33333333333334,3485,58.083333333333336,3000000000,51.649928263988514
741,12,3,15,49.4,247,3705,61.75,3000000000,48.582995951417004
522,10,5,15,34.8,104.4,2610,43.5,5000000000,114.94252873563218
369,7,3,10,36.9,123,1845,30.75,3000000000,97.5609756097561
664,7,9,16,41.5,73.77777777777777,3320,55.333333333333336,9000000000,162.65060240963857
327,7,3,10,32.7,109,1635,27.25,3000000000,110.09174311926604
610,12,3,15,40.666666666666664,203.33333333333334,3050,50.833333333333336,3000000000,59.01639344262294
606,9,4,13,46.61538461538461,151.5,3030,50.5,4000000000,79.20792079207921
453,5,3,8,56.625,151,2265,37.75,3000000000,79.47019867549669
553,10,7,17,32.529411764705884,79,2765,46.083333333333336,7000000000,151.89873417721518
680,11,3,14,48.57142857142857,226.66666666666666,3400,56.666666666666664,3000000000,52.94117647058824
225,4,5,9,25,45,1125,18.75,5000000000,266.66666666666663
1035,14,10,24,43.125,103.5,5175,86.25,10000000000,115.94202898550725
775,13,7,20,38.75,110.71428571428571,3875,64.58333333333333,7000000000,108.38709677419355
770,5,5,10,77,154,3850,64.16666666666667,5000000000,77.9220779220779
232,7,3,10,23.2,77.33333333333333,1160,19.333333333333332,3000000000,155.17241379310346
292,7,5,12,24.333333333333332,58.4,1460,24.333333333333332,5000000000,205.4794520547945
438,7,3,10,43.8,146,2190,36.5,3000000000,82.1917808219178
882,10,4,14,63,220.5,4410,73.5,4000000000,54.421768707483
310,4,3,7,44.285714285714285,103.33333333333333,1550,25.833333333333332,3000000000,116.12903225806453
1069,12,6,18,59.388888888888886,178.16666666666666,5345,89.08333333333333,6000000000,67.35266604303088
583,6,4,10,58.3,145.75,2915,48.583333333333336,4000000000,82.3327615780446
1088,14,7,21,51.80952380952381,155.42857142857142,5440,90.66666666666667,7000000000,77.20588235294117
334,3,6,9,37.111111111111114,55.666666666666664,1670,27.833333333333332,6000000000,215.5688622754491
739,15,3,18,41.05555555555556,246.33333333333334,3695,61.583333333333336,3000000000,48.71447902571042
433,9,3,12,36.083333333333336,144.33333333333334,2165,36.083333333333336,3000000000,83.14087759815241
196,4,3,7,28,65.33333333333333,980,16.333333333333332,3000000000,183.67346938775512
531,10,3,13,40.84615384615385,177,2655,44.25,3000000000,67.79661016949153
292,6,3,9,32.44444444444444,97.33333333333333,1460,24.333333333333332,3000000000,123.28767123287672
636,9,8,17,37.411764705882355,79.5,3180,53,8000000000,150.9433962264151
1010,17,9,26,38.84615384615385,112.22222222222223,5050,84.16666666666667,9000000000,106.93069306930693
594,8,3,11,54,198,2970,49.5,3000000000,60.60606060606061
729,7,4,11,66.27272727272727,182.25,3645,60.75,4000000000,65.84362139917695
969,17,3,20,48.45,323,4845,80.75,3000000000,37.151702786377705
1319,12,3,15,87.93333333333334,439.6666666666667,6595,109.91666666666667,3000000000,27.293404094010615
386,6,6,12,32.166666666666664,64.33333333333333,1930,32.166666666666664,6000000000,186.52849740932643
628,8,6,14,44.857142857142854,104.66666666666667,3140,52.333333333333336,6000000000,114.64968152866241
1359,22,3,25,54.36,453,6795,113.25,3000000000,26.490066225165563
731,14,3,17,43,243.66666666666666,3655,60.916666666666664,3000000000,49.24760601915185
1247,23,7,30,41.56666666666667,178.14285714285714,6235,103.91666666666667,7000000000,67.3616680032077
380,7,3,10,38,126.66666666666667,1900,31.666666666666668,3000000000,94.73684210526316
627,10,3,13,48.23076923076923,209,3135,52.25,3000000000,57.41626794258373
818,14,5,19,43.05263157894737,163.6,4090,68.16666666666667,5000000000,73.34963325183374
1009,14,8,22,45.86363636363637,126.125,5045,84.08333333333333,8000000000,95.14370664023787
1725,27,18,45,38.333333333333336,95.83333333333333,8625,143.75,18000000000,125.21739130434783
313,3,3,6,52.166666666666664,104.33333333333333,1565,26.083333333333332,3000000000,115.01597444089457
739,11,7,18,41.05555555555556,105.57142857142857,3695,61.583333333333336,7000000000,113.66711772665765
1545,26,3,29,53.275862068965516,515,7725,128.75,3000000000,23.300970873786408
621,11,3,14,44.357142857142854,207,3105,51.75,3000000000,57.971014492753625
525,7,4,11,47.72727272727273,131.25,2625,43.75,4000000000,91.42857142857143
228,6,3,9,25.333333333333332,76,1140,19,3000000000,157.89473684210526
357,9,7,16,22.3125,51,1785,29.75,7000000000,235.2941176470588
603,9,5,14,43.07142857142857,120.6,3015,50.25,5000000000,99.50248756218906
342,5,3,8,42.75,114,1710,28.5,3000000000,105.26315789473684
763,18,3,21,36.333333333333336,254.33333333333334,3815,63.583333333333336,3000000000,47.18217562254259
456,5,3,8,57,152,2280,38,3000000000,78.94736842105263
390,5,3,8,48.75,130,1950,32.5,3000000000,92.3076923076923
394,7,4,11,35.81818181818182,98.5,1970,32.833333333333336,4000000000,121.82741116751268
383,6,3,9,42.55555555555556,127.66666666666667,1915,31.916666666666668,3000000000,93.99477806788512
556,8,3,11,50.54545454545455,185.33333333333334,2780,46.333333333333336,3000000000,64.74820143884892
1000,9,3,12,83.33333333333333,333.3333333333333,5000,83.33333333333333,3000000000,36
1196,10,7,17,70.3529411764706,170.85714285714286,5980,99.66666666666667,7000000000,70.23411371237458
756,9,3,12,63,252,3780,63,3000000000,47.61904761904762
692,13,4,17,40.705882352941174,173,3460,57.666666666666664,4000000000,69.36416184971098
1016,15,5,20,50.8,203.2,5080,84.66666666666667,5000000000,59.05511811023622
346,6,3,9,38.44444444444444,115.33333333333333,1730,28.833333333333332,3000000000,104.04624277456647
205,4,3,7,29.285714285714285,68.33333333333333,1025,17.083333333333332,3000000000,175.609756097561
995,21,3,24,41.458333333333336,331.6666666666667,4975,82.91666666666667,3000000000,36.18090452261306
731,20,5,25,29.24,146.2,3655,60.916666666666664,5000000000,82.07934336525308
454,5,3,8,56.75,151.33333333333334,2270,37.833333333333336,3000000000,79.29515418502203
456,5,3,8,57,152,2280,38,3000000000,78.94736842105263
982,18,7,25,39.28,140.28571428571428,4910,81.83333333333333,7000000000,85.53971486761712
189,3,3,6,31.5,63,945,15.75,3000000000,190.47619047619048
386,3,3,6,64.33333333333333,128.66666666666666,1930,32.166666666666664,3000000000,93.26424870466322
715,7,5,12,59.583333333333336,143,3575,59.583333333333336,5000000000,83.91608391608392
645,13,3,16,40.3125,215,3225,53.75,3000000000,55.81395348837209
260,8,3,11,23.636363636363637,86.66666666666667,1300,21.666666666666668,3000000000,138.46153846153845
693,10,3,13,53.30769230769231,231,3465,57.75,3000000000,51.94805194805195
988,10,3,13,76,329.3333333333333,4940,82.33333333333333,3000000000,36.43724696356276
775,7,6,13,59.61538461538461,129.16666666666666,3875,64.58333333333333,6000000000,92.90322580645162
621,8,7,15,41.4,88.71428571428571,3105,51.75,7000000000,135.2657004830918
522,6,6,12,43.5,87,2610,43.5,6000000000,137.9310344827586
642,9,5,14,45.857142857142854,128.4,3210,53.5,5000000000,93.45794392523365
1013,17,3,20,50.65,337.6666666666667,5065,84.41666666666667,3000000000,35.53800592300098
384,10,3,13,29.53846153846154,128,1920,32,3000000000,93.75
366,5,4,9,40.666666666666664,91.5,1830,30.5,4000000000,131.14754098360658
434,6,3,9,48.22222222222222,144.66666666666666,2170,36.166666666666664,3000000000,82.94930875576037
669,12,3,15,44.6,223,3345,55.75,3000000000,53.81165919282511
501,9,3,12,41.75,167,2505,41.75,3000000000,71.85628742514969
512,6,3,9,56.888888888888886,170.66666666666666,2560,42.666666666666664,3000000000,70.3125
564,9,7,16,35.25,80.57142857142857,2820,47,7000000000,148.93617021276597
584,6,3,9,64.88888888888889,194.66666666666666,2920,48.666666666666664,3000000000,61.64383561643836
1286,19,3,22,58.45454545454545,428.6666666666667,6430,107.16666666666667,3000000000,27.993779160186623
367,5,4,9,40.77777777777778,91.75,1835,30.583333333333332,4000000000,130.79019073569484
417,8,4,12,34.75,104.25,2085,34.75,4000000000,115.10791366906474
881,16,8,24,36.708333333333336,110.125,4405,73.41666666666667,8000000000,108.96708286038593
524,8,6,14,37.42857142857143,87.33333333333333,2620,43.666666666666664,6000000000,137.40458015267174
810,11,8,19,42.63157894736842,101.25,4050,67.5,8000000000,118.51851851851852
340,5,3,8,42.5,113.33333333333333,1700,28.333333333333332,3000000000,105.88235294117648
1416,15,3,18,78.66666666666667,472,7080,118,3000000000,25.423728813559322
887,14,3,17,52.1764705882353,295.6666666666667,4435,73.91666666666667,3000000000,40.58624577226606
594,6,8,14,42.42857142857143,74.25,2970,49.5,8000000000,161.6161616161616
758,15,3,18,42.111111111111114,252.66666666666666,3790,63.166666666666664,3000000000,47.4934036939314
570,12,3,15,38,190,2850,47.5,3000000000,63.1578947368421
326,4,6,10,32.6,54.333333333333336,1630,27.166666666666668,6000000000,220.85889570552146
706,10,3,13,54.30769230769231,235.33333333333334,3530,58.833333333333336,3000000000,50.991501416430594
845,13,8,21,40.23809523809524,105.625,4225,70.41666666666667,8000000000,113.60946745562129
657,7,3,10,65.7,219,3285,54.75,3000000000,54.79452054794521
568,9,4,13,43.69230769230769,142,2840,47.333333333333336,4000000000,84.50704225352113
211,6,6,12,17.583333333333332,35.166666666666664,1055,17.583333333333332,6000000000,341.2322274881517
458,6,3,9,50.888888888888886,152.66666666666666,2290,38.166666666666664,3000000000,78.60262008733625
597,8,3,11,54.27272727272727,199,2985,49.75,3000000000,60.301507537688444
530,9,3,12,44.166666666666664,176.66666666666666,2650,44.166666666666664,3000000000,67.9245283018868
1037,13,6,19,54.578947368421055,172.83333333333334,5185,86.41666666666667,6000000000,69.43105110896816
304,8,3,11,27.636363636363637,101.33333333333333,1520,25.333333333333332,3000000000,118.42105263157895
675,11,9,20,33.75,75,3375,56.25,9000000000,160
1030,9,5,14,73.57142857142857,206,5150,85.83333333333333,5000000000,58.25242718446602
959,15,3,18,53.27777777777778,319.6666666666667,4795,79.91666666666667,3000000000,37.53910323253389
749,11,3,14,53.5,249.66666666666666,3745,62.416666666666664,3000000000,48.06408544726302
825,10,3,13,63.46153846153846,275,4125,68.75,3000000000,43.63636363636363
374,7,3,10,37.4,124.66666666666667,1870,31.166666666666668,3000000000,96.2566844919786
560,11,3,14,40,186.66666666666666,2800,46.666666666666664,3000000000,64.28571428571429
591,5,3,8,73.875,197,2955,49.25,3000000000,60.91370558375634
417,5,5,10,41.7,83.4,2085,34.75,5000000000,143.88489208633092
824,16,3,19,43.36842105263158,274.6666666666667,4120,68.66666666666667,3000000000,43.68932038834951
830,13,3,16,51.875,276.6666666666667,4150,69.16666666666667,3000000000,43.37349397590361
245,3,3,6,40.833333333333336,81.66666666666667,1225,20.416666666666668,3000000000,146.93877551020407
967,25,4,29,33.3448275862069,241.75,4835,80.58333333333333,4000000000,49.638055842812825
424,5,3,8,53,141.33333333333334,2120,35.333333333333336,3000000000,84.90566037735849
503,8,3,11,45.72727272727273,167.66666666666666,2515,41.916666666666664,3000000000,71.57057654075547
397,5,3,8,49.625,132.33333333333334,1985,33.083333333333336,3000000000,90.6801007556675
640,12,3,15,42.666666666666664,213.33333333333334,3200,53.333333333333336,3000000000,56.25
457,8,3,11,41.54545454545455,152.33333333333334,2285,38.083333333333336,3000000000,78.77461706783369
890,8,3,11,80.9090909090909,296.6666666666667,4450,74.16666666666667,3000000000,40.44943820224719
463,7,6,13,35.61538461538461,77.16666666666667,2315,38.583333333333336,6000000000,155.5075593952484
563,10,3,13,43.30769230769231,187.66666666666666,2815,46.916666666666664,3000000000,63.94316163410302
1140,16,12,28,40.714285714285715,95,5700,95,12000000000,126.3157894736842
479,6,3,9,53.22222222222222,159.66666666666666,2395,39.916666666666664,3000000000,75.15657620041755
497,8,5,13,38.23076923076923,99.4,2485,41.416666666666664,5000000000,120.72434607645876
517,5,3,8,64.625,172.33333333333334,2585,43.083333333333336,3000000000,69.63249516441006
796,7,3,10,79.6,265.3333333333333,3980,66.33333333333333,3000000000,45.22613065326633
1194,17,6,23,51.91304347826087,199,5970,99.5,6000000000,60.301507537688444
874,14,4,18,48.55555555555556,218.5,4370,72.83333333333333,4000000000,54.91990846681923
460,10,3,13,35.38461538461539,153.33333333333334,2300,38.333333333333336,3000000000,78.26086956521739
382,6,4,10,38.2,95.5,1910,31.833333333333332,4000000000,125.65445026178011
713,10,4,14,50.92857142857143,178.25,3565,59.416666666666664,4000000000,67.3211781206171
449,11,3,14,32.07142857142857,149.66666666666666,2245,37.416666666666664,3000000000,80.1781737193764
783,12,6,18,43.5,130.5,3915,65.25,6000000000,91.95402298850576
382,7,3,10,38.2,127.33333333333333,1910,31.833333333333332,3000000000,94.24083769633508
377,8,3,11,34.27272727272727,125.66666666666667,1885,31.416666666666668,3000000000,95.49071618037135
248,4,3,7,35.42857142857143,82.66666666666667,1240,20.666666666666668,3000000000,145.16129032258064
509,8,4,12,42.416666666666664,127.25,2545,42.416666666666664,4000000000,94.30255402750493
815,13,5,18,45.27777777777778,163,4075,67.91666666666667,5000000000,73.61963190184049
598,13,3,16,37.375,199.33333333333334,2990,49.833333333333336,3000000000,60.20066889632107
506,8,3,11,46,168.66666666666666,2530,42.166666666666664,3000000000,71.14624505928855
250,3,3,6,41.666666666666664,83.33333333333333,1250,20.833333333333332,3000000000,144
697,15,10,25,27.88,69.7,3485,58.083333333333336,10000000000,172.1664275466284
495,9,4,13,38.07692307692308,123.75,2475,41.25,4000000000,96.96969696969697
164,3,3,6,27.333333333333332,54.666666666666664,820,13.666666666666666,3000000000,219.5121951219512
387,4,4,8,48.375,96.75,1935,32.25,4000000000,124.03100775193799
555,11,7,18,30.833333333333332,79.28571428571429,2775,46.25,7000000000,151.35135135135135
190,4,4,8,23.75,47.5,950,15.833333333333334,4000000000,252.6315789473684
331,5,3,8,41.375,110.33333333333333,1655,27.583333333333332,3000000000,108.76132930513594
986,12,9,21,46.95238095238095,109.55555555555556,4930,82.16666666666667,9000000000,109.53346855983773
484,5,4,9,53.77777777777778,121,2420,40.333333333333336,4000000000,99.17355371900825
858,11,3,14,61.285714285714285,286,4290,71.5,3000000000,41.95804195804196
486,4,3,7,69.42857142857143,162,2430,40.5,3000000000,74.07407407407408
779,7,3,10,77.9,259.6666666666667,3895,64.91666666666667,3000000000,46.21309370988446
679,9,6,15,45.266666666666666,113.16666666666667,3395,56.583333333333336,6000000000,106.03829160530192
309,7,3,10,30.9,103,1545,25.75,3000000000,116.50485436893204
507,6,3,9,56.333333333333336,169,2535,42.25,3000000000,71.0059171597633
555,9,8,17,32.64705882352941,69.375,2775,46.25,8000000000,172.97297297297297
336,3,5,8,42,67.2,1680,28,5000000000,178.57142857142856
655,12,5,17,38.529411764705884,131,3275,54.583333333333336,5000000000,91.6030534351145
806,13,3,16,50.375,268.6666666666667,4030,67.16666666666667,3000000000,44.66501240694789
392,5,4,9,43.55555555555556,98,1960,32.666666666666664,4000000000,122.44897959183675
1040,10,6,16,65,173.33333333333334,5200,86.66666666666667,6000000000,69.23076923076923
615,8,5,13,47.30769230769231,123,3075,51.25,5000000000,97.5609756097561
245,3,3,6,40.833333333333336,81.66666666666667,1225,20.416666666666668,3000000000,146.93877551020407
643,8,3,11,58.45454545454545,214.33333333333334,3215,53.583333333333336,3000000000,55.987558320373246
656,14,7,21,31.238095238095237,93.71428571428571,3280,54.666666666666664,7000000000,128.0487804878049
590,7,3,10,59,196.66666666666666,2950,49.166666666666664,3000000000,61.016949152542374
493,9,3,12,41.083333333333336,164.33333333333334,2465,41.083333333333336,3000000000,73.02231237322515
578,10,3,13,44.46153846153846,192.66666666666666,2890,48.166666666666664,3000000000,62.28373702422146
413,6,5,11,37.54545454545455,82.6,2065,34.416666666666664,5000000000,145.27845036319613
1736,12,10,22,78.9090909090909,173.6,8680,144.66666666666666,10000000000,69.12442396313365
520,10,3,13,40,173.33333333333334,2600,43.333333333333336,3000000000,69.23076923076923
960,22,8,30,32,120,4800,80,8000000000,100
440,7,3,10,44,146.66666666666666,2200,36.666666666666664,3000000000,81.81818181818183
686,11,3,14,49,228.66666666666666,3430,57.166666666666664,3000000000,52.478134110787174
734,7,6,13,56.46153846153846,122.33333333333333,3670,61.166666666666664,6000000000,98.09264305177112
558,7,3,10,55.8,186,2790,46.5,3000000000,64.51612903225806
1078,18,3,21,51.333333333333336,359.3333333333333,5390,89.83333333333333,3000000000,33.39517625231911
423,8,4,12,35.25,105.75,2115,35.25,4000000000,113.47517730496455
753,11,3,14,53.785714285714285,251,3765,62.75,3000000000,47.808764940239044
582,11,6,17,34.23529411764706,97,2910,48.5,6000000000,123.71134020618557
1038,21,3,24,43.25,346,5190,86.5,3000000000,34.68208092485549
974,9,5,14,69.57142857142857,194.8,4870,81.16666666666667,5000000000,61.60164271047228
581,14,4,18,32.27777777777778,145.25,2905,48.416666666666664,4000000000,82.61617900172118
1549,23,13,36,43.02777777777778,119.15384615384616,7745,129.08333333333334,13000000000,100.71013557133634
774,18,6,24,32.25,129,3870,64.5,6000000000,93.02325581395348
434,12,3,15,28.933333333333334,144.66666666666666,2170,36.166666666666664,3000000000,82.94930875576037
345,3,4,7,49.285714285714285,86.25,1725,28.75,4000000000,139.1304347826087
642,12,3,15,42.8,214,3210,53.5,3000000000,56.074766355140184
337,5,5,10,33.7,67.4,1685,28.083333333333332,5000000000,178.04154302670625
220,4,4,8,27.5,55,1100,18.333333333333332,4000000000,218.1818181818182
549,10,3,13,42.23076923076923,183,2745,45.75,3000000000,65.57377049180329
610,11,3,14,43.57142857142857,203.33333333333334,3050,50.833333333333336,3000000000,59.01639344262294
460,6,6,12,38.333333333333336,76.66666666666667,2300,38.333333333333336,6000000000,156.52173913043478
586,14,6,20,29.3,97.66666666666667,2930,48.833333333333336,6000000000,122.8668941979522
860,11,4,15,57.333333333333336,215,4300,71.66666666666667,4000000000,55.813953488372086
483,14,3,17,28.41176470588235,161,2415,40.25,3000000000,74.53416149068323
564,7,5,12,47,112.8,2820,47,5000000000,106.38297872340426
651,9,5,14,46.5,130.2,3255,54.25,5000000000,92.16589861751153
364,5,6,11,33.09090909090909,60.666666666666664,1820,30.333333333333332,6000000000,197.8021978021978
775,13,5,18,43.05555555555556,155,3875,64.58333333333333,5000000000,77.41935483870968
544,10,3,13,41.84615384615385,181.33333333333334,2720,45.333333333333336,3000000000,66.17647058823529
865,7,5,12,72.08333333333333,173,4325,72.08333333333333,5000000000,69.36416184971098
165,3,3,6,27.5,55,825,13.75,3000000000,218.1818181818182
565,16,4,20,28.25,141.25,2825,47.083333333333336,4000000000,84.95575221238938
1060,17,3,20,53,353.3333333333333,5300,88.33333333333333,3000000000,33.9622641509434
577,7,3,10,57.7,192.33333333333334,2885,48.083333333333336,3000000000,62.39168110918544
237,3,3,6,39.5,79,1185,19.75,3000000000,151.89873417721518
596,17,3,20,29.8,198.66666666666666,2980,49.666666666666664,3000000000,60.4026845637584
263,5,3,8,32.875,87.66666666666667,1315,21.916666666666668,3000000000,136.88212927756652
1021,17,5,22,46.40909090909091,204.2,5105,85.08333333333333,5000000000,58.765915768854065
638,9,4,13,49.07692307692308,159.5,3190,53.166666666666664,4000000000,75.23510971786834
1278,20,4,24,53.25,319.5,6390,106.5,4000000000,37.55868544600939
816,15,3,18,45.333333333333336,272,4080,68,3000000000,44.11764705882353
643,8,3,11,58.45454545454545,214.33333333333334,3215,53.583333333333336,3000000000,55.987558320373246
374,6,3,9,41.55555555555556,124.66666666666667,1870,31.166666666666668,3000000000,96.2566844919786
451,5,3,8,56.375,150.33333333333334,2255,37.583333333333336,3000000000,79.82261640798227
530,6,3,9,58.888888888888886,176.66666666666666,2650,44.166666666666664,3000000000,67.9245283018868
460,8,5,13,35.38461538461539,92,2300,38.333333333333336,5000000000,130.43478260869563
712,7,3,10,71.2,237.33333333333334,3560,59.333333333333336,3000000000,50.561797752808985
598,8,3,11,54.36363636363637,199.33333333333334,2990,49.833333333333336,3000000000,60.20066889632107
535,6,6,12,44.583333333333336,89.16666666666667,2675,44.583333333333336,6000000000,134.57943925233644
819,17,5,22,37.22727272727273,163.8,4095,68.25,5000000000,73.26007326007326
525,11,8,19,27.63157894736842,65.625,2625,43.75,8000000000,182.85714285714286
706,14,5,19,37.1578947368421,141.2,3530,58.833333333333336,5000000000,84.98583569405098
671,11,3,14,47.92857142857143,223.66666666666666,3355,55.916666666666664,3000000000,53.65126676602087
954,18,3,21,45.42857142857143,318,4770,79.5,3000000000,37.735849056603776
853,5,8,13,65.61538461538461,106.625,4265,71.08333333333333,8000000000,112.54396248534584
223,4,3,7,31.857142857142858,74.33333333333333,1115,18.583333333333332,3000000000,161.43497757847535
621,4,3,7,88.71428571428571,207,3105,51.75,3000000000,57.971014492753625
665,9,3,12,55.416666666666664,221.66666666666666,3325,55.416666666666664,3000000000,54.13533834586466
760,15,4,19,40,190,3800,63.333333333333336,4000000000,63.1578947368421
1051,12,8,20,52.55,131.375,5255,87.58333333333333,8000000000,91.34157944814463
320,8,3,11,29.09090909090909,106.66666666666667,1600,26.666666666666668,3000000000,112.5
782,11,9,20,39.1,86.88888888888889,3910,65.16666666666667,9000000000,138.10741687979538
716,18,7,25,28.64,102.28571428571429,3580,59.666666666666664,7000000000,117.31843575418995
557,8,3,11,50.63636363636363,185.66666666666666,2785,46.416666666666664,3000000000,64.63195691202873
660,14,5,19,34.73684210526316,132,3300,55,5000000000,90.9090909090909
278,5,3,8,34.75,92.66666666666667,1390,23.166666666666668,3000000000,129.49640287769785
1081,13,10,23,47,108.1,5405,90.08333333333333,10000000000,111.00832562442183
349,6,4,10,34.9,87.25,1745,29.083333333333332,4000000000,137.53581661891118
904,14,3,17,53.1764705882353,301.3333333333333,4520,75.33333333333333,3000000000,39.823008849557525
592,7,6,13,45.53846153846154,98.66666666666667,2960,49.333333333333336,6000000000,121.62162162162161
687,11,3,14,49.07142857142857,229,3435,57.25,3000000000,52.40174672489083
413,11,3,14,29.5,137.66666666666666,2065,34.416666666666664,3000000000,87.16707021791768
697,10,3,13,53.61538461538461,232.33333333333334,3485,58.083333333333336,3000000000,51.649928263988514
497,11,4,15,33.13333333333333,124.25,2485,41.416666666666664,4000000000,96.57947686116701
670,6,6,12,55.833333333333336,111.66666666666667,3350,55.833333333333336,6000000000,107.46268656716417
545,7,5,12,45.416666666666664,109,2725,45.416666666666664,5000000000,110.09174311926607
682,12,3,15,45.46666666666667,227.33333333333334,3410,56.833333333333336,3000000000,52.785923753665685
376,11,4,15,25.066666666666666,94,1880,31.333333333333332,4000000000,127.65957446808511
465,11,3,14,33.214285714285715,155,2325,38.75,3000000000,77.41935483870968
361,9,6,15,24.066666666666666,60.166666666666664,1805,30.083333333333332,6000000000,199.4459833795014
385,3,5,8,48.125,77,1925,32.083333333333336,5000000000,155.8441558441558
411,7,3,10,41.1,137,2055,34.25,3000000000,87.59124087591242
310,5,3,8,38.75,103.33333333333333,1550,25.833333333333332,3000000000,116.12903225806453
704,8,3,11,64,234.66666666666666,3520,58.666666666666664,3000000000,51.13636363636364
600,12,3,15,40,200,3000,50,3000000000,60
849,17,3,20,42.45,283,4245,70.75,3000000000,42.40282685512368
432,6,3,9,48,144,2160,36,3000000000,83.33333333333333
761,12,3,15,50.733333333333334,253.66666666666666,3805,63.416666666666664,3000000000,47.306176084099874
512,10,3,13,39.38461538461539,170.66666666666666,2560,42.666666666666664,3000000000,70.3125
363,4,3,7,51.857142857142854,121,1815,30.25,3000000000,99.17355371900827
466,9,3,12,38.833333333333336,155.33333333333334,2330,38.833333333333336,3000000000,77.25321888412017
770,13,4,17,45.294117647058826,192.5,3850,64.16666666666667,4000000000,62.33766233766233
883,14,7,21,42.04761904761905,126.14285714285714,4415,73.58333333333333,7000000000,95.13023782559458
774,9,3,12,64.5,258,3870,64.5,3000000000,46.51162790697674
1007,19,3,22,45.77272727272727,335.6666666666667,5035,83.91666666666667,3000000000,35.749751737835155
668,6,7,13,51.38461538461539,95.42857142857143,3340,55.666666666666664,7000000000,125.74850299401199
1487,15,3,18,82.61111111111111,495.6666666666667,7435,123.91666666666667,3000000000,24.209818426361803
634,13,3,16,39.625,211.33333333333334,3170,52.833333333333336,3000000000,56.78233438485804
880,17,4,21,41.904761904761905,220,4400,73.33333333333333,4000000000,54.54545454545455
533,6,3,9,59.22222222222222,177.66666666666666,2665,44.416666666666664,3000000000,67.5422138836773
407,4,3,7,58.142857142857146,135.66666666666666,2035,33.916666666666664,3000000000,88.45208845208846
750,18,7,25,30,107.14285714285714,3750,62.5,7000000000,112
1728,21,19,40,43.2,90.94736842105263,8640,144,19000000000,131.94444444444446
329,9,3,12,27.416666666666668,109.66666666666667,1645,27.416666666666668,3000000000,109.4224924012158
614,8,3,11,55.81818181818182,204.66666666666666,3070,51.166666666666664,3000000000,58.63192182410423
928,10,3,13,71.38461538461539,309.3333333333333,4640,77.33333333333333,3000000000,38.793103448275865
1267,22,11,33,38.39393939393939,115.18181818181819,6335,105.58333333333333,11000000000,104.18310970797158
542,13,3,16,33.875,180.66666666666666,2710,45.166666666666664,3000000000,66.42066420664207
367,6,5,11,33.36363636363637,73.4,1835,30.583333333333332,5000000000,163.48773841961855
428,6,3,9,47.55555555555556,142.66666666666666,2140,35.666666666666664,3000000000,84.11214953271029
362,6,3,9,40.22222222222222,120.66666666666667,1810,30.166666666666668,3000000000,99.4475138121547
461,7,3,10,46.1,153.66666666666666,2305,38.416666666666664,3000000000,78.09110629067246
978,14,3,17,57.529411764705884,326,4890,81.5,3000000000,36.809815950920246
448,7,3,10,44.8,149.33333333333334,2240,37.333333333333336,3000000000,80.35714285714285
216,6,4,10,21.6,54,1080,18,4000000000,222.2222222222222
1065,17,6,23,46.30434782608695,177.5,5325,88.75,6000000000,67.6056338028169
680,11,4,15,45.333333333333336,170,3400,56.666666666666664,4000000000,70.58823529411764
1044,19,11,30,34.8,94.9090909090909,5220,87,11000000000,126.43678160919539
421,6,3,9,46.77777777777778,140.33333333333334,2105,35.083333333333336,3000000000,85.5106888361045
666,10,6,16,41.625,111,3330,55.5,6000000000,108.1081081081081
1236,21,3,24,51.5,412,6180,103,3000000000,29.12621359223301
768,13,3,16,48,256,3840,64,3000000000,46.875
693,10,4,14,49.5,173.25,3465,57.75,4000000000,69.26406926406926
1069,12,7,19,56.26315789473684,152.71428571428572,5345,89.08333333333333,7000000000,78.57811038353603
453,8,3,11,41.18181818181818,151,2265,37.75,3000000000,79.47019867549669
478,6,6,12,39.833333333333336,79.66666666666667,2390,39.833333333333336,6000000000,150.6276150627615
436,11,3,14,31.142857142857142,145.33333333333334,2180,36.333333333333336,3000000000,82.56880733944953
566,10,3,13,43.53846153846154,188.66666666666666,2830,47.166666666666664,3000000000,63.60424028268552
1061,13,6,19,55.8421052631579,176.83333333333334,5305,88.41666666666667,6000000000,67.86050895381715
1058,15,8,23,46,132.25,5290,88.16666666666667,8000000000,90.73724007561437
987,20,3,23,42.91304347826087,329,4935,82.25,3000000000,36.4741641337386
556,8,4,12,46.333333333333336,139,2780,46.333333333333336,4000000000,86.33093525179855
360,5,3,8,45,120,1800,30,3000000000,100
591,17,3,20,29.55,197,2955,49.25,3000000000,60.91370558375634
384,5,4,9,42.666666666666664,96,1920,32,4000000000,125
534,9,3,12,44.5,178,2670,44.5,3000000000,67.41573033707864
362,6,5,11,32.90909090909091,72.4,1810,30.166666666666668,5000000000,165.74585635359114
665,5,3,8,83.125,221.66666666666666,3325,55.416666666666664,3000000000,54.13533834586466
1023,23,10,33,31,102.3,5115,85.25,10000000000,117.30205278592375
1089,17,3,20,54.45,363,5445,90.75,3000000000,33.05785123966942
547,9,6,15,36.46666666666667,91.16666666666667,2735,45.583333333333336,6000000000,131.6270566727605
461,11,3,14,32.92857142857143,153.66666666666666,2305,38.416666666666664,3000000000,78.09110629067246
448,9,3,12,37.333333333333336,149.33333333333334,2240,37.333333333333336,3000000000,80.35714285714285
313,4,3,7,44.714285714285715,104.33333333333333,1565,26.083333333333332,3000000000,115.01597444089457
640,7,4,11,58.18181818181818,160,3200,53.333333333333336,4000000000,75
397,10,3,13,30.53846153846154,132.33333333333334,1985,33.083333333333336,3000000000,90.6801007556675
791,6,3,9,87.88888888888889,263.6666666666667,3955,65.91666666666667,3000000000,45.51201011378002
725,12,4,16,45.3125,181.25,3625,60.416666666666664,4000000000,66.20689655172414
1226,12,3,15,81.73333333333333,408.6666666666667,6130,102.16666666666667,3000000000,29.363784665579118
765,12,3,15,51,255,3825,63.75,3000000000,47.05882352941176
318,5,3,8,39.75,106,1590,26.5,3000000000,113.20754716981132
559,7,4,11,50.81818181818182,139.75,2795,46.583333333333336,4000000000,85.86762075134168
1403,20,15,35,40.08571428571429,93.53333333333333,7015,116.91666666666667,15000000000,128.29650748396293
518,10,4,14,37,129.5,2590,43.166666666666664,4000000000,92.66409266409268
421,6,3,9,46.77777777777778,140.33333333333334,2105,35.083333333333336,3000000000,85.5106888361045
416,6,3,9,46.22222222222222,138.66666666666666,2080,34.666666666666664,3000000000,86.53846153846155
759,15,4,19,39.94736842105263,189.75,3795,63.25,4000000000,63.241106719367586
781,12,3,15,52.06666666666667,260.3333333333333,3905,65.08333333333333,3000000000,46.09475032010244
555,11,3,14,39.642857142857146,185,2775,46.25,3000000000,64.86486486486487
243,5,3,8,30.375,81,1215,20.25,3000000000,148.14814814814815
686,6,3,9,76.22222222222223,228.66666666666666,3430,57.166666666666664,3000000000,52.478134110787174
583,11,4,15,38.86666666666667,145.75,2915,48.583333333333336,4000000000,82.3327615780446
609,12,3,15,40.6,203,3045,50.75,3000000000,59.11330049261083
574,9,3,12,47.833333333333336,191.33333333333334,2870,47.833333333333336,3000000000,62.7177700348432
608,6,3,9,67.55555555555556,202.66666666666666,3040,50.666666666666664,3000000000,59.21052631578947
1083,20,7,27,40.111111111111114,154.71428571428572,5415,90.25,7000000000,77.5623268698061
443,7,5,12,36.916666666666664,88.6,2215,36.916666666666664,5000000000,135.44018058690745
810,22,3,25,32.4,270,4050,67.5,3000000000,44.44444444444445
918,17,3,20,45.9,306,4590,76.5,3000000000,39.2156862745098
430,7,4,11,39.09090909090909,107.5,2150,35.833333333333336,4000000000,111.62790697674417
650,12,4,16,40.625,162.5,3250,54.166666666666664,4000000000,73.84615384615385
647,9,3,12,53.916666666666664,215.66666666666666,3235,53.916666666666664,3000000000,55.64142194744977
598,12,3,15,39.86666666666667,199.33333333333334,2990,49.833333333333336,3000000000,60.20066889632107
510,7,4,11,46.36363636363637,127.5,2550,42.5,4000000000,94.11764705882352
1053,10,9,19,55.421052631578945,117,5265,87.75,9000000000,102.56410256410255
669,9,3,12,55.75,223,3345,55.75,3000000000,53.81165919282511
203,4,3,7,29,67.66666666666667,1015,16.916666666666668,3000000000,177.33990147783248
915,13,3,16,57.1875,305,4575,76.25,3000000000,39.34426229508197
658,11,5,16,41.125,131.6,3290,54.833333333333336,5000000000,91.1854103343465
1613,18,3,21,76.80952380952381,537.6666666666666,8065,134.41666666666666,3000000000,22.31866088034718
672,7,7,14,48,96,3360,56,7000000000,125
878,16,3,19,46.21052631578947,292.6666666666667,4390,73.16666666666667,3000000000,41.00227790432802
751,13,3,16,46.9375,250.33333333333334,3755,62.583333333333336,3000000000,47.93608521970706
514,9,3,12,42.833333333333336,171.33333333333334,2570,42.833333333333336,3000000000,70.03891050583658
510,10,3,13,39.23076923076923,170,2550,42.5,3000000000,70.58823529411764
406,8,3,11,36.90909090909091,135.33333333333334,2030,33.833333333333336,3000000000,88.66995073891624
514,10,3,13,39.53846153846154,171.33333333333334,2570,42.833333333333336,3000000000,70.03891050583658
469,13,3,16,29.3125,156.33333333333334,2345,39.083333333333336,3000000000,76.75906183368869
680,11,5,16,42.5,136,3400,56.666666666666664,5000000000,88.23529411764707
925,16,3,19,48.68421052631579,308.3333333333333,4625,77.08333333333333,3000000000,38.91891891891892
396,5,3,8,49.5,132,1980,33,3000000000,90.9090909090909
861,15,9,24,35.875,95.66666666666667,4305,71.75,9000000000,125.43554006968641
330,8,3,11,30,110,1650,27.5,3000000000,109.0909090909091
983,11,6,17,57.8235294117647,163.83333333333334,4915,81.91666666666667,6000000000,73.24516785350967
968,11,13,24,40.333333333333336,74.46153846153847,4840,80.66666666666667,13000000000,161.15702479338842
553,8,3,11,50.27272727272727,184.33333333333334,2765,46.083333333333336,3000000000,65.09945750452079
552,9,6,15,36.8,92,2760,46,6000000000,130.43478260869566
444,10,3,13,34.15384615384615,148,2220,37,3000000000,81.08108108108108
857,13,3,16,53.5625,285.6666666666667,4285,71.41666666666667,3000000000,42.00700116686114
560,11,6,17,32.94117647058823,93.33333333333333,2800,46.666666666666664,6000000000,128.57142857142858
511,3,4,7,73,127.75,2555,42.583333333333336,4000000000,93.9334637964775
757,13,10,23,32.91304347826087,75.7,3785,63.083333333333336,10000000000,158.52047556142668
477,5,3,8,59.625,159,2385,39.75,3000000000,75.47169811320755
662,12,3,15,44.13333333333333,220.66666666666666,3310,55.166666666666664,3000000000,54.38066465256797
704,14,3,17,41.411764705882355,234.66666666666666,3520,58.666666666666664,3000000000,51.13636363636364
459,5,3,8,57.375,153,2295,38.25,3000000000,78.4313725490196
332,5,3,8,41.5,110.66666666666667,1660,27.666666666666668,3000000000,108.43373493975903
726,13,3,16,45.375,242,3630,60.5,3000000000,49.586776859504134
487,6,6,12,40.583333333333336,81.16666666666667,2435,40.583333333333336,6000000000,147.84394250513344
446,6,5,11,40.54545454545455,89.2,2230,37.166666666666664,5000000000,134.5291479820628
596,11,3,14,42.57142857142857,198.66666666666666,2980,49.666666666666664,3000000000,60.4026845637584
754,12,3,15,50.266666666666666,251.33333333333334,3770,62.833333333333336,3000000000,47.745358090185675
530,7,3,10,53,176.66666666666666,2650,44.166666666666664,3000000000,67.9245283018868
898,15,9,24,37.416666666666664,99.77777777777777,4490,74.83333333333333,9000000000,120.2672605790646
796,14,6,20,39.8,132.66666666666666,3980,66.33333333333333,6000000000,90.45226130653266
374,8,4,12,31.166666666666668,93.5,1870,31.166666666666668,4000000000,128.34224598930481
539,3,3,6,89.83333333333333,179.66666666666666,2695,44.916666666666664,3000000000,66.79035250463822
540,12,3,15,36,180,2700,45,3000000000,66.66666666666666
719,9,5,14,51.357142857142854,143.8,3595,59.916666666666664,5000000000,83.44923504867873
511,6,3,9,56.77777777777778,170.33333333333334,2555,42.583333333333336,3000000000,70.45009784735812
512,9,5,14,36.57142857142857,102.4,2560,42.666666666666664,5000000000,117.1875
299,7,3,10,29.9,99.66666666666667,1495,24.916666666666668,3000000000,120.40133779264214
676,8,5,13,52,135.2,3380,56.333333333333336,5000000000,88.75739644970415
634,5,6,11,57.63636363636363,105.66666666666667,3170,52.833333333333336,6000000000,113.56466876971608
538,6,5,11,48.90909090909091,107.6,2690,44.833333333333336,5000000000,111.52416356877322
442,9,3,12,36.833333333333336,147.33333333333334,2210,36.833333333333336,3000000000,81.44796380090497
473,5,3,8,59.125,157.66666666666666,2365,39.416666666666664,3000000000,76.10993657505286
888,17,5,22,40.36363636363637,177.6,4440,74,5000000000,67.56756756756758
725,12,5,17,42.64705882352941,145,3625,60.416666666666664,5000000000,82.75862068965517
387,6,6,12,32.25,64.5,1935,32.25,6000000000,186.04651162790697
535,8,3,11,48.63636363636363,178.33333333333334,2675,44.583333333333336,3000000000,67.28971962616822
391,6,3,9,43.44444444444444,130.33333333333334,1955,32.583333333333336,3000000000,92.07161125319692
375,7,3,10,37.5,125,1875,31.25,3000000000,96
881,13,11,24,36.708333333333336,80.0909090909091,4405,73.41666666666667,11000000000,149.82973893303063
378,4,4,8,47.25,94.5,1890,31.5,4000000000,126.98412698412699
829,7,4,11,75.36363636363636,207.25,4145,69.08333333333333,4000000000,57.901085645355856
652,10,6,16,40.75,108.66666666666667,3260,54.333333333333336,6000000000,110.42944785276073
442,7,3,10,44.2,147.33333333333334,2210,36.833333333333336,3000000000,81.44796380090497
339,9,3,12,28.25,113,1695,28.25,3000000000,106.19469026548673
705,9,5,14,50.357142857142854,141,3525,58.75,5000000000,85.1063829787234
462,6,5,11,42,92.4,2310,38.5,5000000000,129.87012987012986
424,6,3,9,47.111111111111114,141.33333333333334,2120,35.333333333333336,3000000000,84.90566037735849
425,8,3,11,38.63636363636363,141.66666666666666,2125,35.416666666666664,3000000000,84.70588235294119
704,11,3,14,50.285714285714285,234.66666666666666,3520,58.666666666666664,3000000000,51.13636363636364
553,8,3,11,50.27272727272727,184.33333333333334,2765,46.083333333333336,3000000000,65.09945750452079
371,10,3,13,28.53846153846154,123.66666666666667,1855,30.916666666666668,3000000000,97.03504043126685
487,6,3,9,54.111111111111114,162.33333333333334,2435,40.583333333333336,3000000000,73.92197125256672
251,6,3,9,27.88888888888889,83.66666666666667,1255,20.916666666666668,3000000000,143.42629482071712
906,13,8,21,43.142857142857146,113.25,4530,75.5,8000000000,105.96026490066225
1081,19,12,31,34.87096774193548,90.08333333333333,5405,90.08333333333333,12000000000,133.2099907493062
619,7,4,11,56.27272727272727,154.75,3095,51.583333333333336,4000000000,77.54442649434571
514,6,4,10,51.4,128.5,2570,42.833333333333336,4000000000,93.3852140077821
861,16,4,20,43.05,215.25,4305,71.75,4000000000,55.749128919860624
1011,17,9,26,38.88461538461539,112.33333333333333,5055,84.25,9000000000,106.82492581602374
356,6,4,10,35.6,89,1780,29.666666666666668,4000000000,134.83146067415728
428,5,3,8,53.5,142.66666666666666,2140,35.666666666666664,3000000000,84.11214953271029
545,5,4,9,60.55555555555556,136.25,2725,45.416666666666664,4000000000,88.07339449541284
1006,19,3,22,45.72727272727273,335.3333333333333,5030,83.83333333333333,3000000000,35.785288270377734
394,7,3,10,39.4,131.33333333333334,1970,32.833333333333336,3000000000,91.3705583756345
468,4,3,7,66.85714285714286,156,2340,39,3000000000,76.92307692307693
1124,11,7,18,62.44444444444444,160.57142857142858,5620,93.66666666666667,7000000000,74.73309608540926
1101,14,3,17,64.76470588235294,367,5505,91.75,3000000000,32.69754768392371
693,14,3,17,40.76470588235294,231,3465,57.75,3000000000,51.94805194805195
409,8,3,11,37.18181818181818,136.33333333333334,2045,34.083333333333336,3000000000,88.01955990220048
419,5,4,9,46.55555555555556,104.75,2095,34.916666666666664,4000000000,114.55847255369929
456,9,3,12,38,152,2280,38,3000000000,78.94736842105263
321,8,3,11,29.181818181818183,107,1605,26.75,3000000000,112.14953271028037
304,5,3,8,38,101.33333333333333,1520,25.333333333333332,3000000000,118.42105263157895
679,9,3,12,56.583333333333336,226.33333333333334,3395,56.583333333333336,3000000000,53.01914580265096
504,4,5,9,56,100.8,2520,42,5000000000,119.04761904761905
568,4,5,9,63.111111111111114,113.6,2840,47.333333333333336,5000000000,105.6338028169014
644,10,5,15,42.93333333333333,128.8,3220,53.666666666666664,5000000000,93.16770186335404
642,8,3,11,58.36363636363637,214,3210,53.5,3000000000,56.074766355140184
463,5,4,9,51.44444444444444,115.75,2315,38.583333333333336,4000000000,103.67170626349892
354,6,6,12,29.5,59,1770,29.5,6000000000,203.38983050847457
896,9,3,12,74.66666666666667,298.6666666666667,4480,74.66666666666667,3000000000,40.17857142857142
759,8,8,16,47.4375,94.875,3795,63.25,8000000000,126.48221343873517
498,10,5,15,33.2,99.6,2490,41.5,5000000000,120.48192771084337
576,7,7,14,41.142857142857146,82.28571428571429,2880,48,7000000000,145.83333333333334
385,8,3,11,35,128.33333333333334,1925,32.083333333333336,3000000000,93.5064935064935
710,13,8,21,33.80952380952381,88.75,3550,59.166666666666664,8000000000,135.2112676056338
1189,15,6,21,56.61904761904762,198.16666666666666,5945,99.08333333333333,6000000000,60.55508830950379
529,6,3,9,58.77777777777778,176.33333333333334,2645,44.083333333333336,3000000000,68.05293005671076
893,16,3,19,47,297.6666666666667,4465,74.41666666666667,3000000000,40.31354983202688
1199,11,6,17,70.52941176470588,199.83333333333334,5995,99.91666666666667,6000000000,60.05004170141785
428,10,3,13,32.92307692307692,142.66666666666666,2140,35.666666666666664,3000000000,84.11214953271029
1121,20,4,24,46.708333333333336,280.25,5605,93.41666666666667,4000000000,42.81891168599465
329,4,3,7,47,109.66666666666667,1645,27.416666666666668,3000000000,109.4224924012158
565,11,3,14,40.357142857142854,188.33333333333334,2825,47.083333333333336,3000000000,63.716814159292035
432,8,3,11,39.27272727272727,144,2160,36,3000000000,83.33333333333333
837,8,6,14,59.785714285714285,139.5,4185,69.75,6000000000,86.02150537634408
733,15,8,23,31.869565217391305,91.625,3665,61.083333333333336,8000000000,130.96862210095497
619,9,3,12,51.583333333333336,206.33333333333334,3095,51.583333333333336,3000000000,58.158319870759286
983,16,3,19,51.73684210526316,327.6666666666667,4915,81.91666666666667,3000000000,36.622583926754835
743,13,3,16,46.4375,247.66666666666666,3715,61.916666666666664,3000000000,48.45222072678331
1034,18,8,26,39.76923076923077,129.25,5170,86.16666666666667,8000000000,92.84332688588007
591,6,6,12,49.25,98.5,2955,49.25,6000000000,121.82741116751268
526,11,4,15,35.06666666666667,131.5,2630,43.833333333333336,4000000000,91.25475285171102
775,11,3,14,55.357142857142854,258.3333333333333,3875,64.58333333333333,3000000000,46.45161290322581
639,10,5,15,42.6,127.8,3195,53.25,5000000000,93.89671361502347
285,3,4,7,40.714285714285715,71.25,1425,23.75,4000000000,168.42105263157896
738,11,3,14,52.714285714285715,246,3690,61.5,3000000000,48.78048780487805
543,14,3,17,31.941176470588236,181,2715,45.25,3000000000,66.29834254143647
442,5,3,8,55.25,147.33333333333334,2210,36.833333333333336,3000000000,81.44796380090497
707,14,3,17,41.588235294117645,235.66666666666666,3535,58.916666666666664,3000000000,50.91937765205092
547,11,9,20,27.35,60.77777777777778,2735,45.583333333333336,9000000000,197.44058500914076
533,14,6,20,26.65,88.83333333333333,2665,44.416666666666664,6000000000,135.0844277673546
725,8,6,14,51.785714285714285,120.83333333333333,3625,60.416666666666664,6000000000,99.3103448275862
257,4,4,8,32.125,64.25,1285,21.416666666666668,4000000000,186.7704280155642
227,4,5,9,25.22222222222222,45.4,1135,18.916666666666668,5000000000,264.3171806167401
840,5,7,12,70,120,4200,70,7000000000,100
790,13,3,16,49.375,263.3333333333333,3950,65.83333333333333,3000000000,45.56962025316456
626,14,3,17,36.8235294117647,208.66666666666666,3130,52.166666666666664,3000000000,57.50798722044728
864,13,3,16,54,288,4320,72,3000000000,41.666666666666664
657,9,3,12,54.75,219,3285,54.75,3000000000,54.79452054794521
539,11,5,16,33.6875,107.8,2695,44.916666666666664,5000000000,111.31725417439704
726,10,8,18,40.333333333333336,90.75,3630,60.5,8000000000,132.23140495867767
342,9,4,13,26.307692307692307,85.5,1710,28.5,4000000000,140.35087719298247
498,9,3,12,41.5,166,2490,41.5,3000000000,72.28915662650603
895,11,4,15,59.666666666666664,223.75,4475,74.58333333333333,4000000000,53.631284916201125
388,10,3,13,29.846153846153847,129.33333333333334,1940,32.333333333333336,3000000000,92.78350515463917
601,7,3,10,60.1,200.33333333333334,3005,50.083333333333336,3000000000,59.90016638935108
381,6,3,9,42.333333333333336,127,1905,31.75,3000000000,94.48818897637796
765,6,3,9,85,255,3825,63.75,3000000000,47.05882352941176
503,7,3,10,50.3,167.66666666666666,2515,41.916666666666664,3000000000,71.57057654075547
347,8,3,11,31.545454545454547,115.66666666666667,1735,28.916666666666668,3000000000,103.7463976945245
541,8,3,11,49.18181818181818,180.33333333333334,2705,45.083333333333336,3000000000,66.54343807763401
949,14,3,17,55.8235294117647,316.3333333333333,4745,79.08333333333333,3000000000,37.93466807165437
760,9,4,13,58.46153846153846,190,3800,63.333333333333336,4000000000,63.1578947368421
541,12,3,15,36.06666666666667,180.33333333333334,2705,45.083333333333336,3000000000,66.54343807763401
574,9,3,12,47.833333333333336,191.33333333333334,2870,47.833333333333336,3000000000,62.7177700348432
435,4,6,10,43.5,72.5,2175,36.25,6000000000,165.51724137931035
593,8,5,13,45.61538461538461,118.6,2965,49.416666666666664,5000000000,101.18043844856662
494,14,3,17,29.058823529411764,164.66666666666666,2470,41.166666666666664,3000000000,72.87449392712551
1148,27,3,30,38.266666666666666,382.6666666666667,5740,95.66666666666667,3000000000,31.3588850174216
923,12,4,16,57.6875,230.75,4615,76.91666666666667,4000000000,52.00433369447453
1116,13,3,16,69.75,372,5580,93,3000000000,32.25806451612903
461,9,3,12,38.416666666666664,153.66666666666666,2305,38.416666666666664,3000000000,78.09110629067246
874,15,7,22,39.72727272727273,124.85714285714286,4370,72.83333333333333,7000000000,96.10983981693364
695,7,3,10,69.5,231.66666666666666,3475,57.916666666666664,3000000000,51.79856115107914
558,5,7,12,46.5,79.71428571428571,2790,46.5,7000000000,150.53763440860214
442,6,3,9,49.111111111111114,147.33333333333334,2210,36.833333333333336,3000000000,81.44796380090497
581,12,3,15,38.733333333333334,193.66666666666666,2905,48.416666666666664,3000000000,61.96213425129088
936,8,8,16,58.5,117,4680,78,8000000000,102.56410256410255
444,8,3,11,40.36363636363637,148,2220,37,3000000000,81.08108108108108
682,8,3,11,62,227.33333333333334,3410,56.833333333333336,3000000000,52.785923753665685
687,13,4,17,40.411764705882355,171.75,3435,57.25,4000000000,69.86899563318777
362,9,3,12,30.166666666666668,120.66666666666667,1810,30.166666666666668,3000000000,99.4475138121547
558,9,3,12,46.5,186,2790,46.5,3000000000,64.51612903225806
341,5,3,8,42.625,113.66666666666667,1705,28.416666666666668,3000000000,105.57184750733137
624,7,3,10,62.4,208,3120,52,3000000000,57.69230769230769
347,9,4,13,26.692307692307693,86.75,1735,28.916666666666668,4000000000,138.32853025936598
686,4,8,12,57.166666666666664,85.75,3430,57.166666666666664,8000000000,139.94169096209913
744,10,4,14,53.142857142857146,186,3720,62,4000000000,64.51612903225806
644,7,3,10,64.4,214.66666666666666,3220,53.666666666666664,3000000000,55.90062111801243
578,6,3,9,64.22222222222223,192.66666666666666,2890,48.166666666666664,3000000000,62.28373702422146
669,11,3,14,47.785714285714285,223,3345,55.75,3000000000,53.81165919282511
623,11,3,14,44.5,207.66666666666666,3115,51.916666666666664,3000000000,57.784911717495994
759,20,3,23,33,253,3795,63.25,3000000000,47.430830039525695
207,4,3,7,29.571428571428573,69,1035,17.25,3000000000,173.91304347826087
578,6,3,9,64.22222222222223,192.66666666666666,2890,48.166666666666664,3000000000,62.28373702422146
278,5,3,8,34.75,92.66666666666667,1390,23.166666666666668,3000000000,129.49640287769785
975,16,3,19,51.31578947368421,325,4875,81.25,3000000000,36.92307692307692
827,15,3,18,45.94444444444444,275.6666666666667,4135,68.91666666666667,3000000000,43.53083434099153
257,10,3,13,19.76923076923077,85.66666666666667,1285,21.416666666666668,3000000000,140.07782101167317
485,6,3,9,53.888888888888886,161.66666666666666,2425,40.416666666666664,3000000000,74.22680412371135
427,10,4,14,30.5,106.75,2135,35.583333333333336,4000000000,112.41217798594847
